Delivered-To: sherhan.wicky@gmail.com
Received: by 10.79.136.132 with SMTP id k126csp168212ivd;
        Mon, 1 May 2017 04:49:58 -0700 (PDT)
X-Received: by 10.223.163.158 with SMTP id l30mr15785767wrb.174.1493639397838;
        Mon, 01 May 2017 04:49:57 -0700 (PDT)
Return-Path: <support@pokerstars.com>
Received: from mx13.pokerstars.eu (mx13.pokerstars.eu. [77.87.179.125])
        by mx.google.com with ESMTPS id 83si130568wme.89.2017.05.01.04.49.57
        for <sherhan.wicky@gmail.com>
        (version=TLS1_2 cipher=ECDHE-RSA-AES128-GCM-SHA256 bits=128/128);
        Mon, 01 May 2017 04:49:57 -0700 (PDT)
Received-SPF: pass (google.com: domain of support@pokerstars.com designates 77.87.179.125 as permitted sender) client-ip=77.87.179.125;
Authentication-Results: mx.google.com;
       dkim=pass (test mode) header.i=@pokerstars.com;
       spf=pass (google.com: domain of support@pokerstars.com designates 77.87.179.125 as permitted sender) smtp.mailfrom=support@pokerstars.com
Received: by mx13.pokerstars.eu (mailer, from userid 503)
	id E7B9F1FC2C5C; Mon,  1 May 2017 07:49:56 -0400 (EDT)
DKIM-Signature: v=1; a=rsa-sha1; c=relaxed; d=pokerstars.com; h=date
	:from:to:subject:message-id:mime-version:content-type
	:content-transfer-encoding; s=s1024; bh=WDBP9ZoiE8cWeAL/49E7/JeR
	7WM=; b=kV0XJdTK2cWDLS8zbQDR68RpruSM72G4J3ToXYu/fW4ATa/L3qLLAVJR
	N4UQ1NpU9tgYiz4l4CDqjAn7tBEgGRSpf5REQEfdYdI+MSfrg/8Tto4U4PD3bC7m
	oK8dPXb5sOp//6kjNQmNpXWkXl0sn9BS6ucEBLLSquA1aVpxUds=
X-PS-ID: c2hlcmhhbi53aWNreUBnbWFpbC5jb20=
Received: from pokerstars.com (IOM-20-81 [192.168.8.81])
	by mx13.pokerstars.eu (mailer) with SMTP id CD4B61FC2788
	for <sherhan.wicky@gmail.com>; Mon,  1 May 2017 07:49:56 -0400 (EDT)
Date: Mon, 1 May 2017 07:49:56 -0400
From: "PokerStars Support" <support@pokerstars.com>
To: sherhan.wicky@gmail.com
Subject: PokerStars Hand History Request - last 1 day of play
Message-Id: <590720E4.A0A57C7D1028EA8@pokerstars.com>
MIME-Version: 1.0
Content-Type: text/plain;
 charset="windows-1252"
Content-Transfer-Encoding: quoted-printable


Transcript for last 1 day of play requested by the_wickstar (sherhan.wi=
cky@gmail.com)

*********** # 1 **************
PokerStars Hand #169803295101:  Hold'em No Limit ($0.01/$0.02 USD) - 20=
17/05/01 21:48:10 CUST [2017/05/01 7:48:10 ET]
Table 'Philoctetes' 9-max Seat #3 is the button
Seat 1: jarko1972 ($2.03 in chips)=20
Seat 3: flyperety ($2 in chips)=20
Seat 5: toubalas ($2.68 in chips)=20
Seat 6: riskmate ($1.92 in chips)=20
Seat 7: the_wickstar ($1.46 in chips)=20
Seat 8: WebCamSasha ($2.34 in chips)=20
toubalas: posts small blind $0.01
riskmate: posts big blind $0.02
Le Clienth: sits out=20
*** HOLE CARDS ***
Dealt to the_wickstar [6c 8d]
the_wickstar: folds=20
WebCamSasha: folds=20
jarko1972: folds=20
flyperety: folds=20
the_wickstar leaves the table
toubalas: raises $0.02 to $0.04
riskmate: calls $0.02
*** FLOP *** [2s 5c Kh]
toubalas: bets $0.04
riskmate: calls $0.04
*** TURN *** [2s 5c Kh] [7d]
toubalas: bets $0.08
riskmate: calls $0.08
*** RIVER *** [2s 5c Kh 7d] [6d]
toubalas: checks=20
riskmate: bets $0.16
toubalas: calls $0.16
*** SHOW DOWN ***
riskmate: shows [Ac Qc] (high card Ace)
toubalas: shows [Jd Js] (a pair of Jacks)
toubalas collected $0.62 from pot
*** SUMMARY ***
Total pot $0.64 | Rake $0.02=20
Board [2s 5c Kh 7d 6d]
Seat 1: jarko1972 folded before Flop (didn't bet)
Seat 3: flyperety (button) folded before Flop (didn't bet)
Seat 5: toubalas (small blind) showed [Jd Js] and won ($0.62) with a pa=
ir of Jacks
Seat 6: riskmate (big blind) showed [Ac Qc] and lost with high card Ace
Seat 7: the_wickstar folded before Flop (didn't bet)
Seat 8: WebCamSasha folded before Flop (didn't bet)


*********** # 2 **************
PokerStars Hand #169803250904:  Hold'em No Limit ($0.01/$0.02 USD) - 20=
17/05/01 21:46:39 CUST [2017/05/01 7:46:39 ET]
Table 'Philoctetes' 9-max Seat #1 is the button
Seat 1: jarko1972 ($2.03 in chips)=20
Seat 3: flyperety ($2.01 in chips)=20
Seat 5: toubalas ($2 in chips)=20
Seat 6: riskmate ($1.92 in chips)=20
Seat 7: the_wickstar ($2.18 in chips)=20
Seat 8: WebCamSasha ($2.34 in chips)=20
flyperety: posts small blind $0.01
toubalas: posts big blind $0.02
Le Clienth: sits out=20
*** HOLE CARDS ***
Dealt to the_wickstar [Ts Qh]
riskmate: folds=20
the_wickstar: raises $0.04 to $0.06
WebCamSasha: folds=20
jarko1972: folds=20
flyperety: folds=20
toubalas: raises $0.06 to $0.12
the_wickstar: calls $0.06
*** FLOP *** [6h Ad Qc]
toubalas: checks=20
the_wickstar: bets $0.20
toubalas: calls $0.20
*** TURN *** [6h Ad Qc] [7d]
toubalas: checks=20
the_wickstar: checks=20
*** RIVER *** [6h Ad Qc 7d] [Th]
toubalas: bets $0.40
the_wickstar: calls $0.40
*** SHOW DOWN ***
toubalas: shows [Ah As] (three of a kind, Aces)
the_wickstar: mucks hand=20
toubalas collected $1.40 from pot
*** SUMMARY ***
Total pot $1.45 | Rake $0.05=20
Board [6h Ad Qc 7d Th]
Seat 1: jarko1972 (button) folded before Flop (didn't bet)
Seat 3: flyperety (small blind) folded before Flop
Seat 5: toubalas (big blind) showed [Ah As] and won ($1.40) with three =
of a kind, Aces
Seat 6: riskmate folded before Flop (didn't bet)
Seat 7: the_wickstar mucked [Ts Qh]
Seat 8: WebCamSasha folded before Flop (didn't bet)


*********** # 3 **************
PokerStars Hand #169803234017:  Hold'em No Limit ($0.01/$0.02 USD) - 20=
17/05/01 21:46:04 CUST [2017/05/01 7:46:04 ET]
Table 'Philoctetes' 9-max Seat #8 is the button
Seat 1: jarko1972 ($2.04 in chips)=20
Seat 3: flyperety ($2.03 in chips)=20
Seat 6: riskmate ($1.92 in chips)=20
Seat 7: the_wickstar ($2.20 in chips)=20
Seat 8: WebCamSasha ($2.29 in chips)=20
Le Clienth will be allowed to play after the button
jarko1972: posts small blind $0.01
flyperety: posts big blind $0.02
toubalas: sits out=20
*** HOLE CARDS ***
Dealt to the_wickstar [2d Qc]
riskmate: folds=20
the_wickstar: calls $0.02
WebCamSasha: raises $0.06 to $0.08
jarko1972: folds=20
flyperety: folds=20
the_wickstar: folds=20
Uncalled bet ($0.06) returned to WebCamSasha
WebCamSasha collected $0.07 from pot
WebCamSasha: doesn't show hand=20
*** SUMMARY ***
Total pot $0.07 | Rake $0=20
Seat 1: jarko1972 (small blind) folded before Flop
Seat 3: flyperety (big blind) folded before Flop
Seat 6: riskmate folded before Flop (didn't bet)
Seat 7: the_wickstar folded before Flop
Seat 8: WebCamSasha (button) collected ($0.07)


*********** # 4 **************
PokerStars Hand #169803214698:  Hold'em No Limit ($0.01/$0.02 USD) - 20=
17/05/01 21:45:25 CUST [2017/05/01 7:45:25 ET]
Table 'Philoctetes' 9-max Seat #7 is the button
Seat 1: jarko1972 ($2.09 in chips)=20
Seat 3: flyperety ($2.03 in chips)=20
Seat 6: riskmate ($1.92 in chips)=20
Seat 7: the_wickstar ($2.20 in chips)=20
Seat 8: WebCamSasha ($2.24 in chips)=20
WebCamSasha: posts small blind $0.01
obama552 was removed from the table for failing to post
jarko1972: posts big blind $0.02
toubalas: sits out=20
*** HOLE CARDS ***
Dealt to the_wickstar [5d 2h]
Le Clienth joins the table at seat #9=20
flyperety: folds=20
riskmate: folds=20
the_wickstar: folds=20
WebCamSasha: raises $0.03 to $0.05
jarko1972: calls $0.03
*** FLOP *** [6h 8d Th]
WebCamSasha: bets $0.06
jarko1972: folds=20
Uncalled bet ($0.06) returned to WebCamSasha
WebCamSasha collected $0.10 from pot
WebCamSasha: doesn't show hand=20
*** SUMMARY ***
Total pot $0.10 | Rake $0=20
Board [6h 8d Th]
Seat 1: jarko1972 (big blind) folded on the Flop
Seat 3: flyperety folded before Flop (didn't bet)
Seat 6: riskmate folded before Flop (didn't bet)
Seat 7: the_wickstar (button) folded before Flop (didn't bet)
Seat 8: WebCamSasha (small blind) collected ($0.10)


*********** # 5 **************
PokerStars Hand #169803207194:  Hold'em No Limit ($0.01/$0.02 USD) - 20=
17/05/01 21:45:09 CUST [2017/05/01 7:45:09 ET]
Table 'Philoctetes' 9-max Seat #6 is the button
Seat 1: jarko1972 ($2.09 in chips)=20
Seat 3: flyperety ($2.03 in chips)=20
Seat 6: riskmate ($1.92 in chips)=20
Seat 7: the_wickstar ($2.21 in chips)=20
Seat 8: WebCamSasha ($2.23 in chips)=20
the_wickstar: posts small blind $0.01
WebCamSasha: posts big blind $0.02
toubalas: sits out=20
*** HOLE CARDS ***
Dealt to the_wickstar [3s 6d]
jarko1972: folds=20
flyperety: folds=20
riskmate: folds=20
the_wickstar: folds=20
Uncalled bet ($0.01) returned to WebCamSasha
WebCamSasha collected $0.02 from pot
WebCamSasha: doesn't show hand=20
*** SUMMARY ***
Total pot $0.02 | Rake $0=20
Seat 1: jarko1972 folded before Flop (didn't bet)
Seat 3: flyperety folded before Flop (didn't bet)
Seat 6: riskmate (button) folded before Flop (didn't bet)
Seat 7: the_wickstar (small blind) folded before Flop
Seat 8: WebCamSasha (big blind) collected ($0.02)


*********** # 6 **************
PokerStars Hand #169803199185:  Hold'em No Limit ($0.01/$0.02 USD) - 20=
17/05/01 21:44:53 CUST [2017/05/01 7:44:53 ET]
Table 'Philoctetes' 9-max Seat #3 is the button
Seat 1: jarko1972 ($2.09 in chips)=20
Seat 3: flyperety ($2 in chips)=20
Seat 6: riskmate ($1.93 in chips)=20
Seat 7: the_wickstar ($2.23 in chips)=20
Seat 8: WebCamSasha ($2.23 in chips)=20
toubalas will be allowed to play after the button
riskmate: posts small blind $0.01
the_wickstar: posts big blind $0.02
*** HOLE CARDS ***
Dealt to the_wickstar [8d Qh]
WebCamSasha: folds=20
jarko1972: folds=20
flyperety: raises $0.03 to $0.05
riskmate: folds=20
the_wickstar: folds=20
Uncalled bet ($0.03) returned to flyperety
flyperety collected $0.05 from pot
flyperety: doesn't show hand=20
*** SUMMARY ***
Total pot $0.05 | Rake $0=20
Seat 1: jarko1972 folded before Flop (didn't bet)
Seat 3: flyperety (button) collected ($0.05)
Seat 6: riskmate (small blind) folded before Flop
Seat 7: the_wickstar (big blind) folded before Flop
Seat 8: WebCamSasha folded before Flop (didn't bet)


*********** # 7 **************
PokerStars Hand #169803183850:  Hold'em No Limit ($0.01/$0.02 USD) - 20=
17/05/01 21:44:21 CUST [2017/05/01 7:44:21 ET]
Table 'Philoctetes' 9-max Seat #1 is the button
Seat 1: jarko1972 ($2.15 in chips)=20
Seat 3: flyperety ($2 in chips)=20
Seat 6: riskmate ($1.86 in chips)=20
Seat 7: the_wickstar ($2.23 in chips)=20
Seat 8: WebCamSasha ($2.23 in chips)=20
flyperety: posts small blind $0.01
tomczyckii: is sitting out=20
riskmate: posts big blind $0.02
*** HOLE CARDS ***
Dealt to the_wickstar [Jc 6s]
tomczyckii leaves the table
the_wickstar: folds=20
WebCamSasha: folds=20
jarko1972: raises $0.02 to $0.04
flyperety: folds=20
toubalas joins the table at seat #5=20
riskmate: raises $0.02 to $0.06
jarko1972: calls $0.02
*** FLOP *** [5s Qc Td]
riskmate: bets $0.07
jarko1972: folds=20
Uncalled bet ($0.07) returned to riskmate
riskmate collected $0.13 from pot
riskmate: doesn't show hand=20
*** SUMMARY ***
Total pot $0.13 | Rake $0=20
Board [5s Qc Td]
Seat 1: jarko1972 (button) folded on the Flop
Seat 3: flyperety (small blind) folded before Flop
Seat 6: riskmate (big blind) collected ($0.13)
Seat 7: the_wickstar folded before Flop (didn't bet)
Seat 8: WebCamSasha folded before Flop (didn't bet)


*********** # 8 **************
PokerStars Hand #169803174175:  Hold'em No Limit ($0.01/$0.02 USD) - 20=
17/05/01 21:44:01 CUST [2017/05/01 7:44:01 ET]
Table 'Philoctetes' 9-max Seat #8 is the button
Seat 1: jarko1972 ($2.16 in chips)=20
Seat 3: flyperety ($2 in chips)=20
Seat 5: tomczyckii ($2.03 in chips)=20
Seat 6: riskmate ($1.86 in chips)=20
Seat 7: the_wickstar ($2.23 in chips)=20
Seat 8: WebCamSasha ($2.23 in chips)=20
jarko1972: posts small blind $0.01
flyperety: posts big blind $0.02
*** HOLE CARDS ***
Dealt to the_wickstar [6c 6s]
tomczyckii: raises $0.04 to $0.06
riskmate: folds=20
the_wickstar: folds=20
WebCamSasha: folds=20
jarko1972: folds=20
flyperety: folds=20
Uncalled bet ($0.04) returned to tomczyckii
tomczyckii collected $0.05 from pot
*** SUMMARY ***
Total pot $0.05 | Rake $0=20
Seat 1: jarko1972 (small blind) folded before Flop
Seat 3: flyperety (big blind) folded before Flop
Seat 5: tomczyckii collected ($0.05)
Seat 6: riskmate folded before Flop (didn't bet)
Seat 7: the_wickstar folded before Flop (didn't bet)
Seat 8: WebCamSasha (button) folded before Flop (didn't bet)


*********** # 9 **************
PokerStars Hand #169803152087:  Hold'em No Limit ($0.01/$0.02 USD) - 20=
17/05/01 21:43:16 CUST [2017/05/01 7:43:16 ET]
Table 'Philoctetes' 9-max Seat #7 is the button
Seat 1: jarko1972 ($2.18 in chips)=20
Seat 3: flyperety ($2 in chips)=20
Seat 5: tomczyckii ($2.03 in chips)=20
Seat 6: riskmate ($1.86 in chips)=20
Seat 7: the_wickstar ($2.20 in chips)=20
Seat 8: WebCamSasha ($2.24 in chips)=20
WebCamSasha: posts small blind $0.01
jarko1972: posts big blind $0.02
*** HOLE CARDS ***
Dealt to the_wickstar [Ac 6c]
flyperety: folds=20
tomczyckii: folds=20
riskmate: folds=20
the_wickstar: calls $0.02
WebCamSasha: folds=20
jarko1972: checks=20
*** FLOP *** [Td Kd Qd]
jarko1972: checks=20
the_wickstar: checks=20
*** TURN *** [Td Kd Qd] [3c]
jarko1972: checks=20
the_wickstar: checks=20
*** RIVER *** [Td Kd Qd 3c] [2h]
jarko1972: checks=20
the_wickstar: checks=20
*** SHOW DOWN ***
jarko1972: shows [9s 6h] (high card King)
the_wickstar: shows [Ac 6c] (high card Ace)
the_wickstar collected $0.05 from pot
*** SUMMARY ***
Total pot $0.05 | Rake $0=20
Board [Td Kd Qd 3c 2h]
Seat 1: jarko1972 (big blind) showed [9s 6h] and lost with high card Ki=
ng
Seat 3: flyperety folded before Flop (didn't bet)
Seat 5: tomczyckii folded before Flop (didn't bet)
Seat 6: riskmate folded before Flop (didn't bet)
Seat 7: the_wickstar (button) showed [Ac 6c] and won ($0.05) with high =
card Ace
Seat 8: WebCamSasha (small blind) folded before Flop


*********** # 10 **************
PokerStars Hand #169803137367:  Hold'em No Limit ($0.01/$0.02 USD) - 20=
17/05/01 21:42:46 CUST [2017/05/01 7:42:46 ET]
Table 'Philoctetes' 9-max Seat #6 is the button
Seat 1: jarko1972 ($2.18 in chips)=20
Seat 3: flyperety ($2 in chips)=20
Seat 5: tomczyckii ($2.03 in chips)=20
Seat 6: riskmate ($1.86 in chips)=20
Seat 7: the_wickstar ($2.21 in chips)=20
Seat 8: WebCamSasha ($2.23 in chips)=20
the_wickstar: posts small blind $0.01
WebCamSasha: posts big blind $0.02
*** HOLE CARDS ***
Dealt to the_wickstar [7s 8s]
jarko1972: folds=20
flyperety: folds=20
tomczyckii: folds=20
riskmate: folds=20
the_wickstar: folds=20
Uncalled bet ($0.01) returned to WebCamSasha
WebCamSasha collected $0.02 from pot
WebCamSasha: doesn't show hand=20
*** SUMMARY ***
Total pot $0.02 | Rake $0=20
Seat 1: jarko1972 folded before Flop (didn't bet)
Seat 3: flyperety folded before Flop (didn't bet)
Seat 5: tomczyckii folded before Flop (didn't bet)
Seat 6: riskmate (button) folded before Flop (didn't bet)
Seat 7: the_wickstar (small blind) folded before Flop
Seat 8: WebCamSasha (big blind) collected ($0.02)


*********** # 11 **************
PokerStars Hand #169803125244:  Hold'em No Limit ($0.01/$0.02 USD) - 20=
17/05/01 21:42:20 CUST [2017/05/01 7:42:20 ET]
Table 'Philoctetes' 9-max Seat #5 is the button
Seat 1: jarko1972 ($2.18 in chips)=20
Seat 3: flyperety ($2 in chips)=20
Seat 5: tomczyckii ($2 in chips)=20
Seat 6: riskmate ($1.87 in chips)=20
Seat 7: the_wickstar ($2.23 in chips)=20
Seat 8: WebCamSasha ($2.23 in chips)=20
riskmate: posts small blind $0.01
the_wickstar: posts big blind $0.02
*** HOLE CARDS ***
Dealt to the_wickstar [Tc 5h]
WebCamSasha: folds=20
jarko1972: folds=20
flyperety: folds=20
tomczyckii: raises $0.04 to $0.06
riskmate: folds=20
the_wickstar: folds=20
Uncalled bet ($0.04) returned to tomczyckii
tomczyckii collected $0.05 from pot
*** SUMMARY ***
Total pot $0.05 | Rake $0=20
Seat 1: jarko1972 folded before Flop (didn't bet)
Seat 3: flyperety folded before Flop (didn't bet)
Seat 5: tomczyckii (button) collected ($0.05)
Seat 6: riskmate (small blind) folded before Flop
Seat 7: the_wickstar (big blind) folded before Flop
Seat 8: WebCamSasha folded before Flop (didn't bet)


*********** # 12 **************
PokerStars Hand #169803104203:  Hold'em No Limit ($0.01/$0.02 USD) - 20=
17/05/01 21:41:36 CUST [2017/05/01 7:41:36 ET]
Table 'Philoctetes' 9-max Seat #3 is the button
Seat 1: jarko1972 ($2.15 in chips)=20
Seat 3: flyperety ($2 in chips)=20
Seat 5: tomczyckii ($2.01 in chips)=20
Seat 6: riskmate ($1.89 in chips)=20
Seat 7: the_wickstar ($2.23 in chips)=20
Seat 8: WebCamSasha ($2.23 in chips)=20
tomczyckii: posts small blind $0.01
riskmate: posts big blind $0.02
*** HOLE CARDS ***
Dealt to the_wickstar [4d 9c]
the_wickstar: folds=20
WebCamSasha: folds=20
jarko1972: raises $0.02 to $0.04
flyperety: folds=20
tomczyckii: folds=20
riskmate: folds=20
Uncalled bet ($0.02) returned to jarko1972
jarko1972 collected $0.05 from pot
jarko1972: doesn't show hand=20
*** SUMMARY ***
Total pot $0.05 | Rake $0=20
Seat 1: jarko1972 collected ($0.05)
Seat 3: flyperety (button) folded before Flop (didn't bet)
Seat 5: tomczyckii (small blind) folded before Flop
Seat 6: riskmate (big blind) folded before Flop
Seat 7: the_wickstar folded before Flop (didn't bet)
Seat 8: WebCamSasha folded before Flop (didn't bet)


*********** # 13 **************
PokerStars Hand #169803072273:  Hold'em No Limit ($0.01/$0.02 USD) - 20=
17/05/01 21:40:30 CUST [2017/05/01 7:40:30 ET]
Table 'Philoctetes' 9-max Seat #1 is the button
Seat 1: jarko1972 ($2.15 in chips)=20
Seat 3: flyperety ($2.04 in chips)=20
Seat 5: tomczyckii ($2.03 in chips)=20
Seat 6: riskmate ($1.89 in chips)=20
Seat 7: the_wickstar ($2.23 in chips)=20
Seat 8: WebCamSasha ($2 in chips)=20
flyperety: posts small blind $0.01
Kokoman111: is sitting out=20
tomczyckii: posts big blind $0.02
*** HOLE CARDS ***
Dealt to the_wickstar [4s Kc]
riskmate: folds=20
the_wickstar: folds=20
WebCamSasha: raises $0.04 to $0.06
jarko1972: folds=20
flyperety: raises $0.17 to $0.23
tomczyckii: folds=20
WebCamSasha: calls $0.17
*** FLOP *** [9c 4c 5d]
flyperety: checks=20
WebCamSasha: checks=20
*** TURN *** [9c 4c 5d] [7d]
flyperety: checks=20
WebCamSasha: bets $0.20
flyperety: folds=20
Uncalled bet ($0.20) returned to WebCamSasha
WebCamSasha collected $0.46 from pot
WebCamSasha: doesn't show hand=20
*** SUMMARY ***
Total pot $0.48 | Rake $0.02=20
Board [9c 4c 5d 7d]
Seat 1: jarko1972 (button) folded before Flop (didn't bet)
Seat 3: flyperety (small blind) folded on the Turn
Seat 5: tomczyckii (big blind) folded before Flop
Seat 6: riskmate folded before Flop (didn't bet)
Seat 7: the_wickstar folded before Flop (didn't bet)
Seat 8: WebCamSasha collected ($0.46)


*********** # 14 **************
PokerStars Hand #169803035492:  Hold'em No Limit ($0.01/$0.02 USD) - 20=
17/05/01 21:39:14 CUST [2017/05/01 7:39:14 ET]
Table 'Philoctetes' 9-max Seat #8 is the button
Seat 1: jarko1972 ($2.21 in chips)=20
Seat 3: flyperety ($2.06 in chips)=20
Seat 4: Kokoman111 ($2 in chips)=20
Seat 5: tomczyckii ($2.03 in chips)=20
Seat 6: riskmate ($1.95 in chips)=20
Seat 7: the_wickstar ($1.85 in chips)=20
Seat 8: WebCamSasha ($2.03 in chips)=20
jarko1972: posts small blind $0.01
flyperety: posts big blind $0.02
*** HOLE CARDS ***
Dealt to the_wickstar [Ah Qh]
Kokoman111: folds=20
tomczyckii: folds=20
riskmate: raises $0.04 to $0.06
the_wickstar: calls $0.06
WebCamSasha: calls $0.06
jarko1972: calls $0.05
flyperety: folds=20
*** FLOP *** [Qd Jh 2s]
jarko1972: checks=20
riskmate: checks=20
the_wickstar: bets $0.20
WebCamSasha: calls $0.20
jarko1972: folds=20
riskmate: folds=20
*** TURN *** [Qd Jh 2s] [7h]
the_wickstar: checks=20
WebCamSasha: checks=20
*** RIVER *** [Qd Jh 2s 7h] [2h]
the_wickstar: bets $0.15
WebCamSasha: folds=20
Uncalled bet ($0.15) returned to the_wickstar
the_wickstar collected $0.64 from pot
*** SUMMARY ***
Total pot $0.66 | Rake $0.02=20
Board [Qd Jh 2s 7h 2h]
Seat 1: jarko1972 (small blind) folded on the Flop
Seat 3: flyperety (big blind) folded before Flop
Seat 4: Kokoman111 folded before Flop (didn't bet)
Seat 5: tomczyckii folded before Flop (didn't bet)
Seat 6: riskmate folded on the Flop
Seat 7: the_wickstar collected ($0.64)
Seat 8: WebCamSasha (button) folded on the River


*********** # 15 **************
PokerStars Hand #169803023065:  Hold'em No Limit ($0.01/$0.02 USD) - 20=
17/05/01 21:38:48 CUST [2017/05/01 7:38:48 ET]
Table 'Philoctetes' 9-max Seat #7 is the button
Seat 1: jarko1972 ($2.20 in chips)=20
Seat 3: flyperety ($2.06 in chips)=20
Seat 4: Kokoman111 ($2 in chips)=20
Seat 5: tomczyckii ($2.03 in chips)=20
Seat 6: riskmate ($1.95 in chips)=20
Seat 7: the_wickstar ($1.85 in chips)=20
Seat 8: WebCamSasha ($2.04 in chips)=20
WebCamSasha: posts small blind $0.01
jarko1972: posts big blind $0.02
*** HOLE CARDS ***
Dealt to the_wickstar [6c 4h]
flyperety: folds=20
Kokoman111: folds=20
tomczyckii: folds=20
riskmate: folds=20
the_wickstar: folds=20
WebCamSasha: folds=20
Uncalled bet ($0.01) returned to jarko1972
jarko1972 collected $0.02 from pot
jarko1972: doesn't show hand=20
*** SUMMARY ***
Total pot $0.02 | Rake $0=20
Seat 1: jarko1972 (big blind) collected ($0.02)
Seat 3: flyperety folded before Flop (didn't bet)
Seat 4: Kokoman111 folded before Flop (didn't bet)
Seat 5: tomczyckii folded before Flop (didn't bet)
Seat 6: riskmate folded before Flop (didn't bet)
Seat 7: the_wickstar (button) folded before Flop (didn't bet)
Seat 8: WebCamSasha (small blind) folded before Flop


*********** # 16 **************
PokerStars Hand #169803009473:  Hold'em No Limit ($0.01/$0.02 USD) - 20=
17/05/01 21:38:20 CUST [2017/05/01 7:38:20 ET]
Table 'Philoctetes' 9-max Seat #6 is the button
Seat 1: jarko1972 ($2.20 in chips)=20
Seat 2: jackjie728 ($1.12 in chips)=20
Seat 3: flyperety ($2.03 in chips)=20
Seat 4: Kokoman111 ($2 in chips)=20
Seat 5: tomczyckii ($2.03 in chips)=20
Seat 6: riskmate ($1.95 in chips)=20
Seat 7: the_wickstar ($1.86 in chips)=20
Seat 8: WebCamSasha ($2.06 in chips)=20
the_wickstar: posts small blind $0.01
WebCamSasha: posts big blind $0.02
*** HOLE CARDS ***
Dealt to the_wickstar [5c 9d]
jarko1972: folds=20
jackjie728: folds=20
flyperety: raises $0.04 to $0.06
Kokoman111: folds=20
tomczyckii: folds=20
riskmate: folds=20
the_wickstar: folds=20
WebCamSasha: folds=20
Uncalled bet ($0.04) returned to flyperety
flyperety collected $0.05 from pot
flyperety: doesn't show hand=20
*** SUMMARY ***
Total pot $0.05 | Rake $0=20
Seat 1: jarko1972 folded before Flop (didn't bet)
Seat 2: jackjie728 folded before Flop (didn't bet)
Seat 3: flyperety collected ($0.05)
Seat 4: Kokoman111 folded before Flop (didn't bet)
Seat 5: tomczyckii folded before Flop (didn't bet)
Seat 6: riskmate (button) folded before Flop (didn't bet)
Seat 7: the_wickstar (small blind) folded before Flop
Seat 8: WebCamSasha (big blind) folded before Flop


*********** # 17 **************
PokerStars Hand #169802985647:  Hold'em No Limit ($0.01/$0.02 USD) - 20=
17/05/01 21:37:30 CUST [2017/05/01 7:37:30 ET]
Table 'Philoctetes' 9-max Seat #5 is the button
Seat 1: jarko1972 ($2.20 in chips)=20
Seat 2: jackjie728 ($1.12 in chips)=20
Seat 3: flyperety ($2.03 in chips)=20
Seat 4: Kokoman111 ($2 in chips)=20
Seat 5: tomczyckii ($2 in chips)=20
Seat 6: riskmate ($1.96 in chips)=20
Seat 7: the_wickstar ($1.88 in chips)=20
Seat 8: WebCamSasha ($2.06 in chips)=20
riskmate: posts small blind $0.01
the_wickstar: posts big blind $0.02
*** HOLE CARDS ***
Dealt to the_wickstar [Js 9d]
WebCamSasha: folds=20
jarko1972: folds=20
jackjie728: folds=20
flyperety: folds=20
Kokoman111: folds=20
tomczyckii: raises $0.04 to $0.06
riskmate: folds=20
the_wickstar: folds=20
Uncalled bet ($0.04) returned to tomczyckii
tomczyckii collected $0.05 from pot
*** SUMMARY ***
Total pot $0.05 | Rake $0=20
Seat 1: jarko1972 folded before Flop (didn't bet)
Seat 2: jackjie728 folded before Flop (didn't bet)
Seat 3: flyperety folded before Flop (didn't bet)
Seat 4: Kokoman111 folded before Flop (didn't bet)
Seat 5: tomczyckii (button) collected ($0.05)
Seat 6: riskmate (small blind) folded before Flop
Seat 7: the_wickstar (big blind) folded before Flop
Seat 8: WebCamSasha folded before Flop (didn't bet)


*********** # 18 **************
PokerStars Hand #169802951685:  Hold'em No Limit ($0.01/$0.02 USD) - 20=
17/05/01 21:36:18 CUST [2017/05/01 7:36:18 ET]
Table 'Philoctetes' 9-max Seat #4 is the button
Seat 1: jarko1972 ($2.20 in chips)=20
Seat 2: jackjie728 ($1.05 in chips)=20
Seat 3: flyperety ($2.03 in chips)=20
Seat 4: Kokoman111 ($2 in chips)=20
Seat 5: tomczyckii ($2 in chips)=20
Seat 6: riskmate ($2.02 in chips)=20
Seat 7: the_wickstar ($1.88 in chips)=20
Seat 8: WebCamSasha ($2.06 in chips)=20
tomczyckii: posts small blind $0.01
riskmate: posts big blind $0.02
*** HOLE CARDS ***
Dealt to the_wickstar [Qs 2d]
the_wickstar: folds=20
WebCamSasha: folds=20
jarko1972: folds=20
jackjie728: raises $0.04 to $0.06
flyperety: folds=20
Kokoman111: folds=20
tomczyckii: folds=20
riskmate: calls $0.04
*** FLOP *** [As Qh 9d]
riskmate: checks=20
jackjie728: bets $0.10
riskmate: folds=20
Uncalled bet ($0.10) returned to jackjie728
jackjie728 collected $0.13 from pot
jackjie728: doesn't show hand=20
*** SUMMARY ***
Total pot $0.13 | Rake $0=20
Board [As Qh 9d]
Seat 1: jarko1972 folded before Flop (didn't bet)
Seat 2: jackjie728 collected ($0.13)
Seat 3: flyperety folded before Flop (didn't bet)
Seat 4: Kokoman111 (button) folded before Flop (didn't bet)
Seat 5: tomczyckii (small blind) folded before Flop
Seat 6: riskmate (big blind) folded on the Flop
Seat 7: the_wickstar folded before Flop (didn't bet)
Seat 8: WebCamSasha folded before Flop (didn't bet)


*********** # 19 **************
PokerStars Hand #169802928444:  Hold'em No Limit ($0.01/$0.02 USD) - 20=
17/05/01 21:35:29 CUST [2017/05/01 7:35:29 ET]
Table 'Philoctetes' 9-max Seat #3 is the button
Seat 1: jarko1972 ($2.17 in chips)=20
Seat 2: jackjie728 ($1.05 in chips)=20
Seat 3: flyperety ($2.03 in chips)=20
Seat 4: Kokoman111 ($2 in chips)=20
Seat 5: tomczyckii ($2.01 in chips)=20
Seat 6: riskmate ($2.02 in chips)=20
Seat 7: the_wickstar ($1.88 in chips)=20
Seat 8: WebCamSasha ($2.06 in chips)=20
Kokoman111: posts small blind $0.01
tomczyckii: posts big blind $0.02
*** HOLE CARDS ***
Dealt to the_wickstar [4c 8s]
riskmate: folds=20
the_wickstar: folds=20
WebCamSasha: folds=20
jarko1972: raises $0.04 to $0.06
jackjie728: folds=20
flyperety: folds=20
Kokoman111: folds=20
tomczyckii: folds=20
Uncalled bet ($0.04) returned to jarko1972
jarko1972 collected $0.05 from pot
jarko1972: doesn't show hand=20
*** SUMMARY ***
Total pot $0.05 | Rake $0=20
Seat 1: jarko1972 collected ($0.05)
Seat 2: jackjie728 folded before Flop (didn't bet)
Seat 3: flyperety (button) folded before Flop (didn't bet)
Seat 4: Kokoman111 (small blind) folded before Flop
Seat 5: tomczyckii (big blind) folded before Flop
Seat 6: riskmate folded before Flop (didn't bet)
Seat 7: the_wickstar folded before Flop (didn't bet)
Seat 8: WebCamSasha folded before Flop (didn't bet)


*********** # 20 **************
PokerStars Hand #169802910844:  Hold'em No Limit ($0.01/$0.02 USD) - 20=
17/05/01 21:34:52 CUST [2017/05/01 7:34:52 ET]
Table 'Philoctetes' 9-max Seat #2 is the button
Seat 1: jarko1972 ($2.17 in chips)=20
Seat 2: jackjie728 ($1.05 in chips)=20
Seat 3: flyperety ($2.04 in chips)=20
Seat 4: Kokoman111 ($2 in chips)=20
Seat 5: tomczyckii ($2.01 in chips)=20
Seat 6: riskmate ($1.99 in chips)=20
Seat 7: the_wickstar ($1.88 in chips)=20
Seat 8: WebCamSasha ($2.06 in chips)=20
flyperety: posts small blind $0.01
Kokoman111: posts big blind $0.02
*** HOLE CARDS ***
Dealt to the_wickstar [Kc 5c]
tomczyckii: folds=20
riskmate: raises $0.04 to $0.06
the_wickstar: folds=20
WebCamSasha: folds=20
jarko1972: folds=20
jackjie728: folds=20
flyperety: folds=20
Kokoman111: folds=20
Uncalled bet ($0.04) returned to riskmate
riskmate collected $0.05 from pot
riskmate: doesn't show hand=20
*** SUMMARY ***
Total pot $0.05 | Rake $0=20
Seat 1: jarko1972 folded before Flop (didn't bet)
Seat 2: jackjie728 (button) folded before Flop (didn't bet)
Seat 3: flyperety (small blind) folded before Flop
Seat 4: Kokoman111 (big blind) folded before Flop
Seat 5: tomczyckii folded before Flop (didn't bet)
Seat 6: riskmate collected ($0.05)
Seat 7: the_wickstar folded before Flop (didn't bet)
Seat 8: WebCamSasha folded before Flop (didn't bet)


*********** # 21 **************
PokerStars Hand #169802866477:  Hold'em No Limit ($0.01/$0.02 USD) - 20=
17/05/01 21:33:18 CUST [2017/05/01 7:33:18 ET]
Table 'Philoctetes' 9-max Seat #1 is the button
Seat 1: jarko1972 ($2.17 in chips)=20
Seat 2: jackjie728 ($1.07 in chips)=20
Seat 3: flyperety ($2 in chips)=20
Seat 5: tomczyckii ($2.03 in chips)=20
Seat 6: riskmate ($1.99 in chips)=20
Seat 7: the_wickstar ($1.88 in chips)=20
Seat 8: WebCamSasha ($2.06 in chips)=20
jackjie728: posts small blind $0.01
flyperety: posts big blind $0.02
Kokoman111: sits out=20
*** HOLE CARDS ***
Dealt to the_wickstar [4s 3s]
tomczyckii: calls $0.02
riskmate: folds=20
the_wickstar: folds=20
WebCamSasha: folds=20
jarko1972: folds=20
jackjie728: calls $0.01
flyperety: checks=20
*** FLOP *** [7h 7d 8c]
jackjie728: checks=20
flyperety: checks=20
tomczyckii: checks=20
*** TURN *** [7h 7d 8c] [Ad]
jackjie728: checks=20
flyperety: bets $0.04
tomczyckii: folds=20
jackjie728: folds=20
Uncalled bet ($0.04) returned to flyperety
flyperety collected $0.06 from pot
flyperety: doesn't show hand=20
*** SUMMARY ***
Total pot $0.06 | Rake $0=20
Board [7h 7d 8c Ad]
Seat 1: jarko1972 (button) folded before Flop (didn't bet)
Seat 2: jackjie728 (small blind) folded on the Turn
Seat 3: flyperety (big blind) collected ($0.06)
Seat 5: tomczyckii folded on the Turn
Seat 6: riskmate folded before Flop (didn't bet)
Seat 7: the_wickstar folded before Flop (didn't bet)
Seat 8: WebCamSasha folded before Flop (didn't bet)


*********** # 22 **************
PokerStars Hand #169802842753:  Hold'em No Limit ($0.01/$0.02 USD) - 20=
17/05/01 21:32:28 CUST [2017/05/01 7:32:28 ET]
Table 'Philoctetes' 9-max Seat #8 is the button
Seat 1: jarko1972 ($2.18 in chips)=20
Seat 2: jackjie728 ($1 in chips)=20
Seat 3: flyperety ($2 in chips)=20
Seat 5: tomczyckii ($2.03 in chips)=20
Seat 6: riskmate ($2.05 in chips)=20
Seat 7: the_wickstar ($1.88 in chips)=20
Seat 8: WebCamSasha ($2.06 in chips)=20
jarko1972: posts small blind $0.01
jackjie728: posts big blind $0.02
Kokoman111: sits out=20
*** HOLE CARDS ***
Dealt to the_wickstar [Jd 7c]
flyperety: folds=20
tomczyckii: folds=20
riskmate: raises $0.04 to $0.06
the_wickstar: folds=20
WebCamSasha: folds=20
jarko1972: folds=20
jackjie728: calls $0.04
*** FLOP *** [Ts Qc 7h]
jackjie728: bets $0.10
riskmate: folds=20
Uncalled bet ($0.10) returned to jackjie728
jackjie728 collected $0.13 from pot
jackjie728: doesn't show hand=20
*** SUMMARY ***
Total pot $0.13 | Rake $0=20
Board [Ts Qc 7h]
Seat 1: jarko1972 (small blind) folded before Flop
Seat 2: jackjie728 (big blind) collected ($0.13)
Seat 3: flyperety folded before Flop (didn't bet)
Seat 5: tomczyckii folded before Flop (didn't bet)
Seat 6: riskmate folded on the Flop
Seat 7: the_wickstar folded before Flop (didn't bet)
Seat 8: WebCamSasha (button) folded before Flop (didn't bet)


*********** # 23 **************
PokerStars Hand #169802807563:  Hold'em No Limit ($0.01/$0.02 USD) - 20=
17/05/01 21:31:13 CUST [2017/05/01 7:31:13 ET]
Table 'Philoctetes' 9-max Seat #7 is the button
Seat 1: jarko1972 ($2.05 in chips)=20
Seat 3: flyperety ($2 in chips)=20
Seat 5: tomczyckii ($2.03 in chips)=20
Seat 6: riskmate ($2.05 in chips)=20
Seat 7: the_wickstar ($2.01 in chips)=20
Seat 8: WebCamSasha ($2.07 in chips)=20
WebCamSasha: posts small blind $0.01
jarko1972: posts big blind $0.02
jackjie728: sits out=20
Kokoman111: sits out=20
*** HOLE CARDS ***
Dealt to the_wickstar [5s As]
flyperety: folds=20
tomczyckii: folds=20
riskmate: folds=20
the_wickstar: calls $0.02
WebCamSasha: folds=20
jarko1972: checks=20
*** FLOP *** [5h 9s 3c]
jarko1972: checks=20
the_wickstar: bets $0.03
jarko1972: calls $0.03
*** TURN *** [5h 9s 3c] [7c]
jarko1972: checks=20
the_wickstar: checks=20
*** RIVER *** [5h 9s 3c 7c] [Qh]
jarko1972: bets $0.08
the_wickstar: calls $0.08
*** SHOW DOWN ***
jarko1972: shows [5d Qs] (two pair, Queens and Fives)
the_wickstar: mucks hand=20
jarko1972 collected $0.26 from pot
*** SUMMARY ***
Total pot $0.27 | Rake $0.01=20
Board [5h 9s 3c 7c Qh]
Seat 1: jarko1972 (big blind) showed [5d Qs] and won ($0.26) with two p=
air, Queens and Fives
Seat 3: flyperety folded before Flop (didn't bet)
Seat 5: tomczyckii folded before Flop (didn't bet)
Seat 6: riskmate folded before Flop (didn't bet)
Seat 7: the_wickstar (button) mucked [5s As]
Seat 8: WebCamSasha (small blind) folded before Flop


*********** # 24 **************
PokerStars Hand #169802787270:  Hold'em No Limit ($0.01/$0.02 USD) - 20=
17/05/01 21:30:29 CUST [2017/05/01 7:30:29 ET]
Table 'Philoctetes' 9-max Seat #6 is the button
Seat 1: jarko1972 ($2.05 in chips)=20
Seat 3: flyperety ($2 in chips)=20
Seat 5: tomczyckii ($2 in chips)=20
Seat 6: riskmate ($2.05 in chips)=20
Seat 7: the_wickstar ($2.02 in chips)=20
Seat 8: WebCamSasha ($2.09 in chips)=20
the_wickstar: posts small blind $0.01
WebCamSasha: posts big blind $0.02
jackjie728: sits out=20
Kokoman111: sits out=20
*** HOLE CARDS ***
Dealt to the_wickstar [Kc 4s]
jarko1972: folds=20
flyperety: folds=20
tomczyckii: raises $0.04 to $0.06
riskmate: folds=20
the_wickstar: folds=20
WebCamSasha: folds=20
Uncalled bet ($0.04) returned to tomczyckii
tomczyckii collected $0.05 from pot
*** SUMMARY ***
Total pot $0.05 | Rake $0=20
Seat 1: jarko1972 folded before Flop (didn't bet)
Seat 3: flyperety folded before Flop (didn't bet)
Seat 5: tomczyckii collected ($0.05)
Seat 6: riskmate (button) folded before Flop (didn't bet)
Seat 7: the_wickstar (small blind) folded before Flop
Seat 8: WebCamSasha (big blind) folded before Flop


*********** # 25 **************
PokerStars Hand #169802776273:  Hold'em No Limit ($0.01/$0.02 USD) - 20=
17/05/01 21:30:06 CUST [2017/05/01 7:30:06 ET]
Table 'Philoctetes' 9-max Seat #5 is the button
Seat 1: jarko1972 ($2.05 in chips)=20
Seat 3: flyperety ($2 in chips)=20
Seat 5: tomczyckii ($2 in chips)=20
Seat 6: riskmate ($2.06 in chips)=20
Seat 7: the_wickstar ($2.01 in chips)=20
Seat 8: WebCamSasha ($2.09 in chips)=20
riskmate: posts small blind $0.01
the_wickstar: posts big blind $0.02
jackjie728: sits out=20
Kokoman111: sits out=20
*** HOLE CARDS ***
Dealt to the_wickstar [Jd Qs]
WebCamSasha: folds=20
jarko1972: folds=20
flyperety: folds=20
tomczyckii: folds=20
riskmate: folds=20
Uncalled bet ($0.01) returned to the_wickstar
the_wickstar collected $0.02 from pot
*** SUMMARY ***
Total pot $0.02 | Rake $0=20
Seat 1: jarko1972 folded before Flop (didn't bet)
Seat 3: flyperety folded before Flop (didn't bet)
Seat 5: tomczyckii (button) folded before Flop (didn't bet)
Seat 6: riskmate (small blind) folded before Flop
Seat 7: the_wickstar (big blind) collected ($0.02)
Seat 8: WebCamSasha folded before Flop (didn't bet)


*********** # 26 **************
PokerStars Hand #169802765456:  Hold'em No Limit ($0.01/$0.02 USD) - 20=
17/05/01 21:29:43 CUST [2017/05/01 7:29:43 ET]
Table 'Philoctetes' 9-max Seat #3 is the button
Seat 1: jarko1972 ($2.02 in chips)=20
Seat 3: flyperety ($2 in chips)=20
Seat 5: tomczyckii ($2 in chips)=20
Seat 6: riskmate ($2.08 in chips)=20
Seat 7: the_wickstar ($2.01 in chips)=20
Seat 8: WebCamSasha ($2.09 in chips)=20
Kokoman111 will be allowed to play after the button
tomczyckii: posts small blind $0.01
riskmate: posts big blind $0.02
jackjie728: sits out=20
*** HOLE CARDS ***
Dealt to the_wickstar [Ks 8c]
the_wickstar: folds=20
WebCamSasha: folds=20
jarko1972: raises $0.04 to $0.06
flyperety: folds=20
tomczyckii: folds=20
riskmate: folds=20
Uncalled bet ($0.04) returned to jarko1972
jarko1972 collected $0.05 from pot
jarko1972: doesn't show hand=20
*** SUMMARY ***
Total pot $0.05 | Rake $0=20
Seat 1: jarko1972 collected ($0.05)
Seat 3: flyperety (button) folded before Flop (didn't bet)
Seat 5: tomczyckii (small blind) folded before Flop
Seat 6: riskmate (big blind) folded before Flop
Seat 7: the_wickstar folded before Flop (didn't bet)
Seat 8: WebCamSasha folded before Flop (didn't bet)


*********** # 27 **************
PokerStars Hand #169802726724:  Hold'em No Limit ($0.01/$0.02 USD) - 20=
17/05/01 21:28:20 CUST [2017/05/01 7:28:20 ET]
Table 'Philoctetes' 9-max Seat #1 is the button
Seat 1: jarko1972 ($2.02 in chips)=20
Seat 3: flyperety ($2.06 in chips)=20
Seat 4: vlasticka504 ($1.60 in chips)=20
Seat 5: tomczyckii ($2 in chips)=20
Seat 6: riskmate ($1.94 in chips)=20
Seat 7: the_wickstar ($2.01 in chips)=20
Seat 8: WebCamSasha ($2.09 in chips)=20
flyperety: posts small blind $0.01
vlasticka504: posts big blind $0.02
*** HOLE CARDS ***
Dealt to the_wickstar [Qh 4h]
tomczyckii: folds=20
jackjie728 joins the table at seat #2=20
riskmate: raises $0.04 to $0.06
the_wickstar: folds=20
WebCamSasha: folds=20
jarko1972: folds=20
flyperety: calls $0.05
vlasticka504: folds=20
*** FLOP *** [3h 3d 9h]
vlasticka504 leaves the table
flyperety: checks=20
riskmate: bets $0.07
flyperety: calls $0.07
*** TURN *** [3h 3d 9h] [5d]
flyperety: checks=20
riskmate: bets $0.14
Kokoman111 joins the table at seat #4=20
flyperety: folds=20
Uncalled bet ($0.14) returned to riskmate
riskmate collected $0.27 from pot
riskmate: doesn't show hand=20
*** SUMMARY ***
Total pot $0.28 | Rake $0.01=20
Board [3h 3d 9h 5d]
Seat 1: jarko1972 (button) folded before Flop (didn't bet)
Seat 3: flyperety (small blind) folded on the Turn
Seat 4: vlasticka504 (big blind) folded before Flop
Seat 5: tomczyckii folded before Flop (didn't bet)
Seat 6: riskmate collected ($0.27)
Seat 7: the_wickstar folded before Flop (didn't bet)
Seat 8: WebCamSasha folded before Flop (didn't bet)


*********** # 28 **************
PokerStars Hand #169802715670:  Hold'em No Limit ($0.01/$0.02 USD) - 20=
17/05/01 21:27:57 CUST [2017/05/01 7:27:57 ET]
Table 'Philoctetes' 9-max Seat #8 is the button
Seat 1: jarko1972 ($2 in chips)=20
Seat 3: flyperety ($2.08 in chips)=20
Seat 5: tomczyckii ($2 in chips)=20
Seat 6: riskmate ($1.94 in chips)=20
Seat 7: the_wickstar ($2.01 in chips)=20
Seat 8: WebCamSasha ($2.09 in chips)=20
jarko1972: posts small blind $0.01
flyperety: posts big blind $0.02
vlasticka504: sits out=20
*** HOLE CARDS ***
Dealt to the_wickstar [Td 3s]
tomczyckii: folds=20
riskmate: folds=20
fokysPokys14 was removed from the table for failing to post
the_wickstar: folds=20
WebCamSasha: folds=20
jarko1972: raises $0.04 to $0.06
flyperety: folds=20
Uncalled bet ($0.04) returned to jarko1972
jarko1972 collected $0.04 from pot
jarko1972: doesn't show hand=20
*** SUMMARY ***
Total pot $0.04 | Rake $0=20
Seat 1: jarko1972 (small blind) collected ($0.04)
Seat 3: flyperety (big blind) folded before Flop
Seat 5: tomczyckii folded before Flop (didn't bet)
Seat 6: riskmate folded before Flop (didn't bet)
Seat 7: the_wickstar folded before Flop (didn't bet)
Seat 8: WebCamSasha (button) folded before Flop (didn't bet)


*********** # 29 **************
PokerStars Hand #169802680789:  Hold'em No Limit ($0.01/$0.02 USD) - 20=
17/05/01 21:26:42 CUST [2017/05/01 7:26:42 ET]
Table 'Philoctetes' 9-max Seat #7 is the button
Seat 1: jarko1972 ($2 in chips)=20
Seat 3: flyperety ($2 in chips)=20
Seat 4: Koksmix87 ($2.13 in chips)=20
Seat 5: tomczyckii ($2 in chips)=20
Seat 6: riskmate ($1.94 in chips)=20
Seat 7: the_wickstar ($2.01 in chips)=20
Seat 8: WebCamSasha ($2.10 in chips)=20
WebCamSasha: posts small blind $0.01
jarko1972: posts big blind $0.02
*** HOLE CARDS ***
Dealt to the_wickstar [7s Qd]
flyperety: raises $0.04 to $0.06
Koksmix87: folds=20
tomczyckii: calls $0.06
riskmate: folds=20
the_wickstar: folds=20
WebCamSasha: folds=20
jarko1972: folds=20
*** FLOP *** [Kc 7h 3c]
flyperety: checks=20
tomczyckii: checks=20
*** TURN *** [Kc 7h 3c] [8d]
flyperety: checks=20
tomczyckii: checks=20
*** RIVER *** [Kc 7h 3c 8d] [Th]
Koksmix87 leaves the table
flyperety: checks=20
vlasticka504 joins the table at seat #4=20
tomczyckii: checks=20
*** SHOW DOWN ***
flyperety: shows [Jd Jc] (a pair of Jacks)
tomczyckii: mucks hand=20
flyperety collected $0.14 from pot
*** SUMMARY ***
Total pot $0.15 | Rake $0.01=20
Board [Kc 7h 3c 8d Th]
Seat 1: jarko1972 (big blind) folded before Flop
Seat 3: flyperety showed [Jd Jc] and won ($0.14) with a pair of Jacks
Seat 4: Koksmix87 folded before Flop (didn't bet)
Seat 5: tomczyckii mucked [Ad Qh]
Seat 6: riskmate folded before Flop (didn't bet)
Seat 7: the_wickstar (button) folded before Flop (didn't bet)
Seat 8: WebCamSasha (small blind) folded before Flop


*********** # 30 **************
PokerStars Hand #169802671287:  Hold'em No Limit ($0.01/$0.02 USD) - 20=
17/05/01 21:26:21 CUST [2017/05/01 7:26:21 ET]
Table 'Philoctetes' 9-max Seat #6 is the button
Seat 1: jarko1972 ($2 in chips)=20
Seat 3: flyperety ($2 in chips)=20
Seat 4: Koksmix87 ($2.13 in chips)=20
Seat 5: tomczyckii ($2 in chips)=20
Seat 6: riskmate ($1.94 in chips)=20
Seat 7: the_wickstar ($2.02 in chips)=20
Seat 8: WebCamSasha ($2.09 in chips)=20
the_wickstar: posts small blind $0.01
WebCamSasha: posts big blind $0.02
*** HOLE CARDS ***
Dealt to the_wickstar [4s Ts]
jarko1972: folds=20
flyperety: folds=20
Koksmix87: folds=20
tomczyckii: folds=20
riskmate: folds=20
the_wickstar: folds=20
Uncalled bet ($0.01) returned to WebCamSasha
WebCamSasha collected $0.02 from pot
WebCamSasha: doesn't show hand=20
*** SUMMARY ***
Total pot $0.02 | Rake $0=20
Seat 1: jarko1972 folded before Flop (didn't bet)
Seat 3: flyperety folded before Flop (didn't bet)
Seat 4: Koksmix87 folded before Flop (didn't bet)
Seat 5: tomczyckii folded before Flop (didn't bet)
Seat 6: riskmate (button) folded before Flop (didn't bet)
Seat 7: the_wickstar (small blind) folded before Flop
Seat 8: WebCamSasha (big blind) collected ($0.02)


*********** # 31 **************
PokerStars Hand #169802631068:  Hold'em No Limit ($0.01/$0.02 USD) - 20=
17/05/01 21:24:54 CUST [2017/05/01 7:24:54 ET]
Table 'Philoctetes' 9-max Seat #5 is the button
Seat 1: jarko1972 ($2 in chips)=20
Seat 3: flyperety ($2 in chips)=20
Seat 4: Koksmix87 ($2 in chips)=20
Seat 5: tomczyckii ($2 in chips)=20
Seat 6: riskmate ($1.95 in chips)=20
Seat 7: the_wickstar ($2.15 in chips)=20
Seat 8: WebCamSasha ($2.09 in chips)=20
Seat 9: obama552 ($5.09 in chips)=20
riskmate: posts small blind $0.01
the_wickstar: posts big blind $0.02
Koksmix87: posts big blind $0.02
*** HOLE CARDS ***
Dealt to the_wickstar [Ac Qh]
WebCamSasha: folds=20
obama552 has timed out
obama552: folds=20
jarko1972: folds=20
flyperety: folds=20
Koksmix87: raises $0.04 to $0.06
tomczyckii: folds=20
riskmate: folds=20
the_wickstar: calls $0.04
*** FLOP *** [Ts Kc Th]
the_wickstar: bets $0.07
Koksmix87: calls $0.07
*** TURN *** [Ts Kc Th] [2h]
the_wickstar: checks=20
Koksmix87: bets $0.13
the_wickstar: folds=20
Uncalled bet ($0.13) returned to Koksmix87
Koksmix87 collected $0.26 from pot
Koksmix87: doesn't show hand=20
*** SUMMARY ***
Total pot $0.27 | Rake $0.01=20
Board [Ts Kc Th 2h]
Seat 1: jarko1972 folded before Flop (didn't bet)
Seat 3: flyperety folded before Flop (didn't bet)
Seat 4: Koksmix87 collected ($0.26)
Seat 5: tomczyckii (button) folded before Flop (didn't bet)
Seat 6: riskmate (small blind) folded before Flop
Seat 7: the_wickstar (big blind) folded on the Turn
Seat 8: WebCamSasha folded before Flop (didn't bet)
Seat 9: obama552 folded before Flop (didn't bet)


*********** # 32 **************
PokerStars Hand #169802602907:  Hold'em No Limit ($0.01/$0.02 USD) - 20=
17/05/01 21:23:54 CUST [2017/05/01 7:23:54 ET]
Table 'Philoctetes' 9-max Seat #3 is the button
Seat 1: jarko1972 ($2 in chips)=20
Seat 3: flyperety ($2 in chips)=20
Seat 5: tomczyckii ($2 in chips)=20
Seat 6: riskmate ($1.97 in chips)=20
Seat 7: the_wickstar ($2.02 in chips)=20
Seat 8: WebCamSasha ($2.09 in chips)=20
Seat 9: obama552 ($5.19 in chips)=20
Koksmix87 will be allowed to play after the button
tomczyckii: posts small blind $0.01
riskmate: posts big blind $0.02
*** HOLE CARDS ***
Dealt to the_wickstar [Kh Kd]
the_wickstar: calls $0.02
WebCamSasha: folds=20
obama552: raises $0.08 to $0.10
jarko1972: folds=20
flyperety: folds=20
tomczyckii: folds=20
riskmate: folds=20
the_wickstar: raises $0.10 to $0.20
obama552: folds=20
Uncalled bet ($0.10) returned to the_wickstar
the_wickstar collected $0.23 from pot
*** SUMMARY ***
Total pot $0.23 | Rake $0=20
Seat 1: jarko1972 folded before Flop (didn't bet)
Seat 3: flyperety (button) folded before Flop (didn't bet)
Seat 5: tomczyckii (small blind) folded before Flop
Seat 6: riskmate (big blind) folded before Flop
Seat 7: the_wickstar collected ($0.23)
Seat 8: WebCamSasha folded before Flop (didn't bet)
Seat 9: obama552 folded before Flop


*********** # 33 **************
PokerStars Hand #169802581614:  Hold'em No Limit ($0.01/$0.02 USD) - 20=
17/05/01 21:23:08 CUST [2017/05/01 7:23:08 ET]
Table 'Philoctetes' 9-max Seat #1 is the button
Seat 1: jarko1972 ($2 in chips)=20
Seat 3: flyperety ($2 in chips)=20
Seat 5: tomczyckii ($2 in chips)=20
Seat 6: riskmate ($1.97 in chips)=20
Seat 7: the_wickstar ($2.04 in chips)=20
Seat 8: WebCamSasha ($2.09 in chips)=20
Seat 9: obama552 ($5.14 in chips)=20
flyperety: posts small blind $0.01
Rozovisahar: is sitting out=20
tomczyckii: posts big blind $0.02
*** HOLE CARDS ***
Dealt to the_wickstar [Qs Tc]
Rozovisahar leaves the table
riskmate: folds=20
the_wickstar: calls $0.02
WebCamSasha: folds=20
Koksmix87 joins the table at seat #4=20
obama552: raises $0.06 to $0.08
jarko1972: folds=20
flyperety: folds=20
tomczyckii: folds=20
the_wickstar: folds=20
Uncalled bet ($0.06) returned to obama552
obama552 collected $0.07 from pot
obama552: doesn't show hand=20
*** SUMMARY ***
Total pot $0.07 | Rake $0=20
Seat 1: jarko1972 (button) folded before Flop (didn't bet)
Seat 3: flyperety (small blind) folded before Flop
Seat 5: tomczyckii (big blind) folded before Flop
Seat 6: riskmate folded before Flop (didn't bet)
Seat 7: the_wickstar folded before Flop
Seat 8: WebCamSasha folded before Flop (didn't bet)
Seat 9: obama552 collected ($0.07)


*********** # 34 **************
PokerStars Hand #169802559416:  Hold'em No Limit ($0.01/$0.02 USD) - 20=
17/05/01 21:22:20 CUST [2017/05/01 7:22:20 ET]
Table 'Philoctetes' 9-max Seat #9 is the button
Seat 1: jarko1972 ($2 in chips)=20
Seat 3: flyperety ($2 in chips)=20
Seat 4: Rozovisahar ($2 in chips)=20
Seat 6: riskmate ($1.97 in chips)=20
Seat 7: the_wickstar ($2.04 in chips)=20
Seat 8: WebCamSasha ($2.03 in chips)=20
Seat 9: obama552 ($5.14 in chips)=20
jarko1972: posts small blind $0.01
flyperety: posts big blind $0.02
tomczyckii: sits out=20
*** HOLE CARDS ***
Dealt to the_wickstar [Ks 3d]
Rozovisahar: folds=20
riskmate: folds=20
the_wickstar: folds=20
WebCamSasha: raises $0.03 to $0.05
obama552: folds=20
jarko1972: folds=20
flyperety: calls $0.03
*** FLOP *** [9s 2d Qs]
flyperety: checks=20
WebCamSasha: bets $0.08
flyperety: folds=20
Uncalled bet ($0.08) returned to WebCamSasha
WebCamSasha collected $0.11 from pot
WebCamSasha: doesn't show hand=20
*** SUMMARY ***
Total pot $0.11 | Rake $0=20
Board [9s 2d Qs]
Seat 1: jarko1972 (small blind) folded before Flop
Seat 3: flyperety (big blind) folded on the Flop
Seat 4: Rozovisahar folded before Flop (didn't bet)
Seat 6: riskmate folded before Flop (didn't bet)
Seat 7: the_wickstar folded before Flop (didn't bet)
Seat 8: WebCamSasha collected ($0.11)
Seat 9: obama552 (button) folded before Flop (didn't bet)


*********** # 35 **************
PokerStars Hand #169802548276:  Hold'em No Limit ($0.01/$0.02 USD) - 20=
17/05/01 21:21:56 CUST [2017/05/01 7:21:56 ET]
Table 'Philoctetes' 9-max Seat #8 is the button
Seat 1: jarko1972 ($2.01 in chips)=20
Seat 4: Rozovisahar ($2 in chips)=20
Seat 6: riskmate ($1.97 in chips)=20
Seat 7: the_wickstar ($2.04 in chips)=20
Seat 8: WebCamSasha ($2 in chips)=20
Seat 9: obama552 ($5.15 in chips)=20
obama552: posts small blind $0.01
jarko1972: posts big blind $0.02
flyperety: sits out=20
tomczyckii: sits out=20
*** HOLE CARDS ***
Dealt to the_wickstar [2s 7h]
Rozovisahar: folds=20
riskmate: folds=20
the_wickstar: folds=20
WebCamSasha: raises $0.03 to $0.05
obama552: folds=20
jarko1972: folds=20
Uncalled bet ($0.03) returned to WebCamSasha
WebCamSasha collected $0.05 from pot
WebCamSasha: doesn't show hand=20
*** SUMMARY ***
Total pot $0.05 | Rake $0=20
Seat 1: jarko1972 (big blind) folded before Flop
Seat 4: Rozovisahar folded before Flop (didn't bet)
Seat 6: riskmate folded before Flop (didn't bet)
Seat 7: the_wickstar folded before Flop (didn't bet)
Seat 8: WebCamSasha (button) collected ($0.05)
Seat 9: obama552 (small blind) folded before Flop


*********** # 36 **************
PokerStars Hand #169802543524:  Hold'em No Limit ($0.01/$0.02 USD) - 20=
17/05/01 21:21:45 CUST [2017/05/01 7:21:45 ET]
Table 'Philoctetes' 9-max Seat #7 is the button
Seat 1: jarko1972 ($2.01 in chips)=20
Seat 4: Rozovisahar ($2 in chips)=20
Seat 6: riskmate ($1.97 in chips)=20
Seat 7: the_wickstar ($2.04 in chips)=20
Seat 8: WebCamSasha ($2 in chips)=20
Seat 9: obama552 ($5.14 in chips)=20
WebCamSasha: posts small blind $0.01
obama552: posts big blind $0.02
flyperety: sits out=20
tomczyckii: sits out=20
*** HOLE CARDS ***
Dealt to the_wickstar [Tc 7h]
jarko1972: folds=20
Rozovisahar: folds=20
riskmate: folds=20
the_wickstar: folds=20
WebCamSasha: folds=20
Uncalled bet ($0.01) returned to obama552
obama552 collected $0.02 from pot
obama552: doesn't show hand=20
*** SUMMARY ***
Total pot $0.02 | Rake $0=20
Seat 1: jarko1972 folded before Flop (didn't bet)
Seat 4: Rozovisahar folded before Flop (didn't bet)
Seat 6: riskmate folded before Flop (didn't bet)
Seat 7: the_wickstar (button) folded before Flop (didn't bet)
Seat 8: WebCamSasha (small blind) folded before Flop
Seat 9: obama552 (big blind) collected ($0.02)


*********** # 37 **************
PokerStars Hand #169802516141:  Hold'em No Limit ($0.01/$0.02 USD) - 20=
17/05/01 21:20:47 CUST [2017/05/01 7:20:47 ET]
Table 'Philoctetes' 9-max Seat #6 is the button
Seat 1: jarko1972 ($2.01 in chips)=20
Seat 4: Rozovisahar ($2 in chips)=20
Seat 6: riskmate ($1.76 in chips)=20
Seat 7: the_wickstar ($2.24 in chips)=20
Seat 8: WebCamSasha ($2 in chips)=20
Seat 9: obama552 ($5.14 in chips)=20
the_wickstar: posts small blind $0.01
WebCamSasha: posts big blind $0.02
flyperety: sits out=20
tomczyckii: sits out=20
*** HOLE CARDS ***
Dealt to the_wickstar [Qc As]
obama552: folds=20
jarko1972: folds=20
Rozovisahar: folds=20
riskmate: raises $0.04 to $0.06
the_wickstar: calls $0.05
WebCamSasha: folds=20
*** FLOP *** [4h Jc 6d]
the_wickstar: checks=20
riskmate: bets $0.07
the_wickstar: raises $0.07 to $0.14
riskmate: calls $0.07
*** TURN *** [4h Jc 6d] [Jd]
the_wickstar: checks=20
riskmate: bets $0.21
the_wickstar: folds=20
Uncalled bet ($0.21) returned to riskmate
riskmate collected $0.41 from pot
riskmate: doesn't show hand=20
*** SUMMARY ***
Total pot $0.42 | Rake $0.01=20
Board [4h Jc 6d Jd]
Seat 1: jarko1972 folded before Flop (didn't bet)
Seat 4: Rozovisahar folded before Flop (didn't bet)
Seat 6: riskmate (button) collected ($0.41)
Seat 7: the_wickstar (small blind) folded on the Turn
Seat 8: WebCamSasha (big blind) folded before Flop
Seat 9: obama552 folded before Flop (didn't bet)


*********** # 38 **************
PokerStars Hand #169802509483:  Hold'em No Limit ($0.01/$0.02 USD) - 20=
17/05/01 21:20:32 CUST [2017/05/01 7:20:32 ET]
Table 'Philoctetes' 9-max Seat #4 is the button
Seat 1: jarko1972 ($2.01 in chips)=20
Seat 4: Rozovisahar ($2 in chips)=20
Seat 6: riskmate ($1.77 in chips)=20
Seat 7: the_wickstar ($2.26 in chips)=20
Seat 8: WebCamSasha ($2 in chips)=20
Seat 9: obama552 ($5.11 in chips)=20
tomczyckii will be allowed to play after the button
riskmate: posts small blind $0.01
the_wickstar: posts big blind $0.02
flyperety: sits out=20
*** HOLE CARDS ***
Dealt to the_wickstar [4d 6d]
WebCamSasha: folds=20
obama552: raises $0.04 to $0.06
jarko1972: folds=20
Rozovisahar: folds=20
riskmate: folds=20
the_wickstar: folds=20
Uncalled bet ($0.04) returned to obama552
obama552 collected $0.05 from pot
obama552: doesn't show hand=20
*** SUMMARY ***
Total pot $0.05 | Rake $0=20
Seat 1: jarko1972 folded before Flop (didn't bet)
Seat 4: Rozovisahar (button) folded before Flop (didn't bet)
Seat 6: riskmate (small blind) folded before Flop
Seat 7: the_wickstar (big blind) folded before Flop
Seat 8: WebCamSasha folded before Flop (didn't bet)
Seat 9: obama552 collected ($0.05)


*********** # 39 **************
PokerStars Hand #169802484721:  Hold'em No Limit ($0.01/$0.02 USD) - 20=
17/05/01 21:19:39 CUST [2017/05/01 7:19:39 ET]
Table 'Philoctetes' 9-max Seat #1 is the button
Seat 1: jarko1972 ($2.01 in chips)=20
Seat 4: Rozovisahar ($2.01 in chips)=20
Seat 6: riskmate ($1.74 in chips)=20
Seat 7: the_wickstar ($2.28 in chips)=20
Seat 8: WebCamSasha ($2 in chips)=20
Seat 9: obama552 ($5.11 in chips)=20
Rozovisahar: posts small blind $0.01
Sytya88: is sitting out=20
Sytya88 leaves the table
riskmate: posts big blind $0.02
*** HOLE CARDS ***
Dealt to the_wickstar [5h 9h]
flyperety joins the table at seat #3=20
the_wickstar: calls $0.02
tomczyckii joins the table at seat #5=20
WebCamSasha: folds=20
obama552: folds=20
jarko1972: folds=20
Rozovisahar: folds=20
riskmate: checks=20
*** FLOP *** [Jd Js Ah]
riskmate: bets $0.03
the_wickstar: folds=20
Uncalled bet ($0.03) returned to riskmate
riskmate collected $0.05 from pot
riskmate: doesn't show hand=20
*** SUMMARY ***
Total pot $0.05 | Rake $0=20
Board [Jd Js Ah]
Seat 1: jarko1972 (button) folded before Flop (didn't bet)
Seat 4: Rozovisahar (small blind) folded before Flop
Seat 6: riskmate (big blind) collected ($0.05)
Seat 7: the_wickstar folded on the Flop
Seat 8: WebCamSasha folded before Flop (didn't bet)
Seat 9: obama552 folded before Flop (didn't bet)


*********** # 40 **************
PokerStars Hand #169802463567:  Hold'em No Limit ($0.01/$0.02 USD) - 20=
17/05/01 21:18:53 CUST [2017/05/01 7:18:53 ET]
Table 'Philoctetes' 9-max Seat #9 is the button
Seat 1: jarko1972 ($2.02 in chips)=20
Seat 4: Rozovisahar ($2 in chips)=20
Seat 5: Sytya88 ($2.78 in chips)=20
Seat 6: riskmate ($1.74 in chips)=20
Seat 7: the_wickstar ($2.28 in chips)=20
Seat 8: WebCamSasha ($2 in chips)=20
Seat 9: obama552 ($5.11 in chips)=20
jarko1972: posts small blind $0.01
civilknight leaves the table
fokysPokys14 has timed out while disconnected
fokysPokys14: is sitting out=20
Rozovisahar: posts big blind $0.02
*** HOLE CARDS ***
Dealt to the_wickstar [7h 5c]
Sytya88: folds=20
riskmate: folds=20
the_wickstar: folds=20
WebCamSasha: folds=20
obama552: folds=20
jarko1972: folds=20
Uncalled bet ($0.01) returned to Rozovisahar
Rozovisahar collected $0.02 from pot
Rozovisahar: doesn't show hand=20
*** SUMMARY ***
Total pot $0.02 | Rake $0=20
Seat 1: jarko1972 (small blind) folded before Flop
Seat 4: Rozovisahar (big blind) collected ($0.02)
Seat 5: Sytya88 folded before Flop (didn't bet)
Seat 6: riskmate folded before Flop (didn't bet)
Seat 7: the_wickstar folded before Flop (didn't bet)
Seat 8: WebCamSasha folded before Flop (didn't bet)
Seat 9: obama552 (button) folded before Flop (didn't bet)


*********** # 41 **************
PokerStars Hand #169802425231:  Hold'em No Limit ($0.01/$0.02 USD) - 20=
17/05/01 21:17:30 CUST [2017/05/01 7:17:30 ET]
Table 'Philoctetes' 9-max Seat #8 is the button
Seat 1: jarko1972 ($2.04 in chips)=20
Seat 2: fokysPokys14 ($1.97 in chips)=20
Seat 3: civilknight ($0.48 in chips)=20
Seat 5: Sytya88 ($2.78 in chips)=20
Seat 6: riskmate ($1.74 in chips)=20
Seat 7: the_wickstar ($1.34 in chips)=20
Seat 8: WebCamSasha ($2.02 in chips)=20
Seat 9: obama552 ($5.12 in chips)=20
obama552: posts small blind $0.01
jarko1972: posts big blind $0.02
Rozovisahar: sits out=20
*** HOLE CARDS ***
Dealt to the_wickstar [Ah Qh]
fokysPokys14: folds=20
civilknight: raises $0.06 to $0.08
Sytya88: folds=20
riskmate: folds=20
the_wickstar: calls $0.08
WebCamSasha: raises $0.18 to $0.26
obama552: folds=20
jarko1972: folds=20
fokysPokys14 is disconnected=20
civilknight: calls $0.18
the_wickstar: calls $0.18
*** FLOP *** [6h 7h 9d]
civilknight: bets $0.22 and is all-in
the_wickstar: calls $0.22
WebCamSasha: calls $0.22
*** TURN *** [6h 7h 9d] [9h]
the_wickstar: checks=20
WebCamSasha: checks=20
*** RIVER *** [6h 7h 9d 9h] [9c]
the_wickstar: checks=20
WebCamSasha: checks=20
*** SHOW DOWN ***
civilknight: shows [Kd Jh] (three of a kind, Nines)
the_wickstar: shows [Ah Qh] (a flush, Ace high)
WebCamSasha: mucks hand=20
the_wickstar collected $1.42 from pot
*** SUMMARY ***
Total pot $1.47 | Rake $0.05=20
Board [6h 7h 9d 9h 9c]
Seat 1: jarko1972 (big blind) folded before Flop
Seat 2: fokysPokys14 folded before Flop (didn't bet)
Seat 3: civilknight showed [Kd Jh] and lost with three of a kind, Nines
Seat 5: Sytya88 folded before Flop (didn't bet)
Seat 6: riskmate folded before Flop (didn't bet)
Seat 7: the_wickstar showed [Ah Qh] and won ($1.42) with a flush, Ace h=
igh
Seat 8: WebCamSasha (button) mucked [As Qs]
Seat 9: obama552 (small blind) folded before Flop


*********** # 42 **************
PokerStars Hand #169802409391:  Hold'em No Limit ($0.01/$0.02 USD) - 20=
17/05/01 21:16:56 CUST [2017/05/01 7:16:56 ET]
Table 'Philoctetes' 9-max Seat #7 is the button
Seat 1: jarko1972 ($2.04 in chips)=20
Seat 2: fokysPokys14 ($1.97 in chips)=20
Seat 3: civilknight ($0.48 in chips)=20
Seat 5: Sytya88 ($2.78 in chips)=20
Seat 6: riskmate ($1.74 in chips)=20
Seat 7: the_wickstar ($1.34 in chips)=20
Seat 8: WebCamSasha ($2 in chips)=20
Seat 9: obama552 ($5.14 in chips)=20
WebCamSasha: posts small blind $0.01
obama552: posts big blind $0.02
Rozovisahar: sits out=20
*** HOLE CARDS ***
Dealt to the_wickstar [8d 2s]
jarko1972: folds=20
fokysPokys14: folds=20
civilknight: folds=20
Sytya88: folds=20
riskmate: folds=20
the_wickstar: folds=20
WebCamSasha: raises $0.03 to $0.05
obama552: folds=20
Uncalled bet ($0.03) returned to WebCamSasha
WebCamSasha collected $0.04 from pot
WebCamSasha: doesn't show hand=20
*** SUMMARY ***
Total pot $0.04 | Rake $0=20
Seat 1: jarko1972 folded before Flop (didn't bet)
Seat 2: fokysPokys14 folded before Flop (didn't bet)
Seat 3: civilknight folded before Flop (didn't bet)
Seat 5: Sytya88 folded before Flop (didn't bet)
Seat 6: riskmate folded before Flop (didn't bet)
Seat 7: the_wickstar (button) folded before Flop (didn't bet)
Seat 8: WebCamSasha (small blind) collected ($0.04)
Seat 9: obama552 (big blind) folded before Flop


*********** # 43 **************
PokerStars Hand #169802374119:  Hold'em No Limit ($0.01/$0.02 USD) - 20=
17/05/01 21:15:40 CUST [2017/05/01 7:15:40 ET]
Table 'Philoctetes' 9-max Seat #6 is the button
Seat 1: jarko1972 ($2.04 in chips)=20
Seat 2: fokysPokys14 ($1.97 in chips)=20
Seat 3: civilknight ($0.47 in chips)=20
Seat 5: Sytya88 ($2.78 in chips)=20
Seat 6: riskmate ($1.74 in chips)=20
Seat 7: the_wickstar ($1.33 in chips)=20
Seat 8: WebCamSasha ($2 in chips)=20
Seat 9: obama552 ($5.14 in chips)=20
the_wickstar: posts small blind $0.01
WebCamSasha: posts big blind $0.02
*** HOLE CARDS ***
Dealt to the_wickstar [As 9c]
obama552: folds=20
jarko1972: folds=20
fokysPokys14: folds=20
civilknight: raises $0.02 to $0.04
Sytya88: folds=20
ciwong leaves the table
riskmate: folds=20
Rozovisahar joins the table at seat #4=20
the_wickstar: calls $0.03
WebCamSasha: calls $0.02
*** FLOP *** [Js 9d Jc]
the_wickstar: checks=20
WebCamSasha: checks=20
civilknight: bets $0.06
the_wickstar: calls $0.06
WebCamSasha: folds=20
*** TURN *** [Js 9d Jc] [8d]
the_wickstar: checks=20
civilknight: checks=20
*** RIVER *** [Js 9d Jc 8d] [9s]
the_wickstar: checks=20
civilknight: bets $0.13
the_wickstar: calls $0.13
*** SHOW DOWN ***
civilknight: shows [Th 9h] (a full house, Nines full of Jacks)
the_wickstar: shows [As 9c] (a full house, Nines full of Jacks)
the_wickstar collected $0.24 from pot
civilknight collected $0.24 from pot
*** SUMMARY ***
Total pot $0.50 | Rake $0.02=20
Board [Js 9d Jc 8d 9s]
Seat 1: jarko1972 folded before Flop (didn't bet)
Seat 2: fokysPokys14 folded before Flop (didn't bet)
Seat 3: civilknight showed [Th 9h] and won ($0.24) with a full house, N=
ines full of Jacks
Seat 5: Sytya88 folded before Flop (didn't bet)
Seat 6: riskmate (button) folded before Flop (didn't bet)
Seat 7: the_wickstar (small blind) showed [As 9c] and won ($0.24) with =
a full house, Nines full of Jacks
Seat 8: WebCamSasha (big blind) folded on the Flop
Seat 9: obama552 folded before Flop (didn't bet)


*********** # 44 **************
PokerStars Hand #169802343371:  Hold'em No Limit ($0.01/$0.02 USD) - 20=
17/05/01 21:14:34 CUST [2017/05/01 7:14:34 ET]
Table 'Philoctetes' 9-max Seat #5 is the button
Seat 1: jarko1972 ($2.04 in chips)=20
Seat 2: fokysPokys14 ($1.97 in chips)=20
Seat 3: civilknight ($0.49 in chips)=20
Seat 5: Sytya88 ($2.78 in chips)=20
Seat 6: riskmate ($1.75 in chips)=20
Seat 7: the_wickstar ($1.30 in chips)=20
Seat 8: WebCamSasha ($2 in chips)=20
Seat 9: obama552 ($5.14 in chips)=20
riskmate: posts small blind $0.01
the_wickstar: posts big blind $0.02
*** HOLE CARDS ***
Dealt to the_wickstar [8h 2h]
WebCamSasha: folds=20
obama552: folds=20
jarko1972: folds=20
fokysPokys14: folds=20
civilknight: calls $0.02
Sytya88: folds=20
riskmate: folds=20
the_wickstar: checks=20
*** FLOP *** [Kc 7s Jd]
the_wickstar: checks=20
civilknight: checks=20
*** TURN *** [Kc 7s Jd] [9d]
the_wickstar: checks=20
civilknight: checks=20
*** RIVER *** [Kc 7s Jd 9d] [6s]
the_wickstar: bets $0.02
civilknight: folds=20
Uncalled bet ($0.02) returned to the_wickstar
the_wickstar collected $0.05 from pot
*** SUMMARY ***
Total pot $0.05 | Rake $0=20
Board [Kc 7s Jd 9d 6s]
Seat 1: jarko1972 folded before Flop (didn't bet)
Seat 2: fokysPokys14 folded before Flop (didn't bet)
Seat 3: civilknight folded on the River
Seat 5: Sytya88 (button) folded before Flop (didn't bet)
Seat 6: riskmate (small blind) folded before Flop
Seat 7: the_wickstar (big blind) collected ($0.05)
Seat 8: WebCamSasha folded before Flop (didn't bet)
Seat 9: obama552 folded before Flop (didn't bet)


*********** # 45 **************
PokerStars Hand #169802313157:  Hold'em No Limit ($0.01/$0.02 USD) - 20=
17/05/01 21:13:28 CUST [2017/05/01 7:13:28 ET]
Table 'Philoctetes' 9-max Seat #4 is the button
Seat 1: jarko1972 ($2.04 in chips)=20
Seat 2: fokysPokys14 ($1.97 in chips)=20
Seat 3: civilknight ($0.72 in chips)=20
Seat 4: ciwong ($4.36 in chips)=20
Seat 5: Sytya88 ($2.79 in chips)=20
Seat 6: riskmate ($1.77 in chips)=20
Seat 7: the_wickstar ($1.06 in chips)=20
Seat 8: WebCamSasha ($2 in chips)=20
Seat 9: obama552 ($5.14 in chips)=20
Sytya88: posts small blind $0.01
riskmate: posts big blind $0.02
*** HOLE CARDS ***
Dealt to the_wickstar [As Jd]
the_wickstar: calls $0.02
WebCamSasha: folds=20
obama552: folds=20
jarko1972: folds=20
fokysPokys14: folds=20
civilknight: calls $0.02
ciwong: folds=20
Sytya88: folds=20
riskmate: checks=20
*** FLOP *** [7d Jh 3h]
riskmate: checks=20
the_wickstar: bets $0.05
civilknight: calls $0.05
riskmate: folds=20
*** TURN *** [7d Jh 3h] [Th]
the_wickstar: checks=20
civilknight: bets $0.05
the_wickstar: raises $0.11 to $0.16
civilknight: calls $0.11
*** RIVER *** [7d Jh 3h Th] [8s]
the_wickstar: checks=20
civilknight: checks=20
*** SHOW DOWN ***
the_wickstar: shows [As Jd] (a pair of Jacks)
civilknight: mucks hand=20
the_wickstar collected $0.47 from pot
*** SUMMARY ***
Total pot $0.49 | Rake $0.02=20
Board [7d Jh 3h Th 8s]
Seat 1: jarko1972 folded before Flop (didn't bet)
Seat 2: fokysPokys14 folded before Flop (didn't bet)
Seat 3: civilknight mucked [3s Kh]
Seat 4: ciwong (button) folded before Flop (didn't bet)
Seat 5: Sytya88 (small blind) folded before Flop
Seat 6: riskmate (big blind) folded on the Flop
Seat 7: the_wickstar showed [As Jd] and won ($0.47) with a pair of Jacks
Seat 8: WebCamSasha folded before Flop (didn't bet)
Seat 9: obama552 folded before Flop (didn't bet)


*********** # 46 **************
PokerStars Hand #169802291157:  Hold'em No Limit ($0.01/$0.02 USD) - 20=
17/05/01 21:12:40 CUST [2017/05/01 7:12:40 ET]
Table 'Philoctetes' 9-max Seat #3 is the button
Seat 1: jarko1972 ($2.04 in chips)=20
Seat 2: fokysPokys14 ($1.97 in chips)=20
Seat 3: civilknight ($0.72 in chips)=20
Seat 4: ciwong ($4.34 in chips)=20
Seat 5: Sytya88 ($2.81 in chips)=20
Seat 6: riskmate ($1.77 in chips)=20
Seat 7: the_wickstar ($1.06 in chips)=20
Seat 8: WebCamSasha ($2 in chips)=20
Seat 9: obama552 ($5.14 in chips)=20
ciwong: posts small blind $0.01
Sytya88: posts big blind $0.02
*** HOLE CARDS ***
Dealt to the_wickstar [2h Jd]
riskmate: folds=20
the_wickstar: folds=20
WebCamSasha: folds=20
obama552 has timed out
obama552: folds=20
jarko1972: folds=20
fokysPokys14: folds=20
civilknight: folds=20
ciwong: raises $0.04 to $0.06
Sytya88: folds=20
Uncalled bet ($0.04) returned to ciwong
ciwong collected $0.04 from pot
*** SUMMARY ***
Total pot $0.04 | Rake $0=20
Seat 1: jarko1972 folded before Flop (didn't bet)
Seat 2: fokysPokys14 folded before Flop (didn't bet)
Seat 3: civilknight (button) folded before Flop (didn't bet)
Seat 4: ciwong (small blind) collected ($0.04)
Seat 5: Sytya88 (big blind) folded before Flop
Seat 6: riskmate folded before Flop (didn't bet)
Seat 7: the_wickstar folded before Flop (didn't bet)
Seat 8: WebCamSasha folded before Flop (didn't bet)
Seat 9: obama552 folded before Flop (didn't bet)


*********** # 47 **************
PokerStars Hand #169802269489:  Hold'em No Limit ($0.01/$0.02 USD) - 20=
17/05/01 21:11:53 CUST [2017/05/01 7:11:53 ET]
Table 'Philoctetes' 9-max Seat #2 is the button
Seat 1: jarko1972 ($2.04 in chips)=20
Seat 2: fokysPokys14 ($1.97 in chips)=20
Seat 3: civilknight ($0.73 in chips)=20
Seat 4: ciwong ($4.36 in chips)=20
Seat 5: Sytya88 ($2.81 in chips)=20
Seat 6: riskmate ($1.74 in chips)=20
Seat 7: the_wickstar ($1.06 in chips)=20
Seat 8: WebCamSasha ($2 in chips)=20
Seat 9: obama552 ($5.14 in chips)=20
civilknight: posts small blind $0.01
ciwong: posts big blind $0.02
*** HOLE CARDS ***
Dealt to the_wickstar [3h Qh]
Sytya88: folds=20
riskmate: raises $0.04 to $0.06
the_wickstar: folds=20
WebCamSasha: folds=20
obama552: folds=20
jarko1972: folds=20
fokysPokys14: folds=20
civilknight: folds=20
ciwong: folds=20
Uncalled bet ($0.04) returned to riskmate
riskmate collected $0.05 from pot
riskmate: doesn't show hand=20
*** SUMMARY ***
Total pot $0.05 | Rake $0=20
Seat 1: jarko1972 folded before Flop (didn't bet)
Seat 2: fokysPokys14 (button) folded before Flop (didn't bet)
Seat 3: civilknight (small blind) folded before Flop
Seat 4: ciwong (big blind) folded before Flop
Seat 5: Sytya88 folded before Flop (didn't bet)
Seat 6: riskmate collected ($0.05)
Seat 7: the_wickstar folded before Flop (didn't bet)
Seat 8: WebCamSasha folded before Flop (didn't bet)
Seat 9: obama552 folded before Flop (didn't bet)


*********** # 48 **************
PokerStars Hand #169802249639:  Hold'em No Limit ($0.01/$0.02 USD) - 20=
17/05/01 21:11:10 CUST [2017/05/01 7:11:10 ET]
Table 'Philoctetes' 9-max Seat #1 is the button
Seat 1: jarko1972 ($2.04 in chips)=20
Seat 2: fokysPokys14 ($1.98 in chips)=20
Seat 3: civilknight ($0.75 in chips)=20
Seat 4: ciwong ($4.36 in chips)=20
Seat 5: Sytya88 ($2.81 in chips)=20
Seat 6: riskmate ($1.71 in chips)=20
Seat 7: the_wickstar ($1.06 in chips)=20
Seat 8: WebCamSasha ($2 in chips)=20
Seat 9: obama552 ($5.14 in chips)=20
fokysPokys14: posts small blind $0.01
civilknight: posts big blind $0.02
*** HOLE CARDS ***
Dealt to the_wickstar [6c 3d]
ciwong: folds=20
Sytya88: folds=20
riskmate: raises $0.04 to $0.06
the_wickstar: folds=20
WebCamSasha: folds=20
obama552: folds=20
jarko1972: folds=20
fokysPokys14: folds=20
civilknight: folds=20
Uncalled bet ($0.04) returned to riskmate
riskmate collected $0.05 from pot
riskmate: doesn't show hand=20
*** SUMMARY ***
Total pot $0.05 | Rake $0=20
Seat 1: jarko1972 (button) folded before Flop (didn't bet)
Seat 2: fokysPokys14 (small blind) folded before Flop
Seat 3: civilknight (big blind) folded before Flop
Seat 4: ciwong folded before Flop (didn't bet)
Seat 5: Sytya88 folded before Flop (didn't bet)
Seat 6: riskmate collected ($0.05)
Seat 7: the_wickstar folded before Flop (didn't bet)
Seat 8: WebCamSasha folded before Flop (didn't bet)
Seat 9: obama552 folded before Flop (didn't bet)


*********** # 49 **************
PokerStars Hand #169802230290:  Hold'em No Limit ($0.01/$0.02 USD) - 20=
17/05/01 21:10:28 CUST [2017/05/01 7:10:28 ET]
Table 'Philoctetes' 9-max Seat #9 is the button
Seat 1: jarko1972 ($2.05 in chips)=20
Seat 2: fokysPokys14 ($2 in chips)=20
Seat 3: civilknight ($0.77 in chips)=20
Seat 4: ciwong ($4.36 in chips)=20
Seat 5: Sytya88 ($2.81 in chips)=20
Seat 6: riskmate ($1.71 in chips)=20
Seat 7: the_wickstar ($1.08 in chips)=20
Seat 8: WebCamSasha ($2.02 in chips)=20
Seat 9: obama552 ($4.97 in chips)=20
jarko1972: posts small blind $0.01
fokysPokys14: posts big blind $0.02
*** HOLE CARDS ***
Dealt to the_wickstar [5d 5c]
civilknight: calls $0.02
ciwong: folds=20
Sytya88: folds=20
riskmate: folds=20
the_wickstar: calls $0.02
WebCamSasha: raises $0.08 to $0.10
obama552: raises $0.24 to $0.34
jarko1972: folds=20
fokysPokys14: folds=20
civilknight: folds=20
the_wickstar: folds=20
WebCamSasha: folds=20
Uncalled bet ($0.24) returned to obama552
obama552 collected $0.27 from pot
obama552: doesn't show hand=20
*** SUMMARY ***
Total pot $0.27 | Rake $0=20
Seat 1: jarko1972 (small blind) folded before Flop
Seat 2: fokysPokys14 (big blind) folded before Flop
Seat 3: civilknight folded before Flop
Seat 4: ciwong folded before Flop (didn't bet)
Seat 5: Sytya88 folded before Flop (didn't bet)
Seat 6: riskmate folded before Flop (didn't bet)
Seat 7: the_wickstar folded before Flop
Seat 8: WebCamSasha folded before Flop
Seat 9: obama552 (button) collected ($0.27)


*********** # 50 **************
PokerStars Hand #169802205600:  Hold'em No Limit ($0.01/$0.02 USD) - 20=
17/05/01 21:09:34 CUST [2017/05/01 7:09:34 ET]
Table 'Philoctetes' 9-max Seat #8 is the button
Seat 1: jarko1972 ($2 in chips)=20
Seat 3: civilknight ($0.79 in chips)=20
Seat 4: ciwong ($4.36 in chips)=20
Seat 5: Sytya88 ($2.81 in chips)=20
Seat 6: riskmate ($1.71 in chips)=20
Seat 7: the_wickstar ($1.10 in chips)=20
Seat 8: WebCamSasha ($2.02 in chips)=20
Seat 9: obama552 ($4.98 in chips)=20
obama552: posts small blind $0.01
jarko1972: posts big blind $0.02
fokysPokys14: sits out=20
the_wickstar: posts big blind $0.02
*** HOLE CARDS ***
Dealt to the_wickstar [Ts 7s]
civilknight: calls $0.02
ciwong: folds=20
Sytya88: folds=20
riskmate: folds=20
the_wickstar: checks=20
WebCamSasha: folds=20
obama552: folds=20
jarko1972: raises $0.10 to $0.12
civilknight: folds=20
the_wickstar: folds=20
Uncalled bet ($0.10) returned to jarko1972
jarko1972 collected $0.07 from pot
jarko1972: doesn't show hand=20
*** SUMMARY ***
Total pot $0.07 | Rake $0=20
Seat 1: jarko1972 (big blind) collected ($0.07)
Seat 3: civilknight folded before Flop
Seat 4: ciwong folded before Flop (didn't bet)
Seat 5: Sytya88 folded before Flop (didn't bet)
Seat 6: riskmate folded before Flop (didn't bet)
Seat 7: the_wickstar folded before Flop
Seat 8: WebCamSasha (button) folded before Flop (didn't bet)
Seat 9: obama552 (small blind) folded before Flop


*********** # 51 **************
PokerStars Hand #169801822867:  Hold'em No Limit ($0.01/$0.02 USD) - 20=
17/05/01 20:54:53 CUST [2017/05/01 6:54:53 ET]
Table 'Andraimon II' 9-max Seat #4 is the button
Seat 1: AND_Rivne ($0.78 in chips)=20
Seat 2: shahin1360 ($0.73 in chips)=20
Seat 3: Gwenael22 ($1.97 in chips)=20
Seat 4: the_wickstar ($1.73 in chips)=20
Seat 5: 1Asthma1 ($2.03 in chips)=20
Seat 6: Vanga333 ($2.03 in chips)=20
Seat 7: JekaPoyniak ($3.12 in chips)=20
Seat 8: Bozzuka ($2 in chips)=20
Seat 9: 415jqdub ($2.05 in chips)=20
1Asthma1: posts small blind $0.01
Vanga333: posts big blind $0.02
*** HOLE CARDS ***
Dealt to the_wickstar [Kc 9s]
JekaPoyniak: raises $0.06 to $0.08
Bozzuka: calls $0.08
415jqdub: folds=20
AND_Rivne: calls $0.08
shahin1360: folds=20
Gwenael22: folds=20
the_wickstar: calls $0.08
1Asthma1: folds=20
Vanga333: folds=20
*** FLOP *** [9d 4s 5h]
JekaPoyniak: bets $0.26
Bozzuka: folds=20
AND_Rivne: folds=20
the_wickstar: calls $0.26
*** TURN *** [9d 4s 5h] [8c]
JekaPoyniak: checks=20
the_wickstar: checks=20
*** RIVER *** [9d 4s 5h 8c] [9h]
JekaPoyniak: bets $1.50
the_wickstar: calls $1.39 and is all-in
Uncalled bet ($0.11) returned to JekaPoyniak
*** SHOW DOWN ***
JekaPoyniak: shows [8s 8d] (a full house, Eights full of Nines)
the_wickstar: shows [Kc 9s] (three of a kind, Nines)
JekaPoyniak collected $3.52 from pot
*** SUMMARY ***
Total pot $3.65 | Rake $0.13=20
Board [9d 4s 5h 8c 9h]
Seat 1: AND_Rivne folded on the Flop
Seat 2: shahin1360 folded before Flop (didn't bet)
Seat 3: Gwenael22 folded before Flop (didn't bet)
Seat 4: the_wickstar (button) showed [Kc 9s] and lost with three of a k=
ind, Nines
Seat 5: 1Asthma1 (small blind) folded before Flop
Seat 6: Vanga333 (big blind) folded before Flop
Seat 7: JekaPoyniak showed [8s 8d] and won ($3.52) with a full house, E=
ights full of Nines
Seat 8: Bozzuka folded on the Flop
Seat 9: 415jqdub folded before Flop (didn't bet)


*********** # 52 **************
PokerStars Hand #169801798875:  Hold'em No Limit ($0.01/$0.02 USD) - 20=
17/05/01 20:53:59 CUST [2017/05/01 6:53:59 ET]
Table 'Andraimon II' 9-max Seat #3 is the button
Seat 1: AND_Rivne ($0.80 in chips)=20
Seat 2: shahin1360 ($0.73 in chips)=20
Seat 3: Gwenael22 ($1.97 in chips)=20
Seat 4: the_wickstar ($1.74 in chips)=20
Seat 5: 1Asthma1 ($2.05 in chips)=20
Seat 6: Vanga333 ($2.03 in chips)=20
Seat 7: JekaPoyniak ($3.12 in chips)=20
Seat 8: Bozzuka ($2 in chips)=20
Seat 9: 415jqdub ($2 in chips)=20
the_wickstar: posts small blind $0.01
1Asthma1: posts big blind $0.02
AND_Rivne: posts big blind $0.02
*** HOLE CARDS ***
Dealt to the_wickstar [Jc 4d]
Vanga333: folds=20
JekaPoyniak: folds=20
Bozzuka: folds=20
415jqdub: raises $0.08 to $0.10
AND_Rivne: folds=20
shahin1360: folds=20
Gwenael22: folds=20
the_wickstar: folds=20
1Asthma1: folds=20
Uncalled bet ($0.08) returned to 415jqdub
415jqdub collected $0.07 from pot
415jqdub: doesn't show hand=20
*** SUMMARY ***
Total pot $0.07 | Rake $0=20
Seat 1: AND_Rivne folded before Flop
Seat 2: shahin1360 folded before Flop (didn't bet)
Seat 3: Gwenael22 (button) folded before Flop (didn't bet)
Seat 4: the_wickstar (small blind) folded before Flop
Seat 5: 1Asthma1 (big blind) folded before Flop
Seat 6: Vanga333 folded before Flop (didn't bet)
Seat 7: JekaPoyniak folded before Flop (didn't bet)
Seat 8: Bozzuka folded before Flop (didn't bet)
Seat 9: 415jqdub collected ($0.07)


*********** # 53 **************
PokerStars Hand #169801775777:  Hold'em No Limit ($0.01/$0.02 USD) - 20=
17/05/01 20:53:07 CUST [2017/05/01 6:53:07 ET]
Table 'Andraimon II' 9-max Seat #2 is the button
Seat 2: shahin1360 ($0.65 in chips)=20
Seat 3: Gwenael22 ($1.98 in chips)=20
Seat 4: the_wickstar ($1.76 in chips)=20
Seat 5: 1Asthma1 ($2.05 in chips)=20
Seat 6: Vanga333 ($2.03 in chips)=20
Seat 7: JekaPoyniak ($3.12 in chips)=20
Seat 8: Bozzuka ($2 in chips)=20
Seat 9: 415jqdub ($2.05 in chips)=20
Gwenael22: posts small blind $0.01
the_wickstar: posts big blind $0.02
*** HOLE CARDS ***
Dealt to the_wickstar [5s Qc]
AND_Rivne joins the table at seat #1=20
1Asthma1: folds=20
Vanga333: folds=20
JekaPoyniak: folds=20
Bozzuka: folds=20
415jqdub: raises $0.04 to $0.06
shahin1360: calls $0.06
Gwenael22: folds=20
the_wickstar: folds=20
*** FLOP *** [4d Ks 5h]
415jqdub: checks=20
shahin1360: bets $0.06
415jqdub: folds=20
Uncalled bet ($0.06) returned to shahin1360
shahin1360 collected $0.14 from pot
shahin1360: doesn't show hand=20
*** SUMMARY ***
Total pot $0.15 | Rake $0.01=20
Board [4d Ks 5h]
Seat 2: shahin1360 (button) collected ($0.14)
Seat 3: Gwenael22 (small blind) folded before Flop
Seat 4: the_wickstar (big blind) folded before Flop
Seat 5: 1Asthma1 folded before Flop (didn't bet)
Seat 6: Vanga333 folded before Flop (didn't bet)
Seat 7: JekaPoyniak folded before Flop (didn't bet)
Seat 8: Bozzuka folded before Flop (didn't bet)
Seat 9: 415jqdub folded on the Flop


*********** # 54 **************
PokerStars Hand #169801754560:  Hold'em No Limit ($0.01/$0.02 USD) - 20=
17/05/01 20:52:19 CUST [2017/05/01 6:52:19 ET]
Table 'Andraimon II' 9-max Seat #9 is the button
Seat 2: shahin1360 ($0.63 in chips)=20
Seat 3: Gwenael22 ($2 in chips)=20
Seat 4: the_wickstar ($1.76 in chips)=20
Seat 5: 1Asthma1 ($2.05 in chips)=20
Seat 6: Vanga333 ($2.03 in chips)=20
Seat 7: JekaPoyniak ($3.12 in chips)=20
Seat 8: Bozzuka ($2 in chips)=20
Seat 9: 415jqdub ($2.05 in chips)=20
4zander will be allowed to play after the button
shahin1360: posts small blind $0.01
Gwenael22: posts big blind $0.02
*** HOLE CARDS ***
Dealt to the_wickstar [Qs 9c]
4zander leaves the table
the_wickstar: folds=20
1Asthma1: folds=20
Vanga333: folds=20
JekaPoyniak: folds=20
Bozzuka: folds=20
415jqdub: folds=20
shahin1360: calls $0.01
Gwenael22: checks=20
*** FLOP *** [Ah Kh 7s]
shahin1360: bets $0.02
Gwenael22: folds=20
Uncalled bet ($0.02) returned to shahin1360
shahin1360 collected $0.04 from pot
shahin1360: doesn't show hand=20
*** SUMMARY ***
Total pot $0.04 | Rake $0=20
Board [Ah Kh 7s]
Seat 2: shahin1360 (small blind) collected ($0.04)
Seat 3: Gwenael22 (big blind) folded on the Flop
Seat 4: the_wickstar folded before Flop (didn't bet)
Seat 5: 1Asthma1 folded before Flop (didn't bet)
Seat 6: Vanga333 folded before Flop (didn't bet)
Seat 7: JekaPoyniak folded before Flop (didn't bet)
Seat 8: Bozzuka folded before Flop (didn't bet)
Seat 9: 415jqdub (button) folded before Flop (didn't bet)


*********** # 55 **************
PokerStars Hand #169801720998:  Hold'em No Limit ($0.01/$0.02 USD) - 20=
17/05/01 20:51:04 CUST [2017/05/01 6:51:04 ET]
Table 'Andraimon II' 9-max Seat #8 is the button
Seat 2: shahin1360 ($0.32 in chips)=20
Seat 3: Gwenael22 ($2 in chips)=20
Seat 4: the_wickstar ($1.76 in chips)=20
Seat 5: 1Asthma1 ($2.05 in chips)=20
Seat 6: Vanga333 ($2.03 in chips)=20
Seat 7: JekaPoyniak ($3.12 in chips)=20
Seat 8: Bozzuka ($2.05 in chips)=20
Seat 9: 415jqdub ($2.06 in chips)=20
415jqdub: posts small blind $0.01
Zybex696 was removed from the table for failing to post
shahin1360: posts big blind $0.02
*** HOLE CARDS ***
Dealt to the_wickstar [6s Jc]
Gwenael22: folds=20
the_wickstar: folds=20
1Asthma1: folds=20
Vanga333: folds=20
JekaPoyniak: folds=20
Bozzuka: raises $0.04 to $0.06
415jqdub: folds=20
4zander joins the table at seat #1=20
shahin1360: calls $0.04
*** FLOP *** [6h 4h Kh]
shahin1360: checks=20
Bozzuka: bets $0.10
shahin1360: calls $0.10
*** TURN *** [6h 4h Kh] [4c]
shahin1360: checks=20
Bozzuka: bets $0.24
shahin1360: calls $0.16 and is all-in
Uncalled bet ($0.08) returned to Bozzuka
*** RIVER *** [6h 4h Kh 4c] [9d]
*** SHOW DOWN ***
shahin1360: shows [9h Qh] (a flush, King high)
Bozzuka: shows [As Kd] (two pair, Kings and Fours)
shahin1360 collected $0.63 from pot
*** SUMMARY ***
Total pot $0.65 | Rake $0.02=20
Board [6h 4h Kh 4c 9d]
Seat 2: shahin1360 (big blind) showed [9h Qh] and won ($0.63) with a fl=
ush, King high
Seat 3: Gwenael22 folded before Flop (didn't bet)
Seat 4: the_wickstar folded before Flop (didn't bet)
Seat 5: 1Asthma1 folded before Flop (didn't bet)
Seat 6: Vanga333 folded before Flop (didn't bet)
Seat 7: JekaPoyniak folded before Flop (didn't bet)
Seat 8: Bozzuka (button) showed [As Kd] and lost with two pair, Kings a=
nd Fours
Seat 9: 415jqdub (small blind) folded before Flop


*********** # 56 **************
PokerStars Hand #169801705955:  Hold'em No Limit ($0.01/$0.02 USD) - 20=
17/05/01 20:50:30 CUST [2017/05/01 6:50:30 ET]
Table 'Andraimon II' 9-max Seat #7 is the button
Seat 2: shahin1360 ($0.32 in chips)=20
Seat 3: Gwenael22 ($2 in chips)=20
Seat 4: the_wickstar ($1.76 in chips)=20
Seat 5: 1Asthma1 ($2.11 in chips)=20
Seat 6: Vanga333 ($2.03 in chips)=20
Seat 7: JekaPoyniak ($3.03 in chips)=20
Seat 8: Bozzuka ($2.06 in chips)=20
Seat 9: 415jqdub ($2.08 in chips)=20
Bozzuka: posts small blind $0.01
415jqdub: posts big blind $0.02
*** HOLE CARDS ***
Dealt to the_wickstar [9c Td]
shahin1360: folds=20
Gwenael22: folds=20
the_wickstar: folds=20
1Asthma1: raises $0.04 to $0.06
Vanga333: folds=20
JekaPoyniak: raises $0.12 to $0.18
Bozzuka: folds=20
415jqdub: folds=20
1Asthma1: folds=20
Uncalled bet ($0.12) returned to JekaPoyniak
JekaPoyniak collected $0.15 from pot
*** SUMMARY ***
Total pot $0.15 | Rake $0=20
Seat 2: shahin1360 folded before Flop (didn't bet)
Seat 3: Gwenael22 folded before Flop (didn't bet)
Seat 4: the_wickstar folded before Flop (didn't bet)
Seat 5: 1Asthma1 folded before Flop
Seat 6: Vanga333 folded before Flop (didn't bet)
Seat 7: JekaPoyniak (button) collected ($0.15)
Seat 8: Bozzuka (small blind) folded before Flop
Seat 9: 415jqdub (big blind) folded before Flop


*********** # 57 **************
PokerStars Hand #169801689531:  Hold'em No Limit ($0.01/$0.02 USD) - 20=
17/05/01 20:49:53 CUST [2017/05/01 6:49:53 ET]
Table 'Andraimon II' 9-max Seat #6 is the button
Seat 2: shahin1360 ($0.32 in chips)=20
Seat 3: Gwenael22 ($2 in chips)=20
Seat 4: the_wickstar ($1.76 in chips)=20
Seat 5: 1Asthma1 ($2.11 in chips)=20
Seat 6: Vanga333 ($2.03 in chips)=20
Seat 7: JekaPoyniak ($3.09 in chips)=20
Seat 8: Bozzuka ($2 in chips)=20
Seat 9: 415jqdub ($2.08 in chips)=20
JekaPoyniak: posts small blind $0.01
Bozzuka: posts big blind $0.02
*** HOLE CARDS ***
Dealt to the_wickstar [5h Tc]
415jqdub: folds=20
shahin1360: folds=20
Gwenael22: folds=20
the_wickstar: folds=20
1Asthma1: folds=20
Vanga333: folds=20
JekaPoyniak: raises $0.04 to $0.06
Bozzuka: raises $0.12 to $0.18
JekaPoyniak: folds=20
Uncalled bet ($0.12) returned to Bozzuka
Bozzuka collected $0.12 from pot
Bozzuka: doesn't show hand=20
*** SUMMARY ***
Total pot $0.12 | Rake $0=20
Seat 2: shahin1360 folded before Flop (didn't bet)
Seat 3: Gwenael22 folded before Flop (didn't bet)
Seat 4: the_wickstar folded before Flop (didn't bet)
Seat 5: 1Asthma1 folded before Flop (didn't bet)
Seat 6: Vanga333 (button) folded before Flop (didn't bet)
Seat 7: JekaPoyniak (small blind) folded before Flop
Seat 8: Bozzuka (big blind) collected ($0.12)
Seat 9: 415jqdub folded before Flop (didn't bet)


*********** # 58 **************
PokerStars Hand #169801675702:  Hold'em No Limit ($0.01/$0.02 USD) - 20=
17/05/01 20:49:22 CUST [2017/05/01 6:49:22 ET]
Table 'Andraimon II' 9-max Seat #5 is the button
Seat 2: shahin1360 ($0.32 in chips)=20
Seat 3: Gwenael22 ($2 in chips)=20
Seat 4: the_wickstar ($1.76 in chips)=20
Seat 5: 1Asthma1 ($2.08 in chips)=20
Seat 6: Vanga333 ($2.04 in chips)=20
Seat 7: JekaPoyniak ($3.11 in chips)=20
Seat 8: Bozzuka ($2 in chips)=20
Seat 9: 415jqdub ($2.08 in chips)=20
Vanga333: posts small blind $0.01
JekaPoyniak: posts big blind $0.02
*** HOLE CARDS ***
Dealt to the_wickstar [2s Jd]
Bozzuka: folds=20
415jqdub: folds=20
shahin1360: folds=20
Gwenael22: folds=20
the_wickstar: folds=20
1Asthma1: raises $0.03 to $0.05
Vanga333: folds=20
JekaPoyniak: folds=20
Uncalled bet ($0.03) returned to 1Asthma1
1Asthma1 collected $0.05 from pot
*** SUMMARY ***
Total pot $0.05 | Rake $0=20
Seat 2: shahin1360 folded before Flop (didn't bet)
Seat 3: Gwenael22 folded before Flop (didn't bet)
Seat 4: the_wickstar folded before Flop (didn't bet)
Seat 5: 1Asthma1 (button) collected ($0.05)
Seat 6: Vanga333 (small blind) folded before Flop
Seat 7: JekaPoyniak (big blind) folded before Flop
Seat 8: Bozzuka folded before Flop (didn't bet)
Seat 9: 415jqdub folded before Flop (didn't bet)


*********** # 59 **************
PokerStars Hand #169801658169:  Hold'em No Limit ($0.01/$0.02 USD) - 20=
17/05/01 20:48:43 CUST [2017/05/01 6:48:43 ET]
Table 'Andraimon II' 9-max Seat #4 is the button
Seat 2: shahin1360 ($0.32 in chips)=20
Seat 3: Gwenael22 ($2 in chips)=20
Seat 4: the_wickstar ($1.76 in chips)=20
Seat 5: 1Asthma1 ($2.09 in chips)=20
Seat 6: Vanga333 ($2.03 in chips)=20
Seat 7: JekaPoyniak ($3.11 in chips)=20
Seat 8: Bozzuka ($2 in chips)=20
Seat 9: 415jqdub ($2.08 in chips)=20
1Asthma1: posts small blind $0.01
Vanga333: posts big blind $0.02
*** HOLE CARDS ***
Dealt to the_wickstar [4s Kh]
JekaPoyniak: folds=20
Bozzuka: folds=20
415jqdub: folds=20
shahin1360: folds=20
Gwenael22: folds=20
the_wickstar: folds=20
1Asthma1: folds=20
Uncalled bet ($0.01) returned to Vanga333
Vanga333 collected $0.02 from pot
Vanga333: doesn't show hand=20
*** SUMMARY ***
Total pot $0.02 | Rake $0=20
Seat 2: shahin1360 folded before Flop (didn't bet)
Seat 3: Gwenael22 folded before Flop (didn't bet)
Seat 4: the_wickstar (button) folded before Flop (didn't bet)
Seat 5: 1Asthma1 (small blind) folded before Flop
Seat 6: Vanga333 (big blind) collected ($0.02)
Seat 7: JekaPoyniak folded before Flop (didn't bet)
Seat 8: Bozzuka folded before Flop (didn't bet)
Seat 9: 415jqdub folded before Flop (didn't bet)


*********** # 60 **************
PokerStars Hand #169801628923:  Hold'em No Limit ($0.01/$0.02 USD) - 20=
17/05/01 20:47:38 CUST [2017/05/01 6:47:38 ET]
Table 'Andraimon II' 9-max Seat #3 is the button
Seat 2: shahin1360 ($0.32 in chips)=20
Seat 3: Gwenael22 ($2 in chips)=20
Seat 4: the_wickstar ($1.82 in chips)=20
Seat 5: 1Asthma1 ($2.11 in chips)=20
Seat 6: Vanga333 ($2.03 in chips)=20
Seat 7: JekaPoyniak ($3.11 in chips)=20
Seat 8: Bozzuka ($2 in chips)=20
Seat 9: 415jqdub ($2 in chips)=20
the_wickstar: posts small blind $0.01
1Asthma1: posts big blind $0.02
*** HOLE CARDS ***
Dealt to the_wickstar [Ah Jd]
Vanga333: folds=20
JekaPoyniak: folds=20
Bozzuka: folds=20
415jqdub: raises $0.04 to $0.06
shahin1360: folds=20
Gwenael22: folds=20
the_wickstar: calls $0.05
1Asthma1: folds=20
*** FLOP *** [3c 7s 9s]
the_wickstar: checks=20
415jqdub: bets $0.12
the_wickstar: folds=20
Uncalled bet ($0.12) returned to 415jqdub
415jqdub collected $0.14 from pot
415jqdub: doesn't show hand=20
*** SUMMARY ***
Total pot $0.14 | Rake $0=20
Board [3c 7s 9s]
Seat 2: shahin1360 folded before Flop (didn't bet)
Seat 3: Gwenael22 (button) folded before Flop (didn't bet)
Seat 4: the_wickstar (small blind) folded on the Flop
Seat 5: 1Asthma1 (big blind) folded before Flop
Seat 6: Vanga333 folded before Flop (didn't bet)
Seat 7: JekaPoyniak folded before Flop (didn't bet)
Seat 8: Bozzuka folded before Flop (didn't bet)
Seat 9: 415jqdub collected ($0.14)


*********** # 61 **************
PokerStars Hand #169801601177:  Hold'em No Limit ($0.01/$0.02 USD) - 20=
17/05/01 20:46:35 CUST [2017/05/01 6:46:35 ET]
Table 'Andraimon II' 9-max Seat #2 is the button
Seat 2: shahin1360 ($0.32 in chips)=20
Seat 3: Gwenael22 ($2.01 in chips)=20
Seat 4: the_wickstar ($1.66 in chips)=20
Seat 5: 1Asthma1 ($2.11 in chips)=20
Seat 6: Vanga333 ($2.03 in chips)=20
Seat 7: JekaPoyniak ($3.11 in chips)=20
Seat 8: Bozzuka ($2.01 in chips)=20
Seat 9: 415jqdub ($2 in chips)=20
Gwenael22: posts small blind $0.01
the_wickstar: posts big blind $0.02
*** HOLE CARDS ***
Dealt to the_wickstar [Kh Qs]
1Asthma1: folds=20
Vanga333: folds=20
JekaPoyniak: folds=20
Bozzuka: raises $0.04 to $0.06
415jqdub: folds=20
shahin1360: folds=20
Gwenael22: folds=20
the_wickstar: calls $0.04
*** FLOP *** [Kd 5h Kc]
the_wickstar: checks=20
Bozzuka: bets $0.10
the_wickstar: raises $0.10 to $0.20
Bozzuka: folds=20
Uncalled bet ($0.10) returned to the_wickstar
the_wickstar collected $0.32 from pot
*** SUMMARY ***
Total pot $0.33 | Rake $0.01=20
Board [Kd 5h Kc]
Seat 2: shahin1360 (button) folded before Flop (didn't bet)
Seat 3: Gwenael22 (small blind) folded before Flop
Seat 4: the_wickstar (big blind) collected ($0.32)
Seat 5: 1Asthma1 folded before Flop (didn't bet)
Seat 6: Vanga333 folded before Flop (didn't bet)
Seat 7: JekaPoyniak folded before Flop (didn't bet)
Seat 8: Bozzuka folded on the Flop
Seat 9: 415jqdub folded before Flop (didn't bet)


*********** # 62 **************
PokerStars Hand #169801570874:  Hold'em No Limit ($0.01/$0.02 USD) - 20=
17/05/01 20:45:27 CUST [2017/05/01 6:45:27 ET]
Table 'Andraimon II' 9-max Seat #9 is the button
Seat 2: shahin1360 ($0.38 in chips)=20
Seat 3: Gwenael22 ($2.03 in chips)=20
Seat 4: the_wickstar ($1.66 in chips)=20
Seat 5: 1Asthma1 ($2.03 in chips)=20
Seat 6: Vanga333 ($2.03 in chips)=20
Seat 7: JekaPoyniak ($3.11 in chips)=20
Seat 8: Bozzuka ($2.01 in chips)=20
Seat 9: 415jqdub ($2 in chips)=20
shahin1360: posts small blind $0.01
Gwenael22: posts big blind $0.02
*** HOLE CARDS ***
Dealt to the_wickstar [9d 7d]
the_wickstar: folds=20
1Asthma1: raises $0.04 to $0.06
Vanga333: folds=20
JekaPoyniak: folds=20
Bozzuka: folds=20
415jqdub: folds=20
shahin1360: calls $0.05
Gwenael22: folds=20
*** FLOP *** [2s Qh Kc]
shahin1360: checks=20
1Asthma1: bets $0.09
shahin1360: folds=20
Uncalled bet ($0.09) returned to 1Asthma1
1Asthma1 collected $0.14 from pot
*** SUMMARY ***
Total pot $0.14 | Rake $0=20
Board [2s Qh Kc]
Seat 2: shahin1360 (small blind) folded on the Flop
Seat 3: Gwenael22 (big blind) folded before Flop
Seat 4: the_wickstar folded before Flop (didn't bet)
Seat 5: 1Asthma1 collected ($0.14)
Seat 6: Vanga333 folded before Flop (didn't bet)
Seat 7: JekaPoyniak folded before Flop (didn't bet)
Seat 8: Bozzuka folded before Flop (didn't bet)
Seat 9: 415jqdub (button) folded before Flop (didn't bet)


*********** # 63 **************
PokerStars Hand #169801559057:  Hold'em No Limit ($0.01/$0.02 USD) - 20=
17/05/01 20:45:01 CUST [2017/05/01 6:45:01 ET]
Table 'Andraimon II' 9-max Seat #8 is the button
Seat 2: shahin1360 ($0.40 in chips)=20
Seat 3: Gwenael22 ($2.03 in chips)=20
Seat 4: the_wickstar ($1.66 in chips)=20
Seat 5: 1Asthma1 ($2.03 in chips)=20
Seat 6: Vanga333 ($2 in chips)=20
Seat 7: JekaPoyniak ($3.11 in chips)=20
Seat 8: Bozzuka ($2.01 in chips)=20
Seat 9: 415jqdub ($2.01 in chips)=20
415jqdub: posts small blind $0.01
shahin1360: posts big blind $0.02
*** HOLE CARDS ***
Dealt to the_wickstar [Tc 5d]
Gwenael22: folds=20
the_wickstar: folds=20
1Asthma1: folds=20
Vanga333: raises $0.03 to $0.05
JekaPoyniak: folds=20
Bozzuka: folds=20
415jqdub: folds=20
shahin1360: folds=20
Uncalled bet ($0.03) returned to Vanga333
Vanga333 collected $0.05 from pot
Vanga333: doesn't show hand=20
*** SUMMARY ***
Total pot $0.05 | Rake $0=20
Seat 2: shahin1360 (big blind) folded before Flop
Seat 3: Gwenael22 folded before Flop (didn't bet)
Seat 4: the_wickstar folded before Flop (didn't bet)
Seat 5: 1Asthma1 folded before Flop (didn't bet)
Seat 6: Vanga333 collected ($0.05)
Seat 7: JekaPoyniak folded before Flop (didn't bet)
Seat 8: Bozzuka (button) folded before Flop (didn't bet)
Seat 9: 415jqdub (small blind) folded before Flop


*********** # 64 **************
PokerStars Hand #169801534964:  Hold'em No Limit ($0.01/$0.02 USD) - 20=
17/05/01 20:44:06 CUST [2017/05/01 6:44:06 ET]
Table 'Andraimon II' 9-max Seat #7 is the button
Seat 2: shahin1360 ($0.40 in chips)=20
Seat 3: Gwenael22 ($2.03 in chips)=20
Seat 4: the_wickstar ($1.66 in chips)=20
Seat 5: 1Asthma1 ($2 in chips)=20
Seat 6: Vanga333 ($2 in chips)=20
Seat 7: JekaPoyniak ($3.11 in chips)=20
Seat 8: Bozzuka ($2.02 in chips)=20
Seat 9: 415jqdub ($2.03 in chips)=20
Bozzuka: posts small blind $0.01
415jqdub: posts big blind $0.02
*** HOLE CARDS ***
Dealt to the_wickstar [6d Ah]
shahin1360: folds=20
Gwenael22: folds=20
the_wickstar: folds=20
1Asthma1: raises $0.04 to $0.06
Vanga333: folds=20
JekaPoyniak: folds=20
Bozzuka: folds=20
415jqdub: folds=20
Uncalled bet ($0.04) returned to 1Asthma1
1Asthma1 collected $0.05 from pot
*** SUMMARY ***
Total pot $0.05 | Rake $0=20
Seat 2: shahin1360 folded before Flop (didn't bet)
Seat 3: Gwenael22 folded before Flop (didn't bet)
Seat 4: the_wickstar folded before Flop (didn't bet)
Seat 5: 1Asthma1 collected ($0.05)
Seat 6: Vanga333 folded before Flop (didn't bet)
Seat 7: JekaPoyniak (button) folded before Flop (didn't bet)
Seat 8: Bozzuka (small blind) folded before Flop
Seat 9: 415jqdub (big blind) folded before Flop


*********** # 65 **************
PokerStars Hand #169801478686:  Hold'em No Limit ($0.01/$0.02 USD) - 20=
17/05/01 20:41:59 CUST [2017/05/01 6:41:59 ET]
Table 'Andraimon II' 9-max Seat #6 is the button
Seat 2: shahin1360 ($0.44 in chips)=20
Seat 3: Gwenael22 ($2.03 in chips)=20
Seat 4: the_wickstar ($1.66 in chips)=20
Seat 5: 1Asthma1 ($2.01 in chips)=20
Seat 6: Vanga333 ($2.09 in chips)=20
Seat 7: JekaPoyniak ($2.09 in chips)=20
Seat 8: Bozzuka ($2.06 in chips)=20
Seat 9: 415jqdub ($2.03 in chips)=20
JekaPoyniak: posts small blind $0.01
Bozzuka: posts big blind $0.02
*** HOLE CARDS ***
Dealt to the_wickstar [Kh 6d]
415jqdub: folds=20
shahin1360: raises $0.02 to $0.04
Gwenael22: folds=20
the_wickstar: folds=20
1Asthma1: calls $0.04
Vanga333: calls $0.04
JekaPoyniak: calls $0.03
Bozzuka: calls $0.02
*** FLOP *** [5d 3s 9d]
JekaPoyniak: checks=20
Bozzuka: checks=20
shahin1360: checks=20
1Asthma1: bets $0.12
Vanga333: calls $0.12
JekaPoyniak: raises $0.12 to $0.24
Bozzuka: folds=20
shahin1360: folds=20
1Asthma1: calls $0.12
Vanga333: calls $0.12
*** TURN *** [5d 3s 9d] [Ks]
JekaPoyniak: bets $0.44
1Asthma1: calls $0.44
Vanga333: folds=20
*** RIVER *** [5d 3s 9d Ks] [Ac]
JekaPoyniak: bets $1.31
1Asthma1: folds=20
Uncalled bet ($1.31) returned to JekaPoyniak
JekaPoyniak collected $1.74 from pot
*** SUMMARY ***
Total pot $1.80 | Rake $0.06=20
Board [5d 3s 9d Ks Ac]
Seat 2: shahin1360 folded on the Flop
Seat 3: Gwenael22 folded before Flop (didn't bet)
Seat 4: the_wickstar folded before Flop (didn't bet)
Seat 5: 1Asthma1 folded on the River
Seat 6: Vanga333 (button) folded on the Turn
Seat 7: JekaPoyniak (small blind) collected ($1.74)
Seat 8: Bozzuka (big blind) folded on the Flop
Seat 9: 415jqdub folded before Flop (didn't bet)


*********** # 66 **************
PokerStars Hand #169801464385:  Hold'em No Limit ($0.01/$0.02 USD) - 20=
17/05/01 20:41:26 CUST [2017/05/01 6:41:26 ET]
Table 'Andraimon II' 9-max Seat #5 is the button
Seat 2: shahin1360 ($0.41 in chips)=20
Seat 3: Gwenael22 ($2.03 in chips)=20
Seat 4: the_wickstar ($1.66 in chips)=20
Seat 5: 1Asthma1 ($2.01 in chips)=20
Seat 6: Vanga333 ($2.10 in chips)=20
Seat 7: JekaPoyniak ($2.11 in chips)=20
Seat 8: Bozzuka ($2.06 in chips)=20
Seat 9: 415jqdub ($2.03 in chips)=20
Vanga333: posts small blind $0.01
JekaPoyniak: posts big blind $0.02
*** HOLE CARDS ***
Dealt to the_wickstar [Qd 9c]
Bozzuka: folds=20
415jqdub: folds=20
shahin1360: raises $0.06 to $0.08
Gwenael22: folds=20
the_wickstar: folds=20
1Asthma1: folds=20
Vanga333: folds=20
JekaPoyniak: folds=20
Uncalled bet ($0.06) returned to shahin1360
shahin1360 collected $0.05 from pot
shahin1360: doesn't show hand=20
*** SUMMARY ***
Total pot $0.05 | Rake $0=20
Seat 2: shahin1360 collected ($0.05)
Seat 3: Gwenael22 folded before Flop (didn't bet)
Seat 4: the_wickstar folded before Flop (didn't bet)
Seat 5: 1Asthma1 (button) folded before Flop (didn't bet)
Seat 6: Vanga333 (small blind) folded before Flop
Seat 7: JekaPoyniak (big blind) folded before Flop
Seat 8: Bozzuka folded before Flop (didn't bet)
Seat 9: 415jqdub folded before Flop (didn't bet)


*********** # 67 **************
PokerStars Hand #169801435367:  Hold'em No Limit ($0.01/$0.02 USD) - 20=
17/05/01 20:40:21 CUST [2017/05/01 6:40:21 ET]
Table 'Andraimon II' 9-max Seat #4 is the button
Seat 2: shahin1360 ($0.17 in chips)=20
Seat 3: Gwenael22 ($2.03 in chips)=20
Seat 4: the_wickstar ($1.83 in chips)=20
Seat 5: 1Asthma1 ($2.02 in chips)=20
Seat 6: Vanga333 ($2.12 in chips)=20
Seat 7: JekaPoyniak ($2.17 in chips)=20
Seat 8: Bozzuka ($2.06 in chips)=20
Seat 9: 415jqdub ($2.03 in chips)=20
1Asthma1: posts small blind $0.01
Vanga333: posts big blind $0.02
*** HOLE CARDS ***
Dealt to the_wickstar [Jd Kd]
JekaPoyniak: raises $0.04 to $0.06
Bozzuka: folds=20
415jqdub: folds=20
shahin1360: raises $0.11 to $0.17 and is all-in
Gwenael22: folds=20
the_wickstar: calls $0.17
1Asthma1: folds=20
Vanga333: folds=20
JekaPoyniak: folds=20
*** FLOP *** [6h 3d 4c]
*** TURN *** [6h 3d 4c] [9s]
*** RIVER *** [6h 3d 4c 9s] [6s]
*** SHOW DOWN ***
shahin1360: shows [Ts Ad] (a pair of Sixes)
the_wickstar: shows [Jd Kd] (a pair of Sixes - lower kicker)
shahin1360 collected $0.41 from pot
*** SUMMARY ***
Total pot $0.43 | Rake $0.02=20
Board [6h 3d 4c 9s 6s]
Seat 2: shahin1360 showed [Ts Ad] and won ($0.41) with a pair of Sixes
Seat 3: Gwenael22 folded before Flop (didn't bet)
Seat 4: the_wickstar (button) showed [Jd Kd] and lost with a pair of Si=
xes
Seat 5: 1Asthma1 (small blind) folded before Flop
Seat 6: Vanga333 (big blind) folded before Flop
Seat 7: JekaPoyniak folded before Flop
Seat 8: Bozzuka folded before Flop (didn't bet)
Seat 9: 415jqdub folded before Flop (didn't bet)


*********** # 68 **************
PokerStars Hand #169801411167:  Hold'em No Limit ($0.01/$0.02 USD) - 20=
17/05/01 20:39:25 CUST [2017/05/01 6:39:25 ET]
Table 'Andraimon II' 9-max Seat #3 is the button
Seat 2: shahin1360 ($0.14 in chips)=20
Seat 3: Gwenael22 ($2.03 in chips)=20
Seat 4: the_wickstar ($1.84 in chips)=20
Seat 5: 1Asthma1 ($2.04 in chips)=20
Seat 6: Vanga333 ($2.12 in chips)=20
Seat 7: JekaPoyniak ($2.17 in chips)=20
Seat 8: Bozzuka ($2.06 in chips)=20
Seat 9: 415jqdub ($2.03 in chips)=20
the_wickstar: posts small blind $0.01
1Asthma1: posts big blind $0.02
*** HOLE CARDS ***
Dealt to the_wickstar [3s 7h]
Vanga333: folds=20
JekaPoyniak has timed out
JekaPoyniak: folds=20
Bozzuka: folds=20
415jqdub: folds=20
shahin1360: raises $0.12 to $0.14 and is all-in
Gwenael22: folds=20
the_wickstar: folds=20
1Asthma1: folds=20
Uncalled bet ($0.12) returned to shahin1360
shahin1360 collected $0.05 from pot
shahin1360: doesn't show hand=20
*** SUMMARY ***
Total pot $0.05 | Rake $0=20
Seat 2: shahin1360 collected ($0.05)
Seat 3: Gwenael22 (button) folded before Flop (didn't bet)
Seat 4: the_wickstar (small blind) folded before Flop
Seat 5: 1Asthma1 (big blind) folded before Flop
Seat 6: Vanga333 folded before Flop (didn't bet)
Seat 7: JekaPoyniak folded before Flop (didn't bet)
Seat 8: Bozzuka folded before Flop (didn't bet)
Seat 9: 415jqdub folded before Flop (didn't bet)


*********** # 69 **************
PokerStars Hand #169801392586:  Hold'em No Limit ($0.01/$0.02 USD) - 20=
17/05/01 20:38:43 CUST [2017/05/01 6:38:43 ET]
Table 'Andraimon II' 9-max Seat #2 is the button
Seat 2: shahin1360 ($0.14 in chips)=20
Seat 3: Gwenael22 ($2.04 in chips)=20
Seat 4: the_wickstar ($1.83 in chips)=20
Seat 5: 1Asthma1 ($2.04 in chips)=20
Seat 6: Vanga333 ($2.12 in chips)=20
Seat 7: JekaPoyniak ($2.17 in chips)=20
Seat 8: Bozzuka ($2.06 in chips)=20
Seat 9: 415jqdub ($2.03 in chips)=20
Gwenael22: posts small blind $0.01
the_wickstar: posts big blind $0.02
*** HOLE CARDS ***
Dealt to the_wickstar [8h Tc]
1Asthma1: folds=20
Vanga333: folds=20
JekaPoyniak: folds=20
Bozzuka: folds=20
415jqdub: folds=20
shahin1360: folds=20
Gwenael22: folds=20
Uncalled bet ($0.01) returned to the_wickstar
the_wickstar collected $0.02 from pot
*** SUMMARY ***
Total pot $0.02 | Rake $0=20
Seat 2: shahin1360 (button) folded before Flop (didn't bet)
Seat 3: Gwenael22 (small blind) folded before Flop
Seat 4: the_wickstar (big blind) collected ($0.02)
Seat 5: 1Asthma1 folded before Flop (didn't bet)
Seat 6: Vanga333 folded before Flop (didn't bet)
Seat 7: JekaPoyniak folded before Flop (didn't bet)
Seat 8: Bozzuka folded before Flop (didn't bet)
Seat 9: 415jqdub folded before Flop (didn't bet)


*********** # 70 **************
PokerStars Hand #169801354223:  Hold'em No Limit ($0.01/$0.02 USD) - 20=
17/05/01 20:37:17 CUST [2017/05/01 6:37:17 ET]
Table 'Andraimon II' 9-max Seat #9 is the button
Seat 2: shahin1360 ($0.15 in chips)=20
Seat 3: Gwenael22 ($1.97 in chips)=20
Seat 4: the_wickstar ($1.83 in chips)=20
Seat 5: 1Asthma1 ($2.04 in chips)=20
Seat 6: Vanga333 ($2.12 in chips)=20
Seat 7: JekaPoyniak ($2.17 in chips)=20
Seat 8: Bozzuka ($2.06 in chips)=20
Seat 9: 415jqdub ($2.09 in chips)=20
shahin1360: posts small blind $0.01
Gwenael22: posts big blind $0.02
*** HOLE CARDS ***
Dealt to the_wickstar [6d 9d]
the_wickstar: folds=20
1Asthma1: folds=20
Vanga333: folds=20
JekaPoyniak: folds=20
Bozzuka: folds=20
415jqdub: raises $0.04 to $0.06
shahin1360: folds=20
Gwenael22: calls $0.04
*** FLOP *** [Ts Qc 9c]
Gwenael22: checks=20
415jqdub: checks=20
*** TURN *** [Ts Qc 9c] [Qd]
Gwenael22: checks=20
415jqdub: checks=20
*** RIVER *** [Ts Qc 9c Qd] [2h]
Gwenael22: checks=20
415jqdub: checks=20
*** SHOW DOWN ***
Gwenael22: shows [Kd As] (a pair of Queens)
415jqdub: mucks hand=20
Gwenael22 collected $0.13 from pot
*** SUMMARY ***
Total pot $0.13 | Rake $0=20
Board [Ts Qc 9c Qd 2h]
Seat 2: shahin1360 (small blind) folded before Flop
Seat 3: Gwenael22 (big blind) showed [Kd As] and won ($0.13) with a pai=
r of Queens
Seat 4: the_wickstar folded before Flop (didn't bet)
Seat 5: 1Asthma1 folded before Flop (didn't bet)
Seat 6: Vanga333 folded before Flop (didn't bet)
Seat 7: JekaPoyniak folded before Flop (didn't bet)
Seat 8: Bozzuka folded before Flop (didn't bet)
Seat 9: 415jqdub (button) mucked [Ah 7c]


*********** # 71 **************
PokerStars Hand #169801341639:  Hold'em No Limit ($0.01/$0.02 USD) - 20=
17/05/01 20:36:48 CUST [2017/05/01 6:36:48 ET]
Table 'Andraimon II' 9-max Seat #8 is the button
Seat 2: shahin1360 ($0.17 in chips)=20
Seat 3: Gwenael22 ($1.97 in chips)=20
Seat 4: the_wickstar ($1.83 in chips)=20
Seat 5: 1Asthma1 ($2.04 in chips)=20
Seat 6: Vanga333 ($2.12 in chips)=20
Seat 7: JekaPoyniak ($2.14 in chips)=20
Seat 8: Bozzuka ($2.06 in chips)=20
Seat 9: 415jqdub ($2.10 in chips)=20
415jqdub: posts small blind $0.01
shahin1360: posts big blind $0.02
*** HOLE CARDS ***
Dealt to the_wickstar [8s 5d]
Gwenael22: folds=20
the_wickstar: folds=20
1Asthma1: folds=20
Vanga333: folds=20
JekaPoyniak: raises $0.06 to $0.08
Bozzuka: folds=20
415jqdub: folds=20
shahin1360: folds=20
Uncalled bet ($0.06) returned to JekaPoyniak
JekaPoyniak collected $0.05 from pot
*** SUMMARY ***
Total pot $0.05 | Rake $0=20
Seat 2: shahin1360 (big blind) folded before Flop
Seat 3: Gwenael22 folded before Flop (didn't bet)
Seat 4: the_wickstar folded before Flop (didn't bet)
Seat 5: 1Asthma1 folded before Flop (didn't bet)
Seat 6: Vanga333 folded before Flop (didn't bet)
Seat 7: JekaPoyniak collected ($0.05)
Seat 8: Bozzuka (button) folded before Flop (didn't bet)
Seat 9: 415jqdub (small blind) folded before Flop


*********** # 72 **************
PokerStars Hand #169801322289:  Hold'em No Limit ($0.01/$0.02 USD) - 20=
17/05/01 20:36:04 CUST [2017/05/01 6:36:04 ET]
Table 'Andraimon II' 9-max Seat #7 is the button
Seat 2: shahin1360 ($0.17 in chips)=20
Seat 3: Gwenael22 ($1.97 in chips)=20
Seat 4: the_wickstar ($1.83 in chips)=20
Seat 5: 1Asthma1 ($2.04 in chips)=20
Seat 6: Vanga333 ($2.17 in chips)=20
Seat 7: JekaPoyniak ($2.14 in chips)=20
Seat 8: Bozzuka ($2.11 in chips)=20
Seat 9: 415jqdub ($2 in chips)=20
Bozzuka: posts small blind $0.01
415jqdub: posts big blind $0.02
*** HOLE CARDS ***
Dealt to the_wickstar [Qh 9s]
shahin1360: folds=20
Gwenael22: folds=20
the_wickstar: folds=20
1Asthma1: folds=20
Vanga333: raises $0.03 to $0.05
JekaPoyniak: folds=20
Bozzuka: calls $0.04
415jqdub: raises $0.25 to $0.30
Vanga333: folds=20
Bozzuka: folds=20
Uncalled bet ($0.25) returned to 415jqdub
415jqdub collected $0.15 from pot
415jqdub: doesn't show hand=20
*** SUMMARY ***
Total pot $0.15 | Rake $0=20
Seat 2: shahin1360 folded before Flop (didn't bet)
Seat 3: Gwenael22 folded before Flop (didn't bet)
Seat 4: the_wickstar folded before Flop (didn't bet)
Seat 5: 1Asthma1 folded before Flop (didn't bet)
Seat 6: Vanga333 folded before Flop
Seat 7: JekaPoyniak (button) folded before Flop (didn't bet)
Seat 8: Bozzuka (small blind) folded before Flop
Seat 9: 415jqdub (big blind) collected ($0.15)


*********** # 73 **************
PokerStars Hand #169801309858:  Hold'em No Limit ($0.01/$0.02 USD) - 20=
17/05/01 20:35:36 CUST [2017/05/01 6:35:36 ET]
Table 'Andraimon II' 9-max Seat #6 is the button
Seat 2: shahin1360 ($0.17 in chips)=20
Seat 3: Gwenael22 ($1.97 in chips)=20
Seat 4: the_wickstar ($1.83 in chips)=20
Seat 5: 1Asthma1 ($2.09 in chips)=20
Seat 6: Vanga333 ($2.17 in chips)=20
Seat 7: JekaPoyniak ($2.15 in chips)=20
Seat 8: Bozzuka ($2.05 in chips)=20
Seat 9: 415jqdub ($2 in chips)=20
JekaPoyniak: posts small blind $0.01
Bozzuka: posts big blind $0.02
*** HOLE CARDS ***
Dealt to the_wickstar [Kc 8d]
415jqdub: folds=20
shahin1360: folds=20
Gwenael22: folds=20
the_wickstar: folds=20
1Asthma1: raises $0.03 to $0.05
Vanga333: folds=20
JekaPoyniak: folds=20
Bozzuka: raises $0.11 to $0.16
1Asthma1: folds=20
Uncalled bet ($0.11) returned to Bozzuka
Bozzuka collected $0.11 from pot
Bozzuka: doesn't show hand=20
*** SUMMARY ***
Total pot $0.11 | Rake $0=20
Seat 2: shahin1360 folded before Flop (didn't bet)
Seat 3: Gwenael22 folded before Flop (didn't bet)
Seat 4: the_wickstar folded before Flop (didn't bet)
Seat 5: 1Asthma1 folded before Flop
Seat 6: Vanga333 (button) folded before Flop (didn't bet)
Seat 7: JekaPoyniak (small blind) folded before Flop
Seat 8: Bozzuka (big blind) collected ($0.11)
Seat 9: 415jqdub folded before Flop (didn't bet)


*********** # 74 **************
PokerStars Hand #169801299716:  Hold'em No Limit ($0.01/$0.02 USD) - 20=
17/05/01 20:35:12 CUST [2017/05/01 6:35:12 ET]
Table 'Andraimon II' 9-max Seat #5 is the button
Seat 2: shahin1360 ($0.17 in chips)=20
Seat 3: Gwenael22 ($1.97 in chips)=20
Seat 4: the_wickstar ($1.83 in chips)=20
Seat 5: 1Asthma1 ($2.09 in chips)=20
Seat 6: Vanga333 ($2.23 in chips)=20
Seat 7: JekaPoyniak ($2.09 in chips)=20
Seat 8: Bozzuka ($2.05 in chips)=20
Seat 9: 415jqdub ($2 in chips)=20
Vanga333: posts small blind $0.01
JekaPoyniak: posts big blind $0.02
*** HOLE CARDS ***
Dealt to the_wickstar [5s 7c]
Bozzuka: folds=20
415jqdub: folds=20
shahin1360: folds=20
Gwenael22: folds=20
the_wickstar: folds=20
1Asthma1: folds=20
Vanga333: raises $0.04 to $0.06
JekaPoyniak: raises $0.12 to $0.18
Vanga333: folds=20
Uncalled bet ($0.12) returned to JekaPoyniak
JekaPoyniak collected $0.12 from pot
*** SUMMARY ***
Total pot $0.12 | Rake $0=20
Seat 2: shahin1360 folded before Flop (didn't bet)
Seat 3: Gwenael22 folded before Flop (didn't bet)
Seat 4: the_wickstar folded before Flop (didn't bet)
Seat 5: 1Asthma1 (button) folded before Flop (didn't bet)
Seat 6: Vanga333 (small blind) folded before Flop
Seat 7: JekaPoyniak (big blind) collected ($0.12)
Seat 8: Bozzuka folded before Flop (didn't bet)
Seat 9: 415jqdub folded before Flop (didn't bet)


*********** # 75 **************
PokerStars Hand #169801286372:  Hold'em No Limit ($0.01/$0.02 USD) - 20=
17/05/01 20:34:42 CUST [2017/05/01 6:34:42 ET]
Table 'Andraimon II' 9-max Seat #4 is the button
Seat 2: shahin1360 ($0.17 in chips)=20
Seat 3: Gwenael22 ($1.97 in chips)=20
Seat 4: the_wickstar ($1.83 in chips)=20
Seat 5: 1Asthma1 ($2.07 in chips)=20
Seat 6: Vanga333 ($2.25 in chips)=20
Seat 7: JekaPoyniak ($2.09 in chips)=20
Seat 8: Bozzuka ($2.05 in chips)=20
Seat 9: 415jqdub ($2 in chips)=20
1Asthma1: posts small blind $0.01
Vanga333: posts big blind $0.02
*** HOLE CARDS ***
Dealt to the_wickstar [Th 7c]
JekaPoyniak: folds=20
Bozzuka: folds=20
415jqdub: folds=20
shahin1360: folds=20
Gwenael22: folds=20
the_wickstar: folds=20
1Asthma1: raises $0.04 to $0.06
Vanga333: folds=20
Uncalled bet ($0.04) returned to 1Asthma1
1Asthma1 collected $0.04 from pot
*** SUMMARY ***
Total pot $0.04 | Rake $0=20
Seat 2: shahin1360 folded before Flop (didn't bet)
Seat 3: Gwenael22 folded before Flop (didn't bet)
Seat 4: the_wickstar (button) folded before Flop (didn't bet)
Seat 5: 1Asthma1 (small blind) collected ($0.04)
Seat 6: Vanga333 (big blind) folded before Flop
Seat 7: JekaPoyniak folded before Flop (didn't bet)
Seat 8: Bozzuka folded before Flop (didn't bet)
Seat 9: 415jqdub folded before Flop (didn't bet)


*********** # 76 **************
PokerStars Hand #169801269658:  Hold'em No Limit ($0.01/$0.02 USD) - 20=
17/05/01 20:34:04 CUST [2017/05/01 6:34:04 ET]
Table 'Andraimon II' 9-max Seat #3 is the button
Seat 2: shahin1360 ($0.14 in chips)=20
Seat 3: Gwenael22 ($1.97 in chips)=20
Seat 4: the_wickstar ($1.84 in chips)=20
Seat 5: 1Asthma1 ($2.09 in chips)=20
Seat 6: Vanga333 ($2.25 in chips)=20
Seat 7: JekaPoyniak ($2.09 in chips)=20
Seat 8: Bozzuka ($2.05 in chips)=20
Seat 9: 415jqdub ($2 in chips)=20
the_wickstar: posts small blind $0.01
1Asthma1: posts big blind $0.02
*** HOLE CARDS ***
Dealt to the_wickstar [6s Ah]
Vanga333: folds=20
JekaPoyniak: folds=20
Bozzuka: folds=20
415jqdub: folds=20
shahin1360: raises $0.06 to $0.08
Gwenael22: folds=20
the_wickstar: folds=20
1Asthma1: folds=20
Uncalled bet ($0.06) returned to shahin1360
shahin1360 collected $0.05 from pot
shahin1360: doesn't show hand=20
*** SUMMARY ***
Total pot $0.05 | Rake $0=20
Seat 2: shahin1360 collected ($0.05)
Seat 3: Gwenael22 (button) folded before Flop (didn't bet)
Seat 4: the_wickstar (small blind) folded before Flop
Seat 5: 1Asthma1 (big blind) folded before Flop
Seat 6: Vanga333 folded before Flop (didn't bet)
Seat 7: JekaPoyniak folded before Flop (didn't bet)
Seat 8: Bozzuka folded before Flop (didn't bet)
Seat 9: 415jqdub folded before Flop (didn't bet)


*********** # 77 **************
PokerStars Hand #169801243433:  Hold'em No Limit ($0.01/$0.02 USD) - 20=
17/05/01 20:33:04 CUST [2017/05/01 6:33:04 ET]
Table 'Andraimon II' 9-max Seat #2 is the button
Seat 2: shahin1360 ($0.14 in chips)=20
Seat 3: Gwenael22 ($1.98 in chips)=20
Seat 4: the_wickstar ($1.86 in chips)=20
Seat 5: 1Asthma1 ($2.15 in chips)=20
Seat 6: Vanga333 ($2.17 in chips)=20
Seat 7: JekaPoyniak ($2.09 in chips)=20
Seat 8: Bozzuka ($2.05 in chips)=20
Seat 9: 415jqdub ($2 in chips)=20
Gwenael22: posts small blind $0.01
the_wickstar: posts big blind $0.02
*** HOLE CARDS ***
Dealt to the_wickstar [5h 3h]
1Asthma1: raises $0.04 to $0.06
Vanga333: calls $0.06
JekaPoyniak: folds=20
Bozzuka: folds=20
415jqdub: folds=20
shahin1360: folds=20
Gwenael22: folds=20
the_wickstar: folds=20
*** FLOP *** [8h Ah Js]
1Asthma1: checks=20
Vanga333: checks=20
*** TURN *** [8h Ah Js] [8c]
1Asthma1: checks=20
Vanga333: bets $0.10
1Asthma1: folds=20
Uncalled bet ($0.10) returned to Vanga333
Vanga333 collected $0.14 from pot
Vanga333: doesn't show hand=20
*** SUMMARY ***
Total pot $0.15 | Rake $0.01=20
Board [8h Ah Js 8c]
Seat 2: shahin1360 (button) folded before Flop (didn't bet)
Seat 3: Gwenael22 (small blind) folded before Flop
Seat 4: the_wickstar (big blind) folded before Flop
Seat 5: 1Asthma1 folded on the Turn
Seat 6: Vanga333 collected ($0.14)
Seat 7: JekaPoyniak folded before Flop (didn't bet)
Seat 8: Bozzuka folded before Flop (didn't bet)
Seat 9: 415jqdub folded before Flop (didn't bet)


*********** # 78 **************
PokerStars Hand #169801227283:  Hold'em No Limit ($0.01/$0.02 USD) - 20=
17/05/01 20:32:27 CUST [2017/05/01 6:32:27 ET]
Table 'Andraimon II' 9-max Seat #9 is the button
Seat 2: shahin1360 ($0.15 in chips)=20
Seat 3: Gwenael22 ($2 in chips)=20
Seat 4: the_wickstar ($1.88 in chips)=20
Seat 5: 1Asthma1 ($2.15 in chips)=20
Seat 6: Vanga333 ($2.17 in chips)=20
Seat 7: JekaPoyniak ($2.09 in chips)=20
Seat 8: Bozzuka ($2 in chips)=20
Seat 9: 415jqdub ($2 in chips)=20
shahin1360: posts small blind $0.01
Gwenael22: posts big blind $0.02
*** HOLE CARDS ***
Dealt to the_wickstar [As 7h]
the_wickstar: calls $0.02
1Asthma1: folds=20
Vanga333: folds=20
JekaPoyniak: folds=20
Bozzuka: raises $0.06 to $0.08
415jqdub: folds=20
shahin1360: folds=20
Gwenael22: folds=20
the_wickstar: folds=20
Uncalled bet ($0.06) returned to Bozzuka
Bozzuka collected $0.07 from pot
Bozzuka: doesn't show hand=20
*** SUMMARY ***
Total pot $0.07 | Rake $0=20
Seat 2: shahin1360 (small blind) folded before Flop
Seat 3: Gwenael22 (big blind) folded before Flop
Seat 4: the_wickstar folded before Flop
Seat 5: 1Asthma1 folded before Flop (didn't bet)
Seat 6: Vanga333 folded before Flop (didn't bet)
Seat 7: JekaPoyniak folded before Flop (didn't bet)
Seat 8: Bozzuka collected ($0.07)
Seat 9: 415jqdub (button) folded before Flop (didn't bet)


*********** # 79 **************
PokerStars Hand #169801197587:  Hold'em No Limit ($0.01/$0.02 USD) - 20=
17/05/01 20:31:19 CUST [2017/05/01 6:31:19 ET]
Table 'Andraimon II' 9-max Seat #8 is the button
Seat 2: shahin1360 ($0.17 in chips)=20
Seat 4: the_wickstar ($0.96 in chips)=20
Seat 5: 1Asthma1 ($2.15 in chips)=20
Seat 6: Vanga333 ($2.17 in chips)=20
Seat 7: JekaPoyniak ($2.09 in chips)=20
Seat 8: Bozzuka ($2.56 in chips)=20
Seat 9: 415jqdub ($2 in chips)=20
415jqdub: posts small blind $0.01
shahin1360: posts big blind $0.02
Gwenael22: sits out=20
*** HOLE CARDS ***
Dealt to the_wickstar [Qd Ac]
the_wickstar: calls $0.02
1Asthma1: folds=20
Vanga333: folds=20
JekaPoyniak: folds=20
Bozzuka: raises $0.06 to $0.08
415jqdub: folds=20
shahin1360: folds=20
the_wickstar: raises $0.06 to $0.14
Bozzuka: raises $0.31 to $0.45
the_wickstar: calls $0.31
*** FLOP *** [2s Td 7d]
the_wickstar: checks=20
Bozzuka: bets $0.68
the_wickstar: calls $0.51 and is all-in
Uncalled bet ($0.17) returned to Bozzuka
*** TURN *** [2s Td 7d] [Ks]
*** RIVER *** [2s Td 7d Ks] [Jh]
*** SHOW DOWN ***
the_wickstar: shows [Qd Ac] (a straight, Ten to Ace)
Bozzuka: shows [Ad Jc] (a pair of Jacks)
the_wickstar collected $1.88 from pot
*** SUMMARY ***
Total pot $1.95 | Rake $0.07=20
Board [2s Td 7d Ks Jh]
Seat 2: shahin1360 (big blind) folded before Flop
Seat 4: the_wickstar showed [Qd Ac] and won ($1.88) with a straight, Te=
n to Ace
Seat 5: 1Asthma1 folded before Flop (didn't bet)
Seat 6: Vanga333 folded before Flop (didn't bet)
Seat 7: JekaPoyniak folded before Flop (didn't bet)
Seat 8: Bozzuka (button) showed [Ad Jc] and lost with a pair of Jacks
Seat 9: 415jqdub (small blind) folded before Flop


*********** # 80 **************
PokerStars Hand #169801181170:  Hold'em No Limit ($0.01/$0.02 USD) - 20=
17/05/01 20:30:41 CUST [2017/05/01 6:30:41 ET]
Table 'Andraimon II' 9-max Seat #7 is the button
Seat 2: shahin1360 ($0.17 in chips)=20
Seat 4: the_wickstar ($1.02 in chips)=20
Seat 5: 1Asthma1 ($2.15 in chips)=20
Seat 6: Vanga333 ($2.17 in chips)=20
Seat 7: JekaPoyniak ($2.09 in chips)=20
Seat 8: Bozzuka ($2.48 in chips)=20
Seat 9: 415jqdub ($2 in chips)=20
Bozzuka: posts small blind $0.01
415jqdub: posts big blind $0.02
Gwenael22: sits out=20
*** HOLE CARDS ***
Dealt to the_wickstar [3h 3s]
shahin1360: folds=20
the_wickstar: calls $0.02
1Asthma1: folds=20
Vanga333: folds=20
JekaPoyniak: folds=20
Bozzuka: raises $0.04 to $0.06
415jqdub: folds=20
the_wickstar: calls $0.04
*** FLOP *** [Qd 2c As]
Bozzuka: bets $0.11
the_wickstar: folds=20
Uncalled bet ($0.11) returned to Bozzuka
Bozzuka collected $0.14 from pot
Bozzuka: doesn't show hand=20
*** SUMMARY ***
Total pot $0.14 | Rake $0=20
Board [Qd 2c As]
Seat 2: shahin1360 folded before Flop (didn't bet)
Seat 4: the_wickstar folded on the Flop
Seat 5: 1Asthma1 folded before Flop (didn't bet)
Seat 6: Vanga333 folded before Flop (didn't bet)
Seat 7: JekaPoyniak (button) folded before Flop (didn't bet)
Seat 8: Bozzuka (small blind) collected ($0.14)
Seat 9: 415jqdub (big blind) folded before Flop


*********** # 81 **************
PokerStars Hand #169801154304:  Hold'em No Limit ($0.01/$0.02 USD) - 20=
17/05/01 20:29:39 CUST [2017/05/01 6:29:39 ET]
Table 'Andraimon II' 9-max Seat #6 is the button
Seat 2: shahin1360 ($0.17 in chips)=20
Seat 4: the_wickstar ($1.08 in chips)=20
Seat 5: 1Asthma1 ($2.59 in chips)=20
Seat 6: Vanga333 ($2.17 in chips)=20
Seat 7: JekaPoyniak ($2.10 in chips)=20
Seat 8: Bozzuka ($2 in chips)=20
JekaPoyniak: posts small blind $0.01
Bozzuka: posts big blind $0.02
415jqdub: sits out=20
Gwenael22: sits out=20
*** HOLE CARDS ***
Dealt to the_wickstar [9h 6h]
shahin1360: folds=20
the_wickstar: raises $0.04 to $0.06
1Asthma1: raises $0.12 to $0.18
Vanga333: folds=20
JekaPoyniak: folds=20
Bozzuka: calls $0.16
the_wickstar: folds=20
*** FLOP *** [7c Kd 8s]
Bozzuka: checks=20
1Asthma1: bets $0.26
Bozzuka: raises $0.47 to $0.73
1Asthma1: folds=20
Uncalled bet ($0.47) returned to Bozzuka
Bozzuka collected $0.92 from pot
Bozzuka: doesn't show hand=20
*** SUMMARY ***
Total pot $0.95 | Rake $0.03=20
Board [7c Kd 8s]
Seat 2: shahin1360 folded before Flop (didn't bet)
Seat 4: the_wickstar folded before Flop
Seat 5: 1Asthma1 folded on the Flop
Seat 6: Vanga333 (button) folded before Flop (didn't bet)
Seat 7: JekaPoyniak (small blind) folded before Flop
Seat 8: Bozzuka (big blind) collected ($0.92)


*********** # 82 **************
PokerStars Hand #169801129074:  Hold'em No Limit ($0.01/$0.02 USD) - 20=
17/05/01 20:28:40 CUST [2017/05/01 6:28:40 ET]
Table 'Andraimon II' 9-max Seat #5 is the button
Seat 2: shahin1360 ($0.25 in chips)=20
Seat 4: the_wickstar ($1.16 in chips)=20
Seat 5: 1Asthma1 ($2.59 in chips)=20
Seat 6: Vanga333 ($2 in chips)=20
Seat 7: JekaPoyniak ($2.12 in chips)=20
Seat 8: Bozzuka ($2 in chips)=20
Vanga333: posts small blind $0.01
JekaPoyniak: posts big blind $0.02
415jqdub: sits out=20
Gwenael22: sits out=20
*** HOLE CARDS ***
Dealt to the_wickstar [Qs Js]
Bozzuka: folds=20
shahin1360: raises $0.02 to $0.04
the_wickstar: calls $0.04
1Asthma1: folds=20
Vanga333: calls $0.03
JekaPoyniak: folds=20
*** FLOP *** [3d 8h Ah]
Vanga333: checks=20
shahin1360: checks=20
the_wickstar: checks=20
*** TURN *** [3d 8h Ah] [7h]
Vanga333: checks=20
shahin1360: bets $0.04
the_wickstar: calls $0.04
Vanga333: raises $0.12 to $0.16
shahin1360: folds=20
the_wickstar: folds=20
Uncalled bet ($0.12) returned to Vanga333
Vanga333 collected $0.25 from pot
Vanga333: doesn't show hand=20
*** SUMMARY ***
Total pot $0.26 | Rake $0.01=20
Board [3d 8h Ah 7h]
Seat 2: shahin1360 folded on the Turn
Seat 4: the_wickstar folded on the Turn
Seat 5: 1Asthma1 (button) folded before Flop (didn't bet)
Seat 6: Vanga333 (small blind) collected ($0.25)
Seat 7: JekaPoyniak (big blind) folded before Flop
Seat 8: Bozzuka folded before Flop (didn't bet)


*********** # 83 **************
PokerStars Hand #169801110470:  Hold'em No Limit ($0.01/$0.02 USD) - 20=
17/05/01 20:27:57 CUST [2017/05/01 6:27:57 ET]
Table 'Andraimon II' 9-max Seat #4 is the button
Seat 2: shahin1360 ($0.22 in chips)=20
Seat 3: einsplussieg ($2.21 in chips)=20
Seat 4: the_wickstar ($1.16 in chips)=20
Seat 5: 1Asthma1 ($2.60 in chips)=20
Seat 6: Vanga333 ($2 in chips)=20
Seat 7: JekaPoyniak ($2.12 in chips)=20
Seat 8: Bozzuka ($2 in chips)=20
1Asthma1: posts small blind $0.01
Vanga333: posts big blind $0.02
415jqdub: sits out=20
*** HOLE CARDS ***
Dealt to the_wickstar [2s Jd]
JekaPoyniak: folds=20
Bozzuka: folds=20
shahin1360: raises $0.02 to $0.04
einsplussieg: folds=20
einsplussieg leaves the table
the_wickstar: folds=20
1Asthma1: folds=20
Gwenael22 joins the table at seat #3=20
Vanga333: folds=20
Uncalled bet ($0.02) returned to shahin1360
shahin1360 collected $0.05 from pot
shahin1360: doesn't show hand=20
*** SUMMARY ***
Total pot $0.05 | Rake $0=20
Seat 2: shahin1360 collected ($0.05)
Seat 3: einsplussieg folded before Flop (didn't bet)
Seat 4: the_wickstar (button) folded before Flop (didn't bet)
Seat 5: 1Asthma1 (small blind) folded before Flop
Seat 6: Vanga333 (big blind) folded before Flop
Seat 7: JekaPoyniak folded before Flop (didn't bet)
Seat 8: Bozzuka folded before Flop (didn't bet)


*********** # 84 **************
PokerStars Hand #169801078204:  Hold'em No Limit ($0.01/$0.02 USD) - 20=
17/05/01 20:26:41 CUST [2017/05/01 6:26:41 ET]
Table 'Andraimon II' 9-max Seat #3 is the button
Seat 2: shahin1360 ($0.22 in chips)=20
Seat 3: einsplussieg ($2.27 in chips)=20
Seat 4: the_wickstar ($1.03 in chips)=20
Seat 5: 1Asthma1 ($2.62 in chips)=20
Seat 7: JekaPoyniak ($2.12 in chips)=20
Seat 8: Bozzuka ($2 in chips)=20
Seat 9: Vit94nit ($1.76 in chips)=20
the_wickstar: posts small blind $0.01
1Asthma1: posts big blind $0.02
*** HOLE CARDS ***
Dealt to the_wickstar [Ah Qs]
JekaPoyniak: folds=20
Bozzuka: folds=20
Vit94nit: raises $0.04 to $0.06
Volk1001 leaves the table
shahin1360: folds=20
einsplussieg: calls $0.06
Vanga333 joins the table at seat #6=20
the_wickstar: calls $0.05
1Asthma1: folds=20
*** FLOP *** [9c 8h Qc]
the_wickstar: bets $0.15
Vit94nit: folds=20
Vit94nit leaves the table
415jqdub joins the table at seat #9=20
einsplussieg: folds [As]
Uncalled bet ($0.15) returned to the_wickstar
the_wickstar collected $0.19 from pot
*** SUMMARY ***
Total pot $0.20 | Rake $0.01=20
Board [9c 8h Qc]
Seat 2: shahin1360 folded before Flop (didn't bet)
Seat 3: einsplussieg (button) folded on the Flop
Seat 4: the_wickstar (small blind) collected ($0.19)
Seat 5: 1Asthma1 (big blind) folded before Flop
Seat 7: JekaPoyniak folded before Flop (didn't bet)
Seat 8: Bozzuka folded before Flop (didn't bet)
Seat 9: Vit94nit folded on the Flop


*********** # 85 **************
PokerStars Hand #169801043966:  Hold'em No Limit ($0.01/$0.02 USD) - 20=
17/05/01 20:25:21 CUST [2017/05/01 6:25:21 ET]
Table 'Andraimon II' 9-max Seat #2 is the button
Seat 2: shahin1360 ($0.22 in chips)=20
Seat 3: einsplussieg ($1.20 in chips)=20
Seat 4: the_wickstar ($1.05 in chips)=20
Seat 5: 1Asthma1 ($2.62 in chips)=20
Seat 6: Volk1001 ($1 in chips)=20
Seat 7: JekaPoyniak ($2.12 in chips)=20
Seat 8: Bozzuka ($2 in chips)=20
Seat 9: Vit94nit ($1.88 in chips)=20
einsplussieg: posts small blind $0.01
the_wickstar: posts big blind $0.02
*** HOLE CARDS ***
Dealt to the_wickstar [2h 6s]
1Asthma1: folds=20
Volk1001: raises $0.04 to $0.06
JekaPoyniak: folds=20
Bozzuka: folds=20
Vit94nit: raises $0.06 to $0.12
shahin1360: folds=20
einsplussieg: calls $0.11
the_wickstar: folds=20
Volk1001: calls $0.06
*** FLOP *** [8d Kh 5h]
einsplussieg: checks=20
Volk1001: bets $0.20
Vit94nit: folds=20
einsplussieg: raises $0.88 to $1.08 and is all-in
Volk1001: calls $0.68 and is all-in
Uncalled bet ($0.20) returned to einsplussieg
*** TURN *** [8d Kh 5h] [Qc]
*** RIVER *** [8d Kh 5h Qc] [7d]
*** SHOW DOWN ***
einsplussieg: shows [Ac Qh] (a pair of Queens)
Volk1001: shows [Th Ah] (high card Ace)
einsplussieg collected $2.07 from pot
*** SUMMARY ***
Total pot $2.14 | Rake $0.07=20
Board [8d Kh 5h Qc 7d]
Seat 2: shahin1360 (button) folded before Flop (didn't bet)
Seat 3: einsplussieg (small blind) showed [Ac Qh] and won ($2.07) with =
a pair of Queens
Seat 4: the_wickstar (big blind) folded before Flop
Seat 5: 1Asthma1 folded before Flop (didn't bet)
Seat 6: Volk1001 showed [Th Ah] and lost with high card Ace
Seat 7: JekaPoyniak folded before Flop (didn't bet)
Seat 8: Bozzuka folded before Flop (didn't bet)
Seat 9: Vit94nit folded on the Flop


*********** # 86 **************
PokerStars Hand #169801016808:  Hold'em No Limit ($0.01/$0.02 USD) - 20=
17/05/01 20:24:18 CUST [2017/05/01 6:24:18 ET]
Table 'Andraimon II' 9-max Seat #9 is the button
Seat 2: shahin1360 ($0.46 in chips)=20
Seat 3: einsplussieg ($0.98 in chips)=20
Seat 4: the_wickstar ($1.05 in chips)=20
Seat 5: 1Asthma1 ($2.62 in chips)=20
Seat 6: Volk1001 ($1 in chips)=20
Seat 7: JekaPoyniak ($2.12 in chips)=20
Seat 8: Bozzuka ($2 in chips)=20
Seat 9: Vit94nit ($1.88 in chips)=20
shahin1360: posts small blind $0.01
einsplussieg: posts big blind $0.02
*** HOLE CARDS ***
Dealt to the_wickstar [3s 5h]
the_wickstar: folds=20
1Asthma1 has timed out
1Asthma1: folds=20
Volk1001: folds=20
JekaPoyniak: folds=20
Bozzuka: folds=20
Vit94nit: folds=20
shahin1360: raises $0.04 to $0.06
einsplussieg: calls $0.04
*** FLOP *** [Jc 6h 8d]
shahin1360: bets $0.04
einsplussieg: calls $0.04
*** TURN *** [Jc 6h 8d] [Jd]
shahin1360: bets $0.06
einsplussieg: calls $0.06
*** RIVER *** [Jc 6h 8d Jd] [Js]
shahin1360: bets $0.08
einsplussieg: raises $0.74 to $0.82 and is all-in
shahin1360: folds=20
Uncalled bet ($0.74) returned to einsplussieg
einsplussieg collected $0.46 from pot
*** SUMMARY ***
Total pot $0.48 | Rake $0.02=20
Board [Jc 6h 8d Jd Js]
Seat 2: shahin1360 (small blind) folded on the River
Seat 3: einsplussieg (big blind) collected ($0.46)
Seat 4: the_wickstar folded before Flop (didn't bet)
Seat 5: 1Asthma1 folded before Flop (didn't bet)
Seat 6: Volk1001 folded before Flop (didn't bet)
Seat 7: JekaPoyniak folded before Flop (didn't bet)
Seat 8: Bozzuka folded before Flop (didn't bet)
Seat 9: Vit94nit (button) folded before Flop (didn't bet)


*********** # 87 **************
PokerStars Hand #169800985414:  Hold'em No Limit ($0.01/$0.02 USD) - 20=
17/05/01 20:23:04 CUST [2017/05/01 6:23:04 ET]
Table 'Andraimon II' 9-max Seat #8 is the button
Seat 2: shahin1360 ($0.72 in chips)=20
Seat 3: einsplussieg ($0.73 in chips)=20
Seat 4: the_wickstar ($1.05 in chips)=20
Seat 5: 1Asthma1 ($2.62 in chips)=20
Seat 6: Volk1001 ($1 in chips)=20
Seat 7: JekaPoyniak ($2.12 in chips)=20
Seat 8: Bozzuka ($2 in chips)=20
Seat 9: Vit94nit ($1.89 in chips)=20
Vit94nit: posts small blind $0.01
shahin1360: posts big blind $0.02
*** HOLE CARDS ***
Dealt to the_wickstar [6d Ks]
einsplussieg: calls $0.02
the_wickstar: folds=20
1Asthma1: folds=20
Volk1001: folds=20
JekaPoyniak has timed out
JekaPoyniak: folds=20
Bozzuka: folds=20
Vit94nit: folds=20
shahin1360: checks=20
*** FLOP *** [Js Kh 7d]
shahin1360: bets $0.04
einsplussieg: raises $0.16 to $0.20
shahin1360: calls $0.16
*** TURN *** [Js Kh 7d] [Td]
shahin1360: bets $0.04
einsplussieg: raises $0.47 to $0.51 and is all-in
shahin1360: folds=20
Uncalled bet ($0.47) returned to einsplussieg
einsplussieg collected $0.51 from pot
*** SUMMARY ***
Total pot $0.53 | Rake $0.02=20
Board [Js Kh 7d Td]
Seat 2: shahin1360 (big blind) folded on the Turn
Seat 3: einsplussieg collected ($0.51)
Seat 4: the_wickstar folded before Flop (didn't bet)
Seat 5: 1Asthma1 folded before Flop (didn't bet)
Seat 6: Volk1001 folded before Flop (didn't bet)
Seat 7: JekaPoyniak folded before Flop (didn't bet)
Seat 8: Bozzuka (button) folded before Flop (didn't bet)
Seat 9: Vit94nit (small blind) folded before Flop


*********** # 88 **************
PokerStars Hand #169800949687:  Hold'em No Limit ($0.01/$0.02 USD) - 20=
17/05/01 20:21:41 CUST [2017/05/01 6:21:41 ET]
Table 'Andraimon II' 9-max Seat #7 is the button
Seat 2: shahin1360 ($0.72 in chips)=20
Seat 3: einsplussieg ($0.75 in chips)=20
Seat 4: the_wickstar ($1.05 in chips)=20
Seat 5: 1Asthma1 ($2 in chips)=20
Seat 6: Volk1001 ($1.61 in chips)=20
Seat 7: JekaPoyniak ($2.12 in chips)=20
Seat 8: Bozzuka ($2 in chips)=20
Seat 9: Vit94nit ($1.91 in chips)=20
Bozzuka: posts small blind $0.01
Vit94nit: posts big blind $0.02
*** HOLE CARDS ***
Dealt to the_wickstar [3h As]
shahin1360: folds=20
einsplussieg: calls $0.02
the_wickstar: folds=20
1Asthma1: raises $0.06 to $0.08
Volk1001: calls $0.08
JekaPoyniak: folds=20
Bozzuka: folds=20
Vit94nit: folds=20
einsplussieg: folds=20
*** FLOP *** [Ts 7s 4h]
1Asthma1: bets $0.13
Volk1001: calls $0.13
*** TURN *** [Ts 7s 4h] [9c]
1Asthma1: checks=20
Volk1001: bets $0.18
1Asthma1: calls $0.18
*** RIVER *** [Ts 7s 4h 9c] [7c]
1Asthma1: checks=20
Volk1001: bets $0.22
1Asthma1: calls $0.22
*** SHOW DOWN ***
Volk1001: shows [Ad Qh] (a pair of Sevens)
1Asthma1: shows [9s Ac] (two pair, Nines and Sevens)
1Asthma1 collected $1.23 from pot
*** SUMMARY ***
Total pot $1.27 | Rake $0.04=20
Board [Ts 7s 4h 9c 7c]
Seat 2: shahin1360 folded before Flop (didn't bet)
Seat 3: einsplussieg folded before Flop
Seat 4: the_wickstar folded before Flop (didn't bet)
Seat 5: 1Asthma1 showed [9s Ac] and won ($1.23) with two pair, Nines an=
d Sevens
Seat 6: Volk1001 showed [Ad Qh] and lost with a pair of Sevens
Seat 7: JekaPoyniak (button) folded before Flop (didn't bet)
Seat 8: Bozzuka (small blind) folded before Flop
Seat 9: Vit94nit (big blind) folded before Flop


*********** # 89 **************
PokerStars Hand #169800926196:  Hold'em No Limit ($0.01/$0.02 USD) - 20=
17/05/01 20:20:46 CUST [2017/05/01 6:20:46 ET]
Table 'Andraimon II' 9-max Seat #6 is the button
Seat 2: shahin1360 ($0.72 in chips)=20
Seat 3: einsplussieg ($0.75 in chips)=20
Seat 4: the_wickstar ($1.05 in chips)=20
Seat 5: 1Asthma1 ($2.06 in chips)=20
Seat 6: Volk1001 ($1.35 in chips)=20
Seat 7: JekaPoyniak ($2.13 in chips)=20
Seat 8: Bozzuka ($2 in chips)=20
Seat 9: Vit94nit ($1.91 in chips)=20
JekaPoyniak: posts small blind $0.01
Bozzuka: posts big blind $0.02
*** HOLE CARDS ***
Dealt to the_wickstar [4h Ad]
Vit94nit: folds=20
shahin1360: folds=20
einsplussieg: folds=20
the_wickstar: folds=20
1Asthma1: raises $0.03 to $0.05
Volk1001: calls $0.05
JekaPoyniak: folds=20
Bozzuka: folds=20
*** FLOP *** [4d 3d Jc]
1Asthma1: bets $0.06
Volk1001: calls $0.06
*** TURN *** [4d 3d Jc] [5s]
1Asthma1: bets $0.14
Volk1001: calls $0.14
*** RIVER *** [4d 3d Jc 5s] [Td]
1Asthma1: checks=20
Volk1001: bets $0.16
1Asthma1: folds=20
Uncalled bet ($0.16) returned to Volk1001
Volk1001 collected $0.51 from pot
*** SUMMARY ***
Total pot $0.53 | Rake $0.02=20
Board [4d 3d Jc 5s Td]
Seat 2: shahin1360 folded before Flop (didn't bet)
Seat 3: einsplussieg folded before Flop (didn't bet)
Seat 4: the_wickstar folded before Flop (didn't bet)
Seat 5: 1Asthma1 folded on the River
Seat 6: Volk1001 (button) collected ($0.51)
Seat 7: JekaPoyniak (small blind) folded before Flop
Seat 8: Bozzuka (big blind) folded before Flop
Seat 9: Vit94nit folded before Flop (didn't bet)


*********** # 90 **************
PokerStars Hand #169800910157:  Hold'em No Limit ($0.01/$0.02 USD) - 20=
17/05/01 20:20:08 CUST [2017/05/01 6:20:08 ET]
Table 'Andraimon II' 9-max Seat #5 is the button
Seat 1: Zybex696 ($0.56 in chips)=20
Seat 2: shahin1360 ($0.78 in chips)=20
Seat 3: einsplussieg ($0.61 in chips)=20
Seat 4: the_wickstar ($1.11 in chips)=20
Seat 5: 1Asthma1 ($2.06 in chips)=20
Seat 6: Volk1001 ($1.36 in chips)=20
Seat 7: JekaPoyniak ($2.15 in chips)=20
Seat 9: Vit94nit ($1.91 in chips)=20
Volk1001: posts small blind $0.01
JekaPoyniak: posts big blind $0.02
Bozzuka: sits out=20
*** HOLE CARDS ***
Dealt to the_wickstar [5s 4s]
Vit94nit: folds=20
Zybex696: folds=20
shahin1360: raises $0.04 to $0.06
einsplussieg: calls $0.06
the_wickstar: calls $0.06
1Asthma1: folds=20
Volk1001: folds=20
JekaPoyniak: folds=20
*** FLOP *** [2d Th 7d]
shahin1360: checks=20
einsplussieg: bets $0.10
the_wickstar: folds=20
shahin1360: folds=20
Uncalled bet ($0.10) returned to einsplussieg
einsplussieg collected $0.20 from pot
*** SUMMARY ***
Total pot $0.21 | Rake $0.01=20
Board [2d Th 7d]
Seat 1: Zybex696 folded before Flop (didn't bet)
Seat 2: shahin1360 folded on the Flop
Seat 3: einsplussieg collected ($0.20)
Seat 4: the_wickstar folded on the Flop
Seat 5: 1Asthma1 (button) folded before Flop (didn't bet)
Seat 6: Volk1001 (small blind) folded before Flop
Seat 7: JekaPoyniak (big blind) folded before Flop
Seat 9: Vit94nit folded before Flop (didn't bet)


*********** # 91 **************
PokerStars Hand #169800888872:  Hold'em No Limit ($0.01/$0.02 USD) - 20=
17/05/01 20:19:19 CUST [2017/05/01 6:19:19 ET]
Table 'Andraimon II' 9-max Seat #4 is the button
Seat 1: Zybex696 ($0.56 in chips)=20
Seat 2: shahin1360 ($0.80 in chips)=20
Seat 3: einsplussieg ($0.67 in chips)=20
Seat 4: the_wickstar ($0.97 in chips)=20
Seat 5: 1Asthma1 ($2.07 in chips)=20
Seat 6: Volk1001 ($1.42 in chips)=20
Seat 7: JekaPoyniak ($2.15 in chips)=20
Seat 9: Vit94nit ($1.91 in chips)=20
1Asthma1: posts small blind $0.01
Volk1001: posts big blind $0.02
Bozzuka: sits out=20
shahin1360: posts big blind $0.02
*** HOLE CARDS ***
Dealt to the_wickstar [Qd Ac]
JekaPoyniak: folds=20
Vit94nit: folds=20
Zybex696: folds=20
shahin1360: checks=20
einsplussieg: calls $0.02
the_wickstar: raises $0.04 to $0.06
1Asthma1: folds=20
Volk1001: calls $0.04
shahin1360: folds=20
einsplussieg: calls $0.04
*** FLOP *** [7c As 6c]
Volk1001: checks=20
einsplussieg: checks=20
the_wickstar: bets $0.16
Volk1001: folds=20
einsplussieg: folds=20
Uncalled bet ($0.16) returned to the_wickstar
the_wickstar collected $0.20 from pot
*** SUMMARY ***
Total pot $0.21 | Rake $0.01=20
Board [7c As 6c]
Seat 1: Zybex696 folded before Flop (didn't bet)
Seat 2: shahin1360 folded before Flop
Seat 3: einsplussieg folded on the Flop
Seat 4: the_wickstar (button) collected ($0.20)
Seat 5: 1Asthma1 (small blind) folded before Flop
Seat 6: Volk1001 (big blind) folded on the Flop
Seat 7: JekaPoyniak folded before Flop (didn't bet)
Seat 9: Vit94nit folded before Flop (didn't bet)


*********** # 92 **************
PokerStars Hand #169800861517:  Hold'em No Limit ($0.01/$0.02 USD) - 20=
17/05/01 20:18:15 CUST [2017/05/01 6:18:15 ET]
Table 'Andraimon II' 9-max Seat #3 is the button
Seat 1: Zybex696 ($0.56 in chips)=20
Seat 3: einsplussieg ($0.69 in chips)=20
Seat 4: the_wickstar ($0.93 in chips)=20
Seat 5: 1Asthma1 ($2.09 in chips)=20
Seat 6: Volk1001 ($1.42 in chips)=20
Seat 7: JekaPoyniak ($2.15 in chips)=20
Seat 9: Vit94nit ($1.91 in chips)=20
the_wickstar: posts small blind $0.01
1Asthma1: posts big blind $0.02
Bozzuka: sits out=20
shahin1360: sits out=20
*** HOLE CARDS ***
Dealt to the_wickstar [6d 7s]
Volk1001: folds=20
JekaPoyniak: folds=20
Vit94nit: folds=20
Zybex696: folds=20
einsplussieg: calls $0.02
the_wickstar: calls $0.01
1Asthma1: checks=20
*** FLOP *** [9c 3c Kd]
the_wickstar: checks=20
1Asthma1: checks=20
einsplussieg: checks=20
*** TURN *** [9c 3c Kd] [8d]
the_wickstar: bets $0.04
1Asthma1: folds=20
einsplussieg: folds=20
Uncalled bet ($0.04) returned to the_wickstar
the_wickstar collected $0.06 from pot
*** SUMMARY ***
Total pot $0.06 | Rake $0=20
Board [9c 3c Kd 8d]
Seat 1: Zybex696 folded before Flop (didn't bet)
Seat 3: einsplussieg (button) folded on the Turn
Seat 4: the_wickstar (small blind) collected ($0.06)
Seat 5: 1Asthma1 (big blind) folded on the Turn
Seat 6: Volk1001 folded before Flop (didn't bet)
Seat 7: JekaPoyniak folded before Flop (didn't bet)
Seat 9: Vit94nit folded before Flop (didn't bet)


*********** # 93 **************
PokerStars Hand #169800834376:  Hold'em No Limit ($0.01/$0.02 USD) - 20=
17/05/01 20:17:11 CUST [2017/05/01 6:17:11 ET]
Table 'Andraimon II' 9-max Seat #1 is the button
Seat 1: Zybex696 ($0.56 in chips)=20
Seat 3: einsplussieg ($0.67 in chips)=20
Seat 4: the_wickstar ($0.95 in chips)=20
Seat 5: 1Asthma1 ($2.09 in chips)=20
Seat 6: Volk1001 ($1.42 in chips)=20
Seat 7: JekaPoyniak ($2.15 in chips)=20
Seat 9: Vit94nit ($1.91 in chips)=20
einsplussieg: posts small blind $0.01
the_wickstar: posts big blind $0.02
Bozzuka: sits out=20
*** HOLE CARDS ***
Dealt to the_wickstar [4h 7s]
1Asthma1: folds=20
Volk1001: folds=20
shahin1360 joins the table at seat #2=20
JekaPoyniak: folds=20
Vit94nit: folds=20
Zybex696: folds=20
einsplussieg: calls $0.01
the_wickstar: checks=20
*** FLOP *** [3c Js Qh]
einsplussieg: checks=20
the_wickstar: checks=20
*** TURN *** [3c Js Qh] [4c]
einsplussieg: bets $0.08
the_wickstar: folds=20
Uncalled bet ($0.08) returned to einsplussieg
einsplussieg collected $0.04 from pot
*** SUMMARY ***
Total pot $0.04 | Rake $0=20
Board [3c Js Qh 4c]
Seat 1: Zybex696 (button) folded before Flop (didn't bet)
Seat 3: einsplussieg (small blind) collected ($0.04)
Seat 4: the_wickstar (big blind) folded on the Turn
Seat 5: 1Asthma1 folded before Flop (didn't bet)
Seat 6: Volk1001 folded before Flop (didn't bet)
Seat 7: JekaPoyniak folded before Flop (didn't bet)
Seat 9: Vit94nit folded before Flop (didn't bet)


*********** # 94 **************
PokerStars Hand #169800826886:  Hold'em No Limit ($0.01/$0.02 USD) - 20=
17/05/01 20:16:53 CUST [2017/05/01 6:16:53 ET]
Table 'Andraimon II' 9-max Seat #9 is the button
Seat 1: Zybex696 ($0.57 in chips)=20
Seat 3: einsplussieg ($0.66 in chips)=20
Seat 4: the_wickstar ($0.95 in chips)=20
Seat 5: 1Asthma1 ($2.09 in chips)=20
Seat 6: Volk1001 ($1.42 in chips)=20
Seat 7: JekaPoyniak ($2.15 in chips)=20
Seat 9: Vit94nit ($1.91 in chips)=20
Zybex696: posts small blind $0.01
sekcboy: is sitting out=20
einsplussieg: posts big blind $0.02
Bozzuka: sits out=20
*** HOLE CARDS ***
Dealt to the_wickstar [3c 5h]
sekcboy leaves the table
the_wickstar: folds=20
1Asthma1: folds=20
Volk1001: folds=20
JekaPoyniak: folds=20
Vit94nit: folds=20
Zybex696: folds=20
Uncalled bet ($0.01) returned to einsplussieg
einsplussieg collected $0.02 from pot
*** SUMMARY ***
Total pot $0.02 | Rake $0=20
Seat 1: Zybex696 (small blind) folded before Flop
Seat 3: einsplussieg (big blind) collected ($0.02)
Seat 4: the_wickstar folded before Flop (didn't bet)
Seat 5: 1Asthma1 folded before Flop (didn't bet)
Seat 6: Volk1001 folded before Flop (didn't bet)
Seat 7: JekaPoyniak folded before Flop (didn't bet)
Seat 9: Vit94nit (button) folded before Flop (didn't bet)


*********** # 95 **************
PokerStars Hand #169800810737:  Hold'em No Limit ($0.01/$0.02 USD) - 20=
17/05/01 20:16:15 CUST [2017/05/01 6:16:15 ET]
Table 'Andraimon II' 9-max Seat #7 is the button
Seat 1: Zybex696 ($0.59 in chips)=20
Seat 2: sekcboy ($2.81 in chips)=20
Seat 3: einsplussieg ($0.70 in chips)=20
Seat 4: the_wickstar ($0.95 in chips)=20
Seat 5: 1Asthma1 ($2.09 in chips)=20
Seat 6: Volk1001 ($1.35 in chips)=20
Seat 7: JekaPoyniak ($2.15 in chips)=20
Seat 9: Vit94nit ($1.92 in chips)=20
Vit94nit: posts small blind $0.01
Zybex696: posts big blind $0.02
*** HOLE CARDS ***
Dealt to the_wickstar [7h 8c]
sekcboy: folds=20
Bozzuka joins the table at seat #8=20
einsplussieg: calls $0.02
the_wickstar: folds=20
1Asthma1: folds=20
Volk1001: raises $0.02 to $0.04
JekaPoyniak: folds=20
Vit94nit: folds=20
Zybex696: folds=20
einsplussieg: calls $0.02
*** FLOP *** [9h Ah As]
einsplussieg: checks=20
Volk1001: bets $0.06
einsplussieg: folds=20
Uncalled bet ($0.06) returned to Volk1001
Volk1001 collected $0.11 from pot
*** SUMMARY ***
Total pot $0.11 | Rake $0=20
Board [9h Ah As]
Seat 1: Zybex696 (big blind) folded before Flop
Seat 2: sekcboy folded before Flop (didn't bet)
Seat 3: einsplussieg folded on the Flop
Seat 4: the_wickstar folded before Flop (didn't bet)
Seat 5: 1Asthma1 folded before Flop (didn't bet)
Seat 6: Volk1001 collected ($0.11)
Seat 7: JekaPoyniak (button) folded before Flop (didn't bet)
Seat 9: Vit94nit (small blind) folded before Flop


*********** # 96 **************
PokerStars Hand #169800801731:  Hold'em No Limit ($0.01/$0.02 USD) - 20=
17/05/01 20:15:54 CUST [2017/05/01 6:15:54 ET]
Table 'Chandra' 9-max Seat #4 is the button
Seat 1: Ainur M ($1.49 in chips)=20
Seat 3: izy cykerman ($3.03 in chips)=20
Seat 4: And7888 ($0.55 in chips)=20
Seat 5: Sosiu82 ($1.31 in chips)=20
Seat 6: Assis2000 ($2 in chips)=20
Seat 7: JekaPoyniak ($2.12 in chips)=20
Seat 8: jays451 ($2.62 in chips)=20
Seat 9: the_wickstar ($0.95 in chips)=20
Sosiu82: posts small blind $0.01
Assis2000: posts big blind $0.02
Kirhgof_1988: sits out=20
*** HOLE CARDS ***
Dealt to the_wickstar [Qs Qh]
JekaPoyniak: folds=20
jays451: raises $0.04 to $0.06
Kirhgof_1988 leaves the table
4Rchy joins the table at seat #2=20
the_wickstar: raises $0.04 to $0.10
Ainur M: calls $0.10
izy cykerman: folds=20
And7888: folds=20
Sosiu82: folds=20
Assis2000: folds=20
jays451: calls $0.04
*** FLOP *** [2d Jd 9d]
Sosiu82 leaves the table
jays451: checks=20
gdyd727 joins the table at seat #5=20
the_wickstar: bets $0.20
Ainur M: folds=20
jays451: calls $0.20
*** TURN *** [2d Jd 9d] [Ac]
jays451: checks=20
the_wickstar: bets $0.65 and is all-in
jays451: calls $0.65
*** RIVER *** [2d Jd 9d Ac] [6d]
*** SHOW DOWN ***
jays451: shows [Ad Jc] (a flush, Ace high)
the_wickstar: shows [Qs Qh] (a pair of Queens)
jays451 collected $1.96 from pot
*** SUMMARY ***
Total pot $2.03 | Rake $0.07=20
Board [2d Jd 9d Ac 6d]
Seat 1: Ainur M folded on the Flop
Seat 3: izy cykerman folded before Flop (didn't bet)
Seat 4: And7888 (button) folded before Flop (didn't bet)
Seat 5: Sosiu82 (small blind) folded before Flop
Seat 6: Assis2000 (big blind) folded before Flop
Seat 7: JekaPoyniak folded before Flop (didn't bet)
Seat 8: jays451 showed [Ad Jc] and won ($1.96) with a flush, Ace high
Seat 9: the_wickstar showed [Qs Qh] and lost with a pair of Queens


*********** # 97 **************
PokerStars Hand #169800788844:  Hold'em No Limit ($0.01/$0.02 USD) - 20=
17/05/01 20:15:24 CUST [2017/05/01 6:15:24 ET]
Table 'Andraimon II' 9-max Seat #6 is the button
Seat 1: Zybex696 ($0.59 in chips)=20
Seat 2: sekcboy ($2.81 in chips)=20
Seat 3: einsplussieg ($0.72 in chips)=20
Seat 4: the_wickstar ($0.97 in chips)=20
Seat 5: 1Asthma1 ($2.09 in chips)=20
Seat 6: Volk1001 ($1.35 in chips)=20
Seat 7: JekaPoyniak ($2.16 in chips)=20
Seat 9: Vit94nit ($1.87 in chips)=20
JekaPoyniak: posts small blind $0.01
Kirhgof_1988: is sitting out=20
Vit94nit: posts big blind $0.02
*** HOLE CARDS ***
Dealt to the_wickstar [Ah 5c]
Zybex696: folds=20
Kirhgof_1988 leaves the table
sekcboy: folds=20
einsplussieg: calls $0.02
the_wickstar: calls $0.02
1Asthma1: folds=20
Volk1001: folds=20
JekaPoyniak: folds=20
Vit94nit: raises $0.08 to $0.10
einsplussieg: folds=20
the_wickstar: folds=20
Uncalled bet ($0.08) returned to Vit94nit
Vit94nit collected $0.07 from pot
Vit94nit: doesn't show hand=20
*** SUMMARY ***
Total pot $0.07 | Rake $0=20
Seat 1: Zybex696 folded before Flop (didn't bet)
Seat 2: sekcboy folded before Flop (didn't bet)
Seat 3: einsplussieg folded before Flop
Seat 4: the_wickstar folded before Flop
Seat 5: 1Asthma1 folded before Flop (didn't bet)
Seat 6: Volk1001 (button) folded before Flop (didn't bet)
Seat 7: JekaPoyniak (small blind) folded before Flop
Seat 9: Vit94nit (big blind) collected ($0.07)


*********** # 98 **************
PokerStars Hand #169800776918:  Hold'em No Limit ($0.01/$0.02 USD) - 20=
17/05/01 20:14:56 CUST [2017/05/01 6:14:56 ET]
Table 'Chandra' 9-max Seat #3 is the button
Seat 1: Ainur M ($1.55 in chips)=20
Seat 3: izy cykerman ($3.03 in chips)=20
Seat 4: And7888 ($0.56 in chips)=20
Seat 5: Sosiu82 ($1.37 in chips)=20
Seat 6: Assis2000 ($2 in chips)=20
Seat 7: JekaPoyniak ($2 in chips)=20
Seat 8: jays451 ($2.62 in chips)=20
Seat 9: the_wickstar ($0.95 in chips)=20
And7888: posts small blind $0.01
Sosiu82: posts big blind $0.02
Kirhgof_1988: sits out=20
*** HOLE CARDS ***
Dealt to the_wickstar [Jh 7d]
Assis2000: folds=20
JekaPoyniak: raises $0.04 to $0.06
jays451: folds=20
the_wickstar: folds=20
Ainur M: calls $0.06
izy cykerman: folds=20
And7888: folds=20
Sosiu82: calls $0.04
*** FLOP *** [Kd As Kc]
Sosiu82: checks=20
JekaPoyniak: bets $0.12
Ainur M: folds=20
Sosiu82: folds=20
Uncalled bet ($0.12) returned to JekaPoyniak
JekaPoyniak collected $0.18 from pot
*** SUMMARY ***
Total pot $0.19 | Rake $0.01=20
Board [Kd As Kc]
Seat 1: Ainur M folded on the Flop
Seat 3: izy cykerman (button) folded before Flop (didn't bet)
Seat 4: And7888 (small blind) folded before Flop
Seat 5: Sosiu82 (big blind) folded on the Flop
Seat 6: Assis2000 folded before Flop (didn't bet)
Seat 7: JekaPoyniak collected ($0.18)
Seat 8: jays451 folded before Flop (didn't bet)
Seat 9: the_wickstar folded before Flop (didn't bet)


*********** # 99 **************
PokerStars Hand #169800748895:  Hold'em No Limit ($0.01/$0.02 USD) - 20=
17/05/01 20:13:50 CUST [2017/05/01 6:13:50 ET]
Table 'Andraimon II' 9-max Seat #5 is the button
Seat 1: Zybex696 ($0.59 in chips)=20
Seat 2: sekcboy ($2.81 in chips)=20
Seat 3: einsplussieg ($0.78 in chips)=20
Seat 4: the_wickstar ($0.77 in chips)=20
Seat 5: 1Asthma1 ($2.09 in chips)=20
Seat 6: Volk1001 ($1.36 in chips)=20
Seat 7: JekaPoyniak ($2.18 in chips)=20
Seat 8: Kirhgof_1988 ($2.19 in chips)=20
Seat 9: Vit94nit ($1.93 in chips)=20
Volk1001: posts small blind $0.01
JekaPoyniak: posts big blind $0.02
*** HOLE CARDS ***
Dealt to the_wickstar [Ks 7c]
Kirhgof_1988: raises $0.04 to $0.06
Vit94nit: calls $0.06
Zybex696: folds=20
sekcboy: folds=20
einsplussieg: calls $0.06
the_wickstar: calls $0.06
1Asthma1: folds=20
Volk1001: folds=20
JekaPoyniak: folds=20
*** FLOP *** [Tc 4d 8c]
Kirhgof_1988: checks=20
Vit94nit: checks=20
einsplussieg: checks=20
the_wickstar: checks=20
*** TURN *** [Tc 4d 8c] [8h]
Kirhgof_1988: checks=20
Vit94nit: checks=20
einsplussieg: checks=20
the_wickstar: bets $0.20
Kirhgof_1988: folds=20
Vit94nit: folds=20
einsplussieg: folds=20
Uncalled bet ($0.20) returned to the_wickstar
the_wickstar collected $0.26 from pot
*** SUMMARY ***
Total pot $0.27 | Rake $0.01=20
Board [Tc 4d 8c 8h]
Seat 1: Zybex696 folded before Flop (didn't bet)
Seat 2: sekcboy folded before Flop (didn't bet)
Seat 3: einsplussieg folded on the Turn
Seat 4: the_wickstar collected ($0.26)
Seat 5: 1Asthma1 (button) folded before Flop (didn't bet)
Seat 6: Volk1001 (small blind) folded before Flop
Seat 7: JekaPoyniak (big blind) folded before Flop
Seat 8: Kirhgof_1988 folded on the Turn
Seat 9: Vit94nit folded on the Turn


*********** # 100 **************
PokerStars Hand #169800744808:  Hold'em No Limit ($0.01/$0.02 USD) - 20=
17/05/01 20:13:41 CUST [2017/05/01 6:13:41 ET]
Table 'Chandra' 9-max Seat #1 is the button
Seat 1: Ainur M ($1.55 in chips)=20
Seat 3: izy cykerman ($3.04 in chips)=20
Seat 4: And7888 ($0.49 in chips)=20
Seat 5: Sosiu82 ($1.37 in chips)=20
Seat 6: Assis2000 ($2 in chips)=20
Seat 7: JekaPoyniak ($2 in chips)=20
Seat 8: jays451 ($2.69 in chips)=20
Seat 9: the_wickstar ($0.95 in chips)=20
Kirhgof_1988 will be allowed to play after the button
izy cykerman: posts small blind $0.01
And7888: posts big blind $0.02
*** HOLE CARDS ***
Dealt to the_wickstar [Ts 9h]
Sosiu82: folds=20
Assis2000: folds=20
JekaPoyniak: folds=20
jays451: calls $0.02
the_wickstar: folds=20
Ainur M: folds=20
izy cykerman: folds=20
And7888 is disconnected=20
And7888 is connected=20
And7888: raises $0.05 to $0.07
jays451: calls $0.05
*** FLOP *** [4c 2s 2h]
And7888: bets $0.42 and is all-in
jays451: folds=20
Uncalled bet ($0.42) returned to And7888
And7888 collected $0.14 from pot
And7888: doesn't show hand=20
*** SUMMARY ***
Total pot $0.15 | Rake $0.01=20
Board [4c 2s 2h]
Seat 1: Ainur M (button) folded before Flop (didn't bet)
Seat 3: izy cykerman (small blind) folded before Flop
Seat 4: And7888 (big blind) collected ($0.14)
Seat 5: Sosiu82 folded before Flop (didn't bet)
Seat 6: Assis2000 folded before Flop (didn't bet)
Seat 7: JekaPoyniak folded before Flop (didn't bet)
Seat 8: jays451 folded on the Flop
Seat 9: the_wickstar folded before Flop (didn't bet)


*********** # 101 **************
PokerStars Hand #169800722124:  Hold'em No Limit ($0.01/$0.02 USD) - 20=
17/05/01 20:12:48 CUST [2017/05/01 6:12:48 ET]
Table 'Andraimon II' 9-max Seat #4 is the button
Seat 1: Zybex696 ($0.59 in chips)=20
Seat 2: sekcboy ($2.81 in chips)=20
Seat 3: einsplussieg ($0.80 in chips)=20
Seat 4: the_wickstar ($0.52 in chips)=20
Seat 5: 1Asthma1 ($2.10 in chips)=20
Seat 6: Volk1001 ($1.60 in chips)=20
Seat 7: JekaPoyniak ($2.18 in chips)=20
Seat 8: Kirhgof_1988 ($2.19 in chips)=20
Seat 9: Vit94nit ($1.93 in chips)=20
1Asthma1: posts small blind $0.01
Volk1001: posts big blind $0.02
einsplussieg: posts big blind $0.02
*** HOLE CARDS ***
Dealt to the_wickstar [9c Qh]
JekaPoyniak: folds=20
Kirhgof_1988: folds=20
Vit94nit: folds=20
Zybex696: folds=20
sekcboy: folds=20
einsplussieg: checks=20
the_wickstar: calls $0.02
1Asthma1: folds=20
Volk1001: checks=20
*** FLOP *** [Ks Kd 9h]
Volk1001: bets $0.06
einsplussieg: folds=20
the_wickstar: calls $0.06
*** TURN *** [Ks Kd 9h] [7h]
Volk1001: bets $0.06
the_wickstar: calls $0.06
*** RIVER *** [Ks Kd 9h 7h] [4d]
Volk1001: bets $0.10
the_wickstar: calls $0.10
*** SHOW DOWN ***
Volk1001: shows [6d Ts] (a pair of Kings)
the_wickstar: shows [9c Qh] (two pair, Kings and Nines)
the_wickstar collected $0.49 from pot
*** SUMMARY ***
Total pot $0.51 | Rake $0.02=20
Board [Ks Kd 9h 7h 4d]
Seat 1: Zybex696 folded before Flop (didn't bet)
Seat 2: sekcboy folded before Flop (didn't bet)
Seat 3: einsplussieg folded on the Flop
Seat 4: the_wickstar (button) showed [9c Qh] and won ($0.49) with two p=
air, Kings and Nines
Seat 5: 1Asthma1 (small blind) folded before Flop
Seat 6: Volk1001 (big blind) showed [6d Ts] and lost with a pair of Kin=
gs
Seat 7: JekaPoyniak folded before Flop (didn't bet)
Seat 8: Kirhgof_1988 folded before Flop (didn't bet)
Seat 9: Vit94nit folded before Flop (didn't bet)


*********** # 102 **************
PokerStars Hand #169800700922:  Hold'em No Limit ($0.01/$0.02 USD) - 20=
17/05/01 20:11:58 CUST [2017/05/01 6:11:58 ET]
Table 'Chandra' 9-max Seat #9 is the button
Seat 1: Ainur M ($1.56 in chips)=20
Seat 3: izy cykerman ($3.06 in chips)=20
Seat 4: And7888 ($0.80 in chips)=20
Seat 5: Sosiu82 ($1.37 in chips)=20
Seat 6: Assis2000 ($2 in chips)=20
Seat 7: JekaPoyniak ($2 in chips)=20
Seat 8: jays451 ($2.37 in chips)=20
Seat 9: the_wickstar ($0.95 in chips)=20
Ainur M: posts small blind $0.01
fomik33: is sitting out=20
izy cykerman: posts big blind $0.02
*** HOLE CARDS ***
Dealt to the_wickstar [4d 8s]
fomik33 leaves the table
And7888: raises $0.05 to $0.07
Kirhgof_1988 joins the table at seat #2=20
Sosiu82: folds=20
Assis2000: folds=20
JekaPoyniak: folds=20
jays451: calls $0.07
the_wickstar: folds=20
Ainur M: folds=20
izy cykerman: folds=20
*** FLOP *** [7s Ad Tc]
And7888: bets $0.16
jays451: calls $0.16
*** TURN *** [7s Ad Tc] [5h]
And7888: checks=20
jays451: checks=20
*** RIVER *** [7s Ad Tc 5h] [3h]
And7888: bets $0.08
jays451: calls $0.08
*** SHOW DOWN ***
And7888: shows [9c 6s] (high card Ace)
jays451: shows [Ah Ks] (a pair of Aces)
jays451 collected $0.63 from pot
*** SUMMARY ***
Total pot $0.65 | Rake $0.02=20
Board [7s Ad Tc 5h 3h]
Seat 1: Ainur M (small blind) folded before Flop
Seat 3: izy cykerman (big blind) folded before Flop
Seat 4: And7888 showed [9c 6s] and lost with high card Ace
Seat 5: Sosiu82 folded before Flop (didn't bet)
Seat 6: Assis2000 folded before Flop (didn't bet)
Seat 7: JekaPoyniak folded before Flop (didn't bet)
Seat 8: jays451 showed [Ah Ks] and won ($0.63) with a pair of Aces
Seat 9: the_wickstar (button) folded before Flop (didn't bet)


*********** # 103 **************
PokerStars Hand #169800697899:  Hold'em No Limit ($0.01/$0.02 USD) - 20=
17/05/01 20:11:51 CUST [2017/05/01 6:11:51 ET]
Table 'Andraimon II' 9-max Seat #2 is the button
Seat 1: Zybex696 ($0.59 in chips)=20
Seat 2: sekcboy ($2.81 in chips)=20
Seat 4: the_wickstar ($0.48 in chips)=20
Seat 5: 1Asthma1 ($2.12 in chips)=20
Seat 6: Volk1001 ($1.60 in chips)=20
Seat 7: JekaPoyniak ($2.18 in chips)=20
Seat 8: Kirhgof_1988 ($2.21 in chips)=20
Seat 9: Vit94nit ($1.93 in chips)=20
the_wickstar: posts small blind $0.01
1Asthma1: posts big blind $0.02
*** HOLE CARDS ***
Dealt to the_wickstar [Th 5c]
Volk1001: folds=20
JekaPoyniak: folds=20
Kirhgof_1988: calls $0.02
Vit94nit: folds=20
Zybex696: folds=20
einsplussieg joins the table at seat #3=20
sekcboy: folds=20
the_wickstar: calls $0.01
1Asthma1: checks=20
*** FLOP *** [6h 6d Jc]
the_wickstar: checks=20
1Asthma1: checks=20
Kirhgof_1988: checks=20
*** TURN *** [6h 6d Jc] [Kd]
the_wickstar: bets $0.04
1Asthma1: folds=20
Kirhgof_1988: folds=20
Uncalled bet ($0.04) returned to the_wickstar
the_wickstar collected $0.06 from pot
*** SUMMARY ***
Total pot $0.06 | Rake $0=20
Board [6h 6d Jc Kd]
Seat 1: Zybex696 folded before Flop (didn't bet)
Seat 2: sekcboy (button) folded before Flop (didn't bet)
Seat 4: the_wickstar (small blind) collected ($0.06)
Seat 5: 1Asthma1 (big blind) folded on the Turn
Seat 6: Volk1001 folded before Flop (didn't bet)
Seat 7: JekaPoyniak folded before Flop (didn't bet)
Seat 8: Kirhgof_1988 folded on the Turn
Seat 9: Vit94nit folded before Flop (didn't bet)


*********** # 104 **************
PokerStars Hand #169800672008:  Hold'em No Limit ($0.01/$0.02 USD) - 20=
17/05/01 20:10:49 CUST [2017/05/01 6:10:49 ET]
Table 'Andraimon II' 9-max Seat #1 is the button
Seat 1: Zybex696 ($0.68 in chips)=20
Seat 2: sekcboy ($2.71 in chips)=20
Seat 3: 3AllBlack ($0.75 in chips)=20
Seat 4: the_wickstar ($0.48 in chips)=20
Seat 5: 1Asthma1 ($2.12 in chips)=20
Seat 6: Volk1001 ($1.60 in chips)=20
Seat 7: JekaPoyniak ($2.18 in chips)=20
Seat 8: Kirhgof_1988 ($2.21 in chips)=20
Seat 9: Vit94nit ($1.93 in chips)=20
sekcboy: posts small blind $0.01
3AllBlack: posts big blind $0.02
*** HOLE CARDS ***
Dealt to the_wickstar [5s 9c]
the_wickstar: folds=20
1Asthma1: folds=20
Volk1001: folds=20
JekaPoyniak: folds=20
Kirhgof_1988: folds=20
Vit94nit: folds=20
Zybex696: raises $0.02 to $0.04
sekcboy: calls $0.03
3AllBlack: folds=20
*** FLOP *** [6d 6s Qh]
3AllBlack leaves the table
sekcboy: checks=20
Zybex696: checks=20
*** TURN *** [6d 6s Qh] [Kd]
sekcboy: bets $0.05
Zybex696: calls $0.05
*** RIVER *** [6d 6s Qh Kd] [2h]
sekcboy: checks=20
Zybex696: checks=20
*** SHOW DOWN ***
sekcboy: shows [As 9d] (a pair of Sixes)
Zybex696: mucks hand=20
sekcboy collected $0.19 from pot
*** SUMMARY ***
Total pot $0.20 | Rake $0.01=20
Board [6d 6s Qh Kd 2h]
Seat 1: Zybex696 (button) mucked [Js Tc]
Seat 2: sekcboy (small blind) showed [As 9d] and won ($0.19) with a pai=
r of Sixes
Seat 3: 3AllBlack (big blind) folded before Flop
Seat 4: the_wickstar folded before Flop (didn't bet)
Seat 5: 1Asthma1 folded before Flop (didn't bet)
Seat 6: Volk1001 folded before Flop (didn't bet)
Seat 7: JekaPoyniak folded before Flop (didn't bet)
Seat 8: Kirhgof_1988 folded before Flop (didn't bet)
Seat 9: Vit94nit folded before Flop (didn't bet)


*********** # 105 **************
PokerStars Hand #169800668192:  Hold'em No Limit ($0.01/$0.02 USD) - 20=
17/05/01 20:10:40 CUST [2017/05/01 6:10:40 ET]
Table 'Chandra' 9-max Seat #8 is the button
Seat 1: Ainur M ($1.58 in chips)=20
Seat 2: fomik33 ($2 in chips)=20
Seat 3: izy cykerman ($3.06 in chips)=20
Seat 5: Sosiu82 ($1.37 in chips)=20
Seat 6: Assis2000 ($2 in chips)=20
Seat 7: JekaPoyniak ($2 in chips)=20
Seat 8: jays451 ($2.37 in chips)=20
Seat 9: the_wickstar ($0.91 in chips)=20
the_wickstar: posts small blind $0.01
Ainur M: posts big blind $0.02
*** HOLE CARDS ***
Dealt to the_wickstar [8s 9d]
fomik33: calls $0.02
izy cykerman: folds=20
Sosiu82: folds=20
Assis2000: folds=20
JekaPoyniak: folds=20
jays451: folds=20
the_wickstar: calls $0.01
Ainur M: checks=20
*** FLOP *** [2s 9s Qs]
the_wickstar: bets $0.04
Ainur M: folds=20
fomik33: folds=20
Uncalled bet ($0.04) returned to the_wickstar
the_wickstar collected $0.06 from pot
*** SUMMARY ***
Total pot $0.06 | Rake $0=20
Board [2s 9s Qs]
Seat 1: Ainur M (big blind) folded on the Flop
Seat 2: fomik33 folded on the Flop
Seat 3: izy cykerman folded before Flop (didn't bet)
Seat 5: Sosiu82 folded before Flop (didn't bet)
Seat 6: Assis2000 folded before Flop (didn't bet)
Seat 7: JekaPoyniak folded before Flop (didn't bet)
Seat 8: jays451 (button) folded before Flop (didn't bet)
Seat 9: the_wickstar (small blind) collected ($0.06)


*********** # 106 **************
PokerStars Hand #169800661370:  Hold'em No Limit ($0.01/$0.02 USD) - 20=
17/05/01 20:10:24 CUST [2017/05/01 6:10:24 ET]
Table 'Andraimon II' 9-max Seat #9 is the button
Seat 1: Zybex696 ($0.69 in chips)=20
Seat 2: sekcboy ($2.73 in chips)=20
Seat 4: the_wickstar ($0.48 in chips)=20
Seat 5: 1Asthma1 ($2.09 in chips)=20
Seat 6: Volk1001 ($1.60 in chips)=20
Seat 7: JekaPoyniak ($2.18 in chips)=20
Seat 8: Kirhgof_1988 ($2.21 in chips)=20
Seat 9: Vit94nit ($1.93 in chips)=20
Zybex696: posts small blind $0.01
sekcboy: posts big blind $0.02
*** HOLE CARDS ***
Dealt to the_wickstar [6s Ts]
the_wickstar: folds=20
1Asthma1: raises $0.04 to $0.06
Volk1001: folds=20
JekaPoyniak: folds=20
Kirhgof_1988: folds=20
Vit94nit: folds=20
Zybex696: folds=20
sekcboy: folds=20
Uncalled bet ($0.04) returned to 1Asthma1
1Asthma1 collected $0.05 from pot
*** SUMMARY ***
Total pot $0.05 | Rake $0=20
Seat 1: Zybex696 (small blind) folded before Flop
Seat 2: sekcboy (big blind) folded before Flop
Seat 4: the_wickstar folded before Flop (didn't bet)
Seat 5: 1Asthma1 collected ($0.05)
Seat 6: Volk1001 folded before Flop (didn't bet)
Seat 7: JekaPoyniak folded before Flop (didn't bet)
Seat 8: Kirhgof_1988 folded before Flop (didn't bet)
Seat 9: Vit94nit (button) folded before Flop (didn't bet)


*********** # 107 **************
PokerStars Hand #169800641113:  Hold'em No Limit ($0.01/$0.02 USD) - 20=
17/05/01 20:09:36 CUST [2017/05/01 6:09:36 ET]
Table 'Chandra' 9-max Seat #7 is the button
Seat 1: Ainur M ($1.58 in chips)=20
Seat 2: fomik33 ($2 in chips)=20
Seat 3: izy cykerman ($3.06 in chips)=20
Seat 4: And7888 ($0.54 in chips)=20
Seat 5: Sosiu82 ($0.84 in chips)=20
Seat 6: Assis2000 ($2 in chips)=20
Seat 7: JekaPoyniak ($2 in chips)=20
Seat 8: jays451 ($2.38 in chips)=20
Seat 9: the_wickstar ($0.93 in chips)=20
jays451: posts small blind $0.01
the_wickstar: posts big blind $0.02
*** HOLE CARDS ***
Dealt to the_wickstar [3h 8c]
Ainur M: folds=20
fomik33: folds=20
izy cykerman: folds=20
And7888: raises $0.05 to $0.07
Sosiu82: calls $0.07
Assis2000: folds=20
JekaPoyniak: folds=20
And7888 is disconnected=20
jays451: folds=20
the_wickstar: folds=20
*** FLOP *** [2d Td 4s]
And7888: bets $0.08
Sosiu82: calls $0.08
*** TURN *** [2d Td 4s] [As]
And7888: bets $0.16
Sosiu82: raises $0.53 to $0.69 and is all-in
And7888: calls $0.23 and is all-in
Uncalled bet ($0.30) returned to Sosiu82
*** RIVER *** [2d Td 4s As] [Jc]
*** SHOW DOWN ***
And7888: shows [Ks 9s] (high card Ace)
Sosiu82: shows [Js Qs] (a pair of Jacks)
Sosiu82 collected $1.07 from pot
*** SUMMARY ***
Total pot $1.11 | Rake $0.04=20
Board [2d Td 4s As Jc]
Seat 1: Ainur M folded before Flop (didn't bet)
Seat 2: fomik33 folded before Flop (didn't bet)
Seat 3: izy cykerman folded before Flop (didn't bet)
Seat 4: And7888 showed [Ks 9s] and lost with high card Ace
Seat 5: Sosiu82 showed [Js Qs] and won ($1.07) with a pair of Jacks
Seat 6: Assis2000 folded before Flop (didn't bet)
Seat 7: JekaPoyniak (button) folded before Flop (didn't bet)
Seat 8: jays451 (small blind) folded before Flop
Seat 9: the_wickstar (big blind) folded before Flop


*********** # 108 **************
PokerStars Hand #169800640873:  Hold'em No Limit ($0.01/$0.02 USD) - 20=
17/05/01 20:09:36 CUST [2017/05/01 6:09:36 ET]
Table 'Andraimon II' 9-max Seat #8 is the button
Seat 1: Zybex696 ($0.71 in chips)=20
Seat 2: sekcboy ($2.79 in chips)=20
Seat 3: 3AllBlack ($0.75 in chips)=20
Seat 4: the_wickstar ($0.48 in chips)=20
Seat 5: 1Asthma1 ($2 in chips)=20
Seat 6: Volk1001 ($1.60 in chips)=20
Seat 7: JekaPoyniak ($2.18 in chips)=20
Seat 8: Kirhgof_1988 ($2.21 in chips)=20
Seat 9: Vit94nit ($1.94 in chips)=20
Vit94nit: posts small blind $0.01
Zybex696: posts big blind $0.02
*** HOLE CARDS ***
Dealt to the_wickstar [Jh 7d]
sekcboy: raises $0.04 to $0.06
3AllBlack has timed out while disconnected
3AllBlack: folds=20
the_wickstar: folds=20
1Asthma1: raises $0.12 to $0.18
Volk1001: folds=20
JekaPoyniak: folds=20
Kirhgof_1988: folds=20
Vit94nit: folds=20
Zybex696: folds=20
sekcboy: folds=20
Uncalled bet ($0.12) returned to 1Asthma1
1Asthma1 collected $0.15 from pot
*** SUMMARY ***
Total pot $0.15 | Rake $0=20
Seat 1: Zybex696 (big blind) folded before Flop
Seat 2: sekcboy folded before Flop
Seat 3: 3AllBlack folded before Flop (didn't bet)
Seat 4: the_wickstar folded before Flop (didn't bet)
Seat 5: 1Asthma1 collected ($0.15)
Seat 6: Volk1001 folded before Flop (didn't bet)
Seat 7: JekaPoyniak folded before Flop (didn't bet)
Seat 8: Kirhgof_1988 (button) folded before Flop (didn't bet)
Seat 9: Vit94nit (small blind) folded before Flop


*********** # 109 **************
PokerStars Hand #169800610120:  Hold'em No Limit ($0.01/$0.02 USD) - 20=
17/05/01 20:08:21 CUST [2017/05/01 6:08:21 ET]
Table 'Andraimon II' 9-max Seat #7 is the button
Seat 1: Zybex696 ($0.71 in chips)=20
Seat 2: sekcboy ($2.79 in chips)=20
Seat 3: 3AllBlack ($0.75 in chips)=20
Seat 4: the_wickstar ($0.64 in chips)=20
Seat 5: 1Asthma1 ($2 in chips)=20
Seat 6: Volk1001 ($1.60 in chips)=20
Seat 7: JekaPoyniak ($2 in chips)=20
Seat 8: Kirhgof_1988 ($2.22 in chips)=20
Seat 9: Vit94nit ($1.96 in chips)=20
Kirhgof_1988: posts small blind $0.01
Vit94nit: posts big blind $0.02
*** HOLE CARDS ***
Dealt to the_wickstar [8d 8h]
Zybex696: folds=20
sekcboy: folds=20
3AllBlack: folds=20
the_wickstar: raises $0.04 to $0.06
1Asthma1: folds=20
Volk1001: folds=20
JekaPoyniak: calls $0.06
Kirhgof_1988: folds=20
Vit94nit: folds=20
*** FLOP *** [4h Ac Qh]
the_wickstar: checks=20
JekaPoyniak: checks=20
*** TURN *** [4h Ac Qh] [7c]
3AllBlack is disconnected=20
the_wickstar: bets $0.10
JekaPoyniak: calls $0.10
*** RIVER *** [4h Ac Qh 7c] [2d]
the_wickstar: checks=20
JekaPoyniak: bets $0.23
the_wickstar: folds=20
Uncalled bet ($0.23) returned to JekaPoyniak
JekaPoyniak collected $0.34 from pot
*** SUMMARY ***
Total pot $0.35 | Rake $0.01=20
Board [4h Ac Qh 7c 2d]
Seat 1: Zybex696 folded before Flop (didn't bet)
Seat 2: sekcboy folded before Flop (didn't bet)
Seat 3: 3AllBlack folded before Flop (didn't bet)
Seat 4: the_wickstar folded on the River
Seat 5: 1Asthma1 folded before Flop (didn't bet)
Seat 6: Volk1001 folded before Flop (didn't bet)
Seat 7: JekaPoyniak (button) collected ($0.34)
Seat 8: Kirhgof_1988 (small blind) folded before Flop
Seat 9: Vit94nit (big blind) folded before Flop


*********** # 110 **************
PokerStars Hand #169800608270:  Hold'em No Limit ($0.01/$0.02 USD) - 20=
17/05/01 20:08:17 CUST [2017/05/01 6:08:17 ET]
Table 'Chandra' 9-max Seat #6 is the button
Seat 1: Ainur M ($1.58 in chips)=20
Seat 2: fomik33 ($2 in chips)=20
Seat 3: izy cykerman ($2.43 in chips)=20
Seat 4: And7888 ($1.13 in chips)=20
Seat 5: Sosiu82 ($0.84 in chips)=20
Seat 6: Assis2000 ($2 in chips)=20
Seat 7: JekaPoyniak ($2.01 in chips)=20
Seat 8: jays451 ($2.42 in chips)=20
Seat 9: the_wickstar ($0.93 in chips)=20
JekaPoyniak: posts small blind $0.01
jays451: posts big blind $0.02
*** HOLE CARDS ***
Dealt to the_wickstar [Th 4h]
the_wickstar: folds=20
Ainur M: folds=20
fomik33: folds=20
izy cykerman: raises $0.02 to $0.04
And7888: calls $0.04
Sosiu82: folds=20
Assis2000: folds=20
JekaPoyniak: calls $0.03
jays451: calls $0.02
*** FLOP *** [8h Qc Ac]
JekaPoyniak: checks=20
jays451: checks=20
izy cykerman: bets $0.08
And7888: calls $0.08
JekaPoyniak: folds=20
jays451: folds=20
*** TURN *** [8h Qc Ac] [6s]
izy cykerman: bets $0.16
And7888: calls $0.16
*** RIVER *** [8h Qc Ac 6s] [4c]
izy cykerman: bets $0.31
And7888: calls $0.31
*** SHOW DOWN ***
izy cykerman: shows [Qs Qh] (three of a kind, Queens)
And7888: mucks hand=20
izy cykerman collected $1.22 from pot
*** SUMMARY ***
Total pot $1.26 | Rake $0.04=20
Board [8h Qc Ac 6s 4c]
Seat 1: Ainur M folded before Flop (didn't bet)
Seat 2: fomik33 folded before Flop (didn't bet)
Seat 3: izy cykerman showed [Qs Qh] and won ($1.22) with three of a kin=
d, Queens
Seat 4: And7888 mucked [Kc Ad]
Seat 5: Sosiu82 folded before Flop (didn't bet)
Seat 6: Assis2000 (button) folded before Flop (didn't bet)
Seat 7: JekaPoyniak (small blind) folded on the Flop
Seat 8: jays451 (big blind) folded on the Flop
Seat 9: the_wickstar folded before Flop (didn't bet)


*********** # 111 **************
PokerStars Hand #169800590503:  Hold'em No Limit ($0.01/$0.02 USD) - 20=
17/05/01 20:07:34 CUST [2017/05/01 6:07:34 ET]
Table 'Chandra' 9-max Seat #5 is the button
Seat 1: Ainur M ($1.58 in chips)=20
Seat 2: fomik33 ($2 in chips)=20
Seat 3: izy cykerman ($2.47 in chips)=20
Seat 4: And7888 ($1.06 in chips)=20
Seat 5: Sosiu82 ($0.84 in chips)=20
Seat 6: Assis2000 ($2.01 in chips)=20
Seat 7: JekaPoyniak ($2.03 in chips)=20
Seat 8: jays451 ($2.42 in chips)=20
Seat 9: the_wickstar ($0.93 in chips)=20
Assis2000: posts small blind $0.01
JekaPoyniak: posts big blind $0.02
*** HOLE CARDS ***
Dealt to the_wickstar [6h 4d]
jays451: folds=20
the_wickstar: folds=20
Ainur M: folds=20
fomik33: folds=20
izy cykerman: raises $0.02 to $0.04
And7888: raises $0.11 to $0.15
Sosiu82: folds=20
Assis2000: folds=20
JekaPoyniak: folds=20
izy cykerman: folds=20
Uncalled bet ($0.11) returned to And7888
And7888 collected $0.11 from pot
And7888: doesn't show hand=20
*** SUMMARY ***
Total pot $0.11 | Rake $0=20
Seat 1: Ainur M folded before Flop (didn't bet)
Seat 2: fomik33 folded before Flop (didn't bet)
Seat 3: izy cykerman folded before Flop
Seat 4: And7888 collected ($0.11)
Seat 5: Sosiu82 (button) folded before Flop (didn't bet)
Seat 6: Assis2000 (small blind) folded before Flop
Seat 7: JekaPoyniak (big blind) folded before Flop
Seat 8: jays451 folded before Flop (didn't bet)
Seat 9: the_wickstar folded before Flop (didn't bet)


*********** # 112 **************
PokerStars Hand #169800586280:  Hold'em No Limit ($0.01/$0.02 USD) - 20=
17/05/01 20:07:24 CUST [2017/05/01 6:07:24 ET]
Table 'Andraimon II' 9-max Seat #6 is the button
Seat 1: Zybex696 ($0.71 in chips)=20
Seat 2: sekcboy ($2.79 in chips)=20
Seat 3: 3AllBlack ($0.75 in chips)=20
Seat 4: the_wickstar ($0.64 in chips)=20
Seat 5: 1Asthma1 ($2 in chips)=20
Seat 6: Volk1001 ($1.60 in chips)=20
Seat 7: JekaPoyniak ($2 in chips)=20
Seat 8: Kirhgof_1988 ($2.21 in chips)=20
Seat 9: Vit94nit ($1.96 in chips)=20
JekaPoyniak: posts small blind $0.01
Kirhgof_1988: posts big blind $0.02
*** HOLE CARDS ***
Dealt to the_wickstar [Js 8c]
Vit94nit: folds=20
Zybex696 has timed out
Zybex696: folds=20
sekcboy: folds=20
3AllBlack is disconnected=20
3AllBlack is connected=20
3AllBlack has timed out
3AllBlack: folds=20
the_wickstar: folds=20
1Asthma1: folds=20
Volk1001: folds=20
JekaPoyniak: folds=20
Uncalled bet ($0.01) returned to Kirhgof_1988
Kirhgof_1988 collected $0.02 from pot
Kirhgof_1988: doesn't show hand=20
*** SUMMARY ***
Total pot $0.02 | Rake $0=20
Seat 1: Zybex696 folded before Flop (didn't bet)
Seat 2: sekcboy folded before Flop (didn't bet)
Seat 3: 3AllBlack folded before Flop (didn't bet)
Seat 4: the_wickstar folded before Flop (didn't bet)
Seat 5: 1Asthma1 folded before Flop (didn't bet)
Seat 6: Volk1001 (button) folded before Flop (didn't bet)
Seat 7: JekaPoyniak (small blind) folded before Flop
Seat 8: Kirhgof_1988 (big blind) collected ($0.02)
Seat 9: Vit94nit folded before Flop (didn't bet)


*********** # 113 **************
PokerStars Hand #169800574821:  Hold'em No Limit ($0.01/$0.02 USD) - 20=
17/05/01 20:06:57 CUST [2017/05/01 6:06:57 ET]
Table 'Andraimon II' 9-max Seat #5 is the button
Seat 1: Zybex696 ($0.71 in chips)=20
Seat 2: sekcboy ($2.79 in chips)=20
Seat 3: 3AllBlack ($0.75 in chips)=20
Seat 4: the_wickstar ($0.64 in chips)=20
Seat 5: 1Asthma1 ($2 in chips)=20
Seat 6: Volk1001 ($1.61 in chips)=20
Seat 7: JekaPoyniak ($2 in chips)=20
Seat 8: Kirhgof_1988 ($2.21 in chips)=20
Seat 9: Vit94nit ($1.93 in chips)=20
Volk1001: posts small blind $0.01
JekaPoyniak: posts big blind $0.02
*** HOLE CARDS ***
Dealt to the_wickstar [Ks 3h]
Kirhgof_1988: folds=20
Vit94nit: raises $0.05 to $0.07
Zybex696: folds=20
sekcboy: folds=20
3AllBlack: folds=20
the_wickstar: folds=20
1Asthma1: folds=20
Volk1001: folds=20
JekaPoyniak: folds=20
Uncalled bet ($0.05) returned to Vit94nit
Vit94nit collected $0.05 from pot
Vit94nit: doesn't show hand=20
*** SUMMARY ***
Total pot $0.05 | Rake $0=20
Seat 1: Zybex696 folded before Flop (didn't bet)
Seat 2: sekcboy folded before Flop (didn't bet)
Seat 3: 3AllBlack folded before Flop (didn't bet)
Seat 4: the_wickstar folded before Flop (didn't bet)
Seat 5: 1Asthma1 (button) folded before Flop (didn't bet)
Seat 6: Volk1001 (small blind) folded before Flop
Seat 7: JekaPoyniak (big blind) folded before Flop
Seat 8: Kirhgof_1988 folded before Flop (didn't bet)
Seat 9: Vit94nit collected ($0.05)


*********** # 114 **************
PokerStars Hand #169800558961:  Hold'em No Limit ($0.01/$0.02 USD) - 20=
17/05/01 20:06:19 CUST [2017/05/01 6:06:19 ET]
Table 'Chandra' 9-max Seat #4 is the button
Seat 1: Ainur M ($1.58 in chips)=20
Seat 2: fomik33 ($2.02 in chips)=20
Seat 3: izy cykerman ($2.47 in chips)=20
Seat 4: And7888 ($1.06 in chips)=20
Seat 5: Sosiu82 ($0.72 in chips)=20
Seat 6: Assis2000 ($2.03 in chips)=20
Seat 7: JekaPoyniak ($2.03 in chips)=20
Seat 8: jays451 ($2.42 in chips)=20
Seat 9: the_wickstar ($0.93 in chips)=20
Sosiu82: posts small blind $0.01
Assis2000: posts big blind $0.02
*** HOLE CARDS ***
Dealt to the_wickstar [9d Tc]
JekaPoyniak: folds=20
jays451: folds=20
the_wickstar: folds=20
Ainur M: folds=20
fomik33: raises $0.03 to $0.05
izy cykerman: folds=20
And7888: folds=20
Sosiu82: calls $0.04
Assis2000: folds=20
*** FLOP *** [Ad 5c Qh]
Sosiu82: checks=20
fomik33: checks=20
*** TURN *** [Ad 5c Qh] [8c]
Sosiu82: checks=20
fomik33: bets $0.06
Sosiu82: calls $0.06
*** RIVER *** [Ad 5c Qh 8c] [9c]
Sosiu82: bets $0.23
fomik33: folds=20
Uncalled bet ($0.23) returned to Sosiu82
Sosiu82 collected $0.23 from pot
Sosiu82: doesn't show hand=20
*** SUMMARY ***
Total pot $0.24 | Rake $0.01=20
Board [Ad 5c Qh 8c 9c]
Seat 1: Ainur M folded before Flop (didn't bet)
Seat 2: fomik33 folded on the River
Seat 3: izy cykerman folded before Flop (didn't bet)
Seat 4: And7888 (button) folded before Flop (didn't bet)
Seat 5: Sosiu82 (small blind) collected ($0.23)
Seat 6: Assis2000 (big blind) folded before Flop
Seat 7: JekaPoyniak folded before Flop (didn't bet)
Seat 8: jays451 folded before Flop (didn't bet)
Seat 9: the_wickstar folded before Flop (didn't bet)


*********** # 115 **************
PokerStars Hand #169800541269:  Hold'em No Limit ($0.01/$0.02 USD) - 20=
17/05/01 20:05:37 CUST [2017/05/01 6:05:37 ET]
Table 'Chandra' 9-max Seat #3 is the button
Seat 1: Ainur M ($1.58 in chips)=20
Seat 2: fomik33 ($2.02 in chips)=20
Seat 3: izy cykerman ($2.47 in chips)=20
Seat 4: And7888 ($1.08 in chips)=20
Seat 5: Sosiu82 ($0.70 in chips)=20
Seat 6: Assis2000 ($2.03 in chips)=20
Seat 7: JekaPoyniak ($2.03 in chips)=20
Seat 8: jays451 ($2.42 in chips)=20
Seat 9: the_wickstar ($0.93 in chips)=20
And7888: posts small blind $0.01
Sosiu82: posts big blind $0.02
*** HOLE CARDS ***
Dealt to the_wickstar [Kc 9d]
Assis2000: folds=20
JekaPoyniak: folds=20
jays451: folds=20
the_wickstar: folds=20
Ainur M: folds=20
fomik33: folds=20
izy cykerman: folds=20
And7888 is disconnected=20
And7888 is connected=20
And7888: calls $0.01
Sosiu82: checks=20
*** FLOP *** [2h 6c 4c]
And7888: checks=20
Sosiu82: checks=20
*** TURN *** [2h 6c 4c] [Kd]
And7888: checks=20
Sosiu82: checks=20
*** RIVER *** [2h 6c 4c Kd] [Td]
And7888: checks=20
Sosiu82: checks=20
*** SHOW DOWN ***
And7888: shows [8s 7h] (high card King)
Sosiu82: shows [3c 2s] (a pair of Deuces)
Sosiu82 collected $0.04 from pot
*** SUMMARY ***
Total pot $0.04 | Rake $0=20
Board [2h 6c 4c Kd Td]
Seat 1: Ainur M folded before Flop (didn't bet)
Seat 2: fomik33 folded before Flop (didn't bet)
Seat 3: izy cykerman (button) folded before Flop (didn't bet)
Seat 4: And7888 (small blind) showed [8s 7h] and lost with high card Ki=
ng
Seat 5: Sosiu82 (big blind) showed [3c 2s] and won ($0.04) with a pair =
of Deuces
Seat 6: Assis2000 folded before Flop (didn't bet)
Seat 7: JekaPoyniak folded before Flop (didn't bet)
Seat 8: jays451 folded before Flop (didn't bet)
Seat 9: the_wickstar folded before Flop (didn't bet)


*********** # 116 **************
PokerStars Hand #169800540259:  Hold'em No Limit ($0.01/$0.02 USD) - 20=
17/05/01 20:05:34 CUST [2017/05/01 6:05:34 ET]
Table 'Andraimon II' 9-max Seat #4 is the button
Seat 1: Zybex696 ($0.71 in chips)=20
Seat 2: sekcboy ($2.79 in chips)=20
Seat 3: 3AllBlack ($0.78 in chips)=20
Seat 4: the_wickstar ($0.58 in chips)=20
Seat 5: 1Asthma1 ($2.01 in chips)=20
Seat 6: Volk1001 ($1.63 in chips)=20
Seat 7: JekaPoyniak ($2 in chips)=20
Seat 8: Kirhgof_1988 ($2.21 in chips)=20
Seat 9: Vit94nit ($1.93 in chips)=20
1Asthma1: posts small blind $0.01
Volk1001: posts big blind $0.02
3AllBlack: posts small & big blinds $0.03
*** HOLE CARDS ***
Dealt to the_wickstar [Jd 5h]
JekaPoyniak: folds=20
Kirhgof_1988: folds=20
Vit94nit: folds=20
Zybex696: folds=20
sekcboy: folds=20
3AllBlack: checks=20
the_wickstar: calls $0.02
1Asthma1: folds=20
Volk1001: checks=20
*** FLOP *** [9s Th 2h]
Volk1001: checks=20
3AllBlack: checks=20
the_wickstar: bets $0.06
Volk1001: folds=20
3AllBlack is disconnected=20
3AllBlack is connected=20
3AllBlack: folds=20
Uncalled bet ($0.06) returned to the_wickstar
the_wickstar collected $0.08 from pot
*** SUMMARY ***
Total pot $0.08 | Rake $0=20
Board [9s Th 2h]
Seat 1: Zybex696 folded before Flop (didn't bet)
Seat 2: sekcboy folded before Flop (didn't bet)
Seat 3: 3AllBlack folded on the Flop
Seat 4: the_wickstar (button) collected ($0.08)
Seat 5: 1Asthma1 (small blind) folded before Flop
Seat 6: Volk1001 (big blind) folded on the Flop
Seat 7: JekaPoyniak folded before Flop (didn't bet)
Seat 8: Kirhgof_1988 folded before Flop (didn't bet)
Seat 9: Vit94nit folded before Flop (didn't bet)


*********** # 117 **************
PokerStars Hand #169800531924:  Hold'em No Limit ($0.01/$0.02 USD) - 20=
17/05/01 20:05:15 CUST [2017/05/01 6:05:15 ET]
Table 'Andraimon II' 9-max Seat #2 is the button
Seat 1: Zybex696 ($0.71 in chips)=20
Seat 2: sekcboy ($2.79 in chips)=20
Seat 4: the_wickstar ($0.59 in chips)=20
Seat 5: 1Asthma1 ($2 in chips)=20
Seat 6: Volk1001 ($1.63 in chips)=20
Seat 7: JekaPoyniak ($2 in chips)=20
Seat 8: Kirhgof_1988 ($2.21 in chips)=20
Seat 9: Vit94nit ($1.93 in chips)=20
3AllBlack will be allowed to play after the button
the_wickstar: posts small blind $0.01
1Asthma1: posts big blind $0.02
*** HOLE CARDS ***
Dealt to the_wickstar [6d Kd]
Volk1001: folds=20
JekaPoyniak: folds=20
Kirhgof_1988: folds=20
Vit94nit: folds=20
Zybex696: folds=20
sekcboy: folds=20
the_wickstar: folds=20
Uncalled bet ($0.01) returned to 1Asthma1
1Asthma1 collected $0.02 from pot
*** SUMMARY ***
Total pot $0.02 | Rake $0=20
Seat 1: Zybex696 folded before Flop (didn't bet)
Seat 2: sekcboy (button) folded before Flop (didn't bet)
Seat 4: the_wickstar (small blind) folded before Flop
Seat 5: 1Asthma1 (big blind) collected ($0.02)
Seat 6: Volk1001 folded before Flop (didn't bet)
Seat 7: JekaPoyniak folded before Flop (didn't bet)
Seat 8: Kirhgof_1988 folded before Flop (didn't bet)
Seat 9: Vit94nit folded before Flop (didn't bet)


*********** # 118 **************
PokerStars Hand #169800525477:  Hold'em No Limit ($0.01/$0.02 USD) - 20=
17/05/01 20:04:59 CUST [2017/05/01 6:04:59 ET]
Table 'Chandra' 9-max Seat #2 is the button
Seat 1: Ainur M ($1.58 in chips)=20
Seat 2: fomik33 ($2.02 in chips)=20
Seat 3: izy cykerman ($2.48 in chips)=20
Seat 4: And7888 ($1.10 in chips)=20
Seat 5: Sosiu82 ($0.70 in chips)=20
Seat 6: Assis2000 ($2.03 in chips)=20
Seat 7: JekaPoyniak ($2.03 in chips)=20
Seat 8: jays451 ($2.39 in chips)=20
Seat 9: the_wickstar ($0.93 in chips)=20
izy cykerman: posts small blind $0.01
And7888: posts big blind $0.02
*** HOLE CARDS ***
Dealt to the_wickstar [Ah 6h]
Sosiu82: folds=20
Assis2000: folds=20
JekaPoyniak: folds=20
jays451: raises $0.04 to $0.06
the_wickstar: folds=20
Ainur M: folds=20
fomik33: folds=20
izy cykerman: folds=20
And7888: folds=20
Uncalled bet ($0.04) returned to jays451
jays451 collected $0.05 from pot
jays451: doesn't show hand=20
*** SUMMARY ***
Total pot $0.05 | Rake $0=20
Seat 1: Ainur M folded before Flop (didn't bet)
Seat 2: fomik33 (button) folded before Flop (didn't bet)
Seat 3: izy cykerman (small blind) folded before Flop
Seat 4: And7888 (big blind) folded before Flop
Seat 5: Sosiu82 folded before Flop (didn't bet)
Seat 6: Assis2000 folded before Flop (didn't bet)
Seat 7: JekaPoyniak folded before Flop (didn't bet)
Seat 8: jays451 collected ($0.05)
Seat 9: the_wickstar folded before Flop (didn't bet)


*********** # 119 **************
PokerStars Hand #169800515806:  Hold'em No Limit ($0.01/$0.02 USD) - 20=
17/05/01 20:04:36 CUST [2017/05/01 6:04:36 ET]
Table 'Andraimon II' 9-max Seat #1 is the button
Seat 1: Zybex696 ($0.71 in chips)=20
Seat 2: sekcboy ($2.80 in chips)=20
Seat 4: the_wickstar ($0.61 in chips)=20
Seat 6: Volk1001 ($1.63 in chips)=20
Seat 7: JekaPoyniak ($2 in chips)=20
Seat 8: Kirhgof_1988 ($2.21 in chips)=20
Seat 9: Vit94nit ($1.90 in chips)=20
sekcboy: posts small blind $0.01
the_wickstar: posts big blind $0.02
1Asthma1: sits out=20
*** HOLE CARDS ***
Dealt to the_wickstar [6h 8c]
Volk1001: folds=20
JekaPoyniak: folds=20
Kirhgof_1988: folds=20
Vit94nit: raises $0.04 to $0.06
Zybex696: folds=20
sekcboy: folds=20
the_wickstar: folds=20
Uncalled bet ($0.04) returned to Vit94nit
Vit94nit collected $0.05 from pot
Vit94nit: doesn't show hand=20
*** SUMMARY ***
Total pot $0.05 | Rake $0=20
Seat 1: Zybex696 (button) folded before Flop (didn't bet)
Seat 2: sekcboy (small blind) folded before Flop
Seat 4: the_wickstar (big blind) folded before Flop
Seat 6: Volk1001 folded before Flop (didn't bet)
Seat 7: JekaPoyniak folded before Flop (didn't bet)
Seat 8: Kirhgof_1988 folded before Flop (didn't bet)
Seat 9: Vit94nit collected ($0.05)


*********** # 120 **************
PokerStars Hand #169800507544:  Hold'em No Limit ($0.01/$0.02 USD) - 20=
17/05/01 20:04:16 CUST [2017/05/01 6:04:16 ET]
Table 'Chandra' 9-max Seat #1 is the button
Seat 1: Ainur M ($1.58 in chips)=20
Seat 2: fomik33 ($2.03 in chips)=20
Seat 3: izy cykerman ($2.50 in chips)=20
Seat 4: And7888 ($1.10 in chips)=20
Seat 5: Sosiu82 ($0.70 in chips)=20
Seat 6: Assis2000 ($2.03 in chips)=20
Seat 7: JekaPoyniak ($2 in chips)=20
Seat 8: jays451 ($2.39 in chips)=20
Seat 9: the_wickstar ($0.93 in chips)=20
fomik33: posts small blind $0.01
izy cykerman: posts big blind $0.02
*** HOLE CARDS ***
Dealt to the_wickstar [2c 4d]
And7888: folds=20
Sosiu82: folds=20
Assis2000: folds=20
JekaPoyniak: raises $0.06 to $0.08
jays451: folds=20
the_wickstar: folds=20
Ainur M: folds=20
fomik33: folds=20
izy cykerman: folds=20
Uncalled bet ($0.06) returned to JekaPoyniak
JekaPoyniak collected $0.05 from pot
*** SUMMARY ***
Total pot $0.05 | Rake $0=20
Seat 1: Ainur M (button) folded before Flop (didn't bet)
Seat 2: fomik33 (small blind) folded before Flop
Seat 3: izy cykerman (big blind) folded before Flop
Seat 4: And7888 folded before Flop (didn't bet)
Seat 5: Sosiu82 folded before Flop (didn't bet)
Seat 6: Assis2000 folded before Flop (didn't bet)
Seat 7: JekaPoyniak collected ($0.05)
Seat 8: jays451 folded before Flop (didn't bet)
Seat 9: the_wickstar folded before Flop (didn't bet)


*********** # 121 **************
PokerStars Hand #169800496468:  Hold'em No Limit ($0.01/$0.02 USD) - 20=
17/05/01 20:03:50 CUST [2017/05/01 6:03:50 ET]
Table 'Andraimon II' 9-max Seat #9 is the button
Seat 1: Zybex696 ($0.69 in chips)=20
Seat 2: sekcboy ($2.82 in chips)=20
Seat 4: the_wickstar ($0.61 in chips)=20
Seat 6: Volk1001 ($1.63 in chips)=20
Seat 7: JekaPoyniak ($2 in chips)=20
Seat 8: Kirhgof_1988 ($2.21 in chips)=20
Seat 9: Vit94nit ($1.90 in chips)=20
Zybex696: posts small blind $0.01
sekcboy: posts big blind $0.02
3AllBlack is disconnected=20
3AllBlack has timed out while disconnected
3AllBlack: is sitting out=20
1Asthma1: sits out=20
*** HOLE CARDS ***
Dealt to the_wickstar [8d 7s]
the_wickstar: folds=20
Volk1001: folds=20
JekaPoyniak: folds=20
Kirhgof_1988: folds=20
Vit94nit: folds=20
Zybex696: raises $0.02 to $0.04
sekcboy: folds=20
Uncalled bet ($0.02) returned to Zybex696
Zybex696 collected $0.04 from pot
Zybex696: doesn't show hand=20
*** SUMMARY ***
Total pot $0.04 | Rake $0=20
Seat 1: Zybex696 (small blind) collected ($0.04)
Seat 2: sekcboy (big blind) folded before Flop
Seat 4: the_wickstar folded before Flop (didn't bet)
Seat 6: Volk1001 folded before Flop (didn't bet)
Seat 7: JekaPoyniak folded before Flop (didn't bet)
Seat 8: Kirhgof_1988 folded before Flop (didn't bet)
Seat 9: Vit94nit (button) folded before Flop (didn't bet)


*********** # 122 **************
PokerStars Hand #169800493147:  Hold'em No Limit ($0.01/$0.02 USD) - 20=
17/05/01 20:03:42 CUST [2017/05/01 6:03:42 ET]
Table 'Chandra' 9-max Seat #9 is the button
Seat 1: Ainur M ($1.59 in chips)=20
Seat 2: fomik33 ($2.05 in chips)=20
Seat 3: izy cykerman ($2.50 in chips)=20
Seat 4: And7888 ($1.10 in chips)=20
Seat 5: Sosiu82 ($0.67 in chips)=20
Seat 6: Assis2000 ($2.03 in chips)=20
Seat 7: JekaPoyniak ($2 in chips)=20
Seat 8: jays451 ($2.39 in chips)=20
Seat 9: the_wickstar ($0.93 in chips)=20
Ainur M: posts small blind $0.01
fomik33: posts big blind $0.02
*** HOLE CARDS ***
Dealt to the_wickstar [9c 4d]
izy cykerman: folds=20
And7888: folds=20
Sosiu82: raises $0.04 to $0.06
Assis2000: folds=20
JekaPoyniak: folds=20
jays451: folds=20
the_wickstar: folds=20
Ainur M: folds=20
fomik33: folds=20
Uncalled bet ($0.04) returned to Sosiu82
Sosiu82 collected $0.05 from pot
Sosiu82: doesn't show hand=20
*** SUMMARY ***
Total pot $0.05 | Rake $0=20
Seat 1: Ainur M (small blind) folded before Flop
Seat 2: fomik33 (big blind) folded before Flop
Seat 3: izy cykerman folded before Flop (didn't bet)
Seat 4: And7888 folded before Flop (didn't bet)
Seat 5: Sosiu82 collected ($0.05)
Seat 6: Assis2000 folded before Flop (didn't bet)
Seat 7: JekaPoyniak folded before Flop (didn't bet)
Seat 8: jays451 folded before Flop (didn't bet)
Seat 9: the_wickstar (button) folded before Flop (didn't bet)


*********** # 123 **************
PokerStars Hand #169800467609:  Hold'em No Limit ($0.01/$0.02 USD) - 20=
17/05/01 20:02:40 CUST [2017/05/01 6:02:40 ET]
Table 'Andraimon II' 9-max Seat #8 is the button
Seat 1: Zybex696 ($0.71 in chips)=20
Seat 2: sekcboy ($2.82 in chips)=20
Seat 4: the_wickstar ($0.58 in chips)=20
Seat 6: Volk1001 ($1.63 in chips)=20
Seat 7: JekaPoyniak ($2 in chips)=20
Seat 8: Kirhgof_1988 ($2.21 in chips)=20
Seat 9: Vit94nit ($1.91 in chips)=20
Vit94nit: posts small blind $0.01
Zybex696: posts big blind $0.02
3AllBlack: sits out=20
*** HOLE CARDS ***
Dealt to the_wickstar [Tc Jh]
Turbo777444 leaves the table
1Asthma1 joins the table at seat #5=20
sekcboy: folds=20
the_wickstar: calls $0.02
Volk1001: folds=20
JekaPoyniak: folds=20
Kirhgof_1988: folds=20
Vit94nit: folds=20
Zybex696: checks=20
*** FLOP *** [7d 7h 2d]
Zybex696: checks=20
the_wickstar: checks=20
*** TURN *** [7d 7h 2d] [3h]
Zybex696: checks=20
the_wickstar: checks=20
*** RIVER *** [7d 7h 2d 3h] [6d]
Zybex696: checks=20
the_wickstar: checks=20
*** SHOW DOWN ***
Zybex696: shows [8c 5d] (a pair of Sevens)
the_wickstar: shows [Tc Jh] (a pair of Sevens - Jack kicker)
the_wickstar collected $0.05 from pot
*** SUMMARY ***
Total pot $0.05 | Rake $0=20
Board [7d 7h 2d 3h 6d]
Seat 1: Zybex696 (big blind) showed [8c 5d] and lost with a pair of Sev=
ens
Seat 2: sekcboy folded before Flop (didn't bet)
Seat 4: the_wickstar showed [Tc Jh] and won ($0.05) with a pair of Seve=
ns
Seat 6: Volk1001 folded before Flop (didn't bet)
Seat 7: JekaPoyniak folded before Flop (didn't bet)
Seat 8: Kirhgof_1988 (button) folded before Flop (didn't bet)
Seat 9: Vit94nit (small blind) folded before Flop


*********** # 124 **************
PokerStars Hand #169800451545:  Hold'em No Limit ($0.01/$0.02 USD) - 20=
17/05/01 20:02:01 CUST [2017/05/01 6:02:01 ET]
Table 'Chandra' 9-max Seat #8 is the button
Seat 1: Ainur M ($1.61 in chips)=20
Seat 2: fomik33 ($2.05 in chips)=20
Seat 3: izy cykerman ($2.50 in chips)=20
Seat 4: And7888 ($1.10 in chips)=20
Seat 5: Sosiu82 ($0.59 in chips)=20
Seat 6: Assis2000 ($2.03 in chips)=20
Seat 7: JekaPoyniak ($2 in chips)=20
Seat 8: jays451 ($2.39 in chips)=20
Seat 9: the_wickstar ($0.99 in chips)=20
the_wickstar: posts small blind $0.01
Ainur M: posts big blind $0.02
*** HOLE CARDS ***
Dealt to the_wickstar [8c Js]
fomik33: folds=20
izy cykerman: folds=20
And7888: folds=20
Sosiu82: calls $0.02
Assis2000: folds=20
JekaPoyniak: folds=20
jays451: folds=20
the_wickstar: calls $0.01
Ainur M: checks=20
*** FLOP *** [Kh 7h Tc]
the_wickstar: checks=20
Ainur M: checks=20
Sosiu82: checks=20
*** TURN *** [Kh 7h Tc] [6d]
the_wickstar: checks=20
Ainur M: checks=20
Sosiu82: checks=20
*** RIVER *** [Kh 7h Tc 6d] [Kd]
the_wickstar: bets $0.04
Ainur M: folds=20
Sosiu82: calls $0.04
*** SHOW DOWN ***
the_wickstar: shows [8c Js] (a pair of Kings)
Sosiu82: shows [Ac 2h] (a pair of Kings - Ace kicker)
Sosiu82 collected $0.14 from pot
*** SUMMARY ***
Total pot $0.14 | Rake $0=20
Board [Kh 7h Tc 6d Kd]
Seat 1: Ainur M (big blind) folded on the River
Seat 2: fomik33 folded before Flop (didn't bet)
Seat 3: izy cykerman folded before Flop (didn't bet)
Seat 4: And7888 folded before Flop (didn't bet)
Seat 5: Sosiu82 showed [Ac 2h] and won ($0.14) with a pair of Kings
Seat 6: Assis2000 folded before Flop (didn't bet)
Seat 7: JekaPoyniak folded before Flop (didn't bet)
Seat 8: jays451 (button) folded before Flop (didn't bet)
Seat 9: the_wickstar (small blind) showed [8c Js] and lost with a pair =
of Kings


*********** # 125 **************
PokerStars Hand #169800441649:  Hold'em No Limit ($0.01/$0.02 USD) - 20=
17/05/01 20:01:37 CUST [2017/05/01 6:01:37 ET]
Table 'Andraimon II' 9-max Seat #7 is the button
Seat 1: Zybex696 ($0.71 in chips)=20
Seat 2: sekcboy ($2.82 in chips)=20
Seat 4: the_wickstar ($0.60 in chips)=20
Seat 5: Turbo777444 ($0.18 in chips)=20
Seat 6: Volk1001 ($1.63 in chips)=20
Seat 7: JekaPoyniak ($2 in chips)=20
Seat 8: Kirhgof_1988 ($2.23 in chips)=20
Seat 9: Vit94nit ($1.70 in chips)=20
Kirhgof_1988: posts small blind $0.01
Vit94nit: posts big blind $0.02
3AllBlack: sits out=20
*** HOLE CARDS ***
Dealt to the_wickstar [9h 8h]
Zybex696: folds=20
sekcboy: folds=20
the_wickstar: calls $0.02
Turbo777444: calls $0.02
Volk1001: folds=20
JekaPoyniak: folds=20
Kirhgof_1988: calls $0.01
Vit94nit: raises $0.08 to $0.10
the_wickstar: folds=20
Turbo777444: calls $0.08
Kirhgof_1988: folds=20
*** FLOP *** [9d 7d 7s]
Vit94nit: bets $0.08
Turbo777444: calls $0.08 and is all-in
*** TURN *** [9d 7d 7s] [9c]
*** RIVER *** [9d 7d 7s 9c] [Qs]
*** SHOW DOWN ***
Vit94nit: shows [As Th] (two pair, Nines and Sevens)
Turbo777444: shows [8c Jc] (two pair, Nines and Sevens - lower kicker)
Vit94nit collected $0.39 from pot
*** SUMMARY ***
Total pot $0.40 | Rake $0.01=20
Board [9d 7d 7s 9c Qs]
Seat 1: Zybex696 folded before Flop (didn't bet)
Seat 2: sekcboy folded before Flop (didn't bet)
Seat 4: the_wickstar folded before Flop
Seat 5: Turbo777444 showed [8c Jc] and lost with two pair, Nines and Se=
vens
Seat 6: Volk1001 folded before Flop (didn't bet)
Seat 7: JekaPoyniak (button) folded before Flop (didn't bet)
Seat 8: Kirhgof_1988 (small blind) folded before Flop
Seat 9: Vit94nit (big blind) showed [As Th] and won ($0.39) with two pa=
ir, Nines and Sevens


*********** # 126 **************
PokerStars Hand #169800420547:  Hold'em No Limit ($0.01/$0.02 USD) - 20=
17/05/01 20:00:44 CUST [2017/05/01 6:00:44 ET]
Table 'Chandra' 9-max Seat #7 is the button
Seat 1: Ainur M ($1.61 in chips)=20
Seat 2: fomik33 ($2.05 in chips)=20
Seat 3: izy cykerman ($2.50 in chips)=20
Seat 4: And7888 ($1.10 in chips)=20
Seat 5: Sosiu82 ($0.67 in chips)=20
Seat 6: Assis2000 ($2.03 in chips)=20
Seat 7: JekaPoyniak ($2 in chips)=20
Seat 8: jays451 ($2.30 in chips)=20
Seat 9: the_wickstar ($1.01 in chips)=20
jays451: posts small blind $0.01
the_wickstar: posts big blind $0.02
*** HOLE CARDS ***
Dealt to the_wickstar [2d 2c]
Ainur M: folds=20
fomik33: folds=20
izy cykerman: folds=20
And7888: folds=20
Sosiu82: calls $0.02
Assis2000: folds=20
JekaPoyniak: folds=20
jays451: raises $0.06 to $0.08
the_wickstar: folds=20
Sosiu82: calls $0.06
*** FLOP *** [Tc 8c Ts]
And7888 is disconnected=20
jays451: bets $0.12
Sosiu82: folds=20
Uncalled bet ($0.12) returned to jays451
jays451 collected $0.17 from pot
jays451: doesn't show hand=20
*** SUMMARY ***
Total pot $0.18 | Rake $0.01=20
Board [Tc 8c Ts]
Seat 1: Ainur M folded before Flop (didn't bet)
Seat 2: fomik33 folded before Flop (didn't bet)
Seat 3: izy cykerman folded before Flop (didn't bet)
Seat 4: And7888 folded before Flop (didn't bet)
Seat 5: Sosiu82 folded on the Flop
Seat 6: Assis2000 folded before Flop (didn't bet)
Seat 7: JekaPoyniak (button) folded before Flop (didn't bet)
Seat 8: jays451 (small blind) collected ($0.17)
Seat 9: the_wickstar (big blind) folded before Flop


*********** # 127 **************
PokerStars Hand #169800413520:  Hold'em No Limit ($0.01/$0.02 USD) - 20=
17/05/01 20:00:26 CUST [2017/05/01 6:00:26 ET]
Table 'Andraimon II' 9-max Seat #6 is the button
Seat 1: Zybex696 ($0.71 in chips)=20
Seat 2: sekcboy ($2.82 in chips)=20
Seat 4: the_wickstar ($0.62 in chips)=20
Seat 5: Turbo777444 ($0.72 in chips)=20
Seat 6: Volk1001 ($1.08 in chips)=20
Seat 7: JekaPoyniak ($2 in chips)=20
Seat 8: Kirhgof_1988 ($2.25 in chips)=20
Seat 9: Vit94nit ($1.70 in chips)=20
JekaPoyniak: posts small blind $0.01
Kirhgof_1988: posts big blind $0.02
3AllBlack is disconnected=20
3AllBlack is connected=20
3AllBlack: sits out=20
*** HOLE CARDS ***
Dealt to the_wickstar [Kh 8c]
Vit94nit: folds=20
Zybex696: folds=20
sekcboy: folds=20
the_wickstar: calls $0.02
Turbo777444: calls $0.02
Volk1001: raises $0.06 to $0.08
JekaPoyniak: folds=20
Kirhgof_1988: folds=20
the_wickstar: folds=20
Turbo777444: calls $0.06
*** FLOP *** [8h 2s 9s]
Turbo777444: bets $0.10
3AllBlack is disconnected=20
Volk1001: calls $0.10
*** TURN *** [8h 2s 9s] [4h]
Turbo777444: bets $0.06
Volk1001: raises $0.08 to $0.14
Turbo777444: calls $0.08
*** RIVER *** [8h 2s 9s 4h] [Jc]
Turbo777444: checks=20
Volk1001: bets $0.22
Turbo777444: calls $0.22
*** SHOW DOWN ***
Volk1001: shows [Ah As] (a pair of Aces)
Turbo777444: mucks hand=20
Volk1001 collected $1.09 from pot
*** SUMMARY ***
Total pot $1.13 | Rake $0.04=20
Board [8h 2s 9s 4h Jc]
Seat 1: Zybex696 folded before Flop (didn't bet)
Seat 2: sekcboy folded before Flop (didn't bet)
Seat 4: the_wickstar folded before Flop
Seat 5: Turbo777444 mucked [9h 7c]
Seat 6: Volk1001 (button) showed [Ah As] and won ($1.09) with a pair of=
 Aces
Seat 7: JekaPoyniak (small blind) folded before Flop
Seat 8: Kirhgof_1988 (big blind) folded before Flop
Seat 9: Vit94nit folded before Flop (didn't bet)


*********** # 128 **************
PokerStars Hand #169800404051:  Hold'em No Limit ($0.01/$0.02 USD) - 20=
17/05/01 20:00:01 CUST [2017/05/01 6:00:01 ET]
Table 'Andraimon II' 9-max Seat #5 is the button
Seat 1: Zybex696 ($0.71 in chips)=20
Seat 2: sekcboy ($2.82 in chips)=20
Seat 4: the_wickstar ($0.62 in chips)=20
Seat 5: Turbo777444 ($0.72 in chips)=20
Seat 6: Volk1001 ($1.06 in chips)=20
Seat 7: JekaPoyniak ($2 in chips)=20
Seat 8: Kirhgof_1988 ($2.25 in chips)=20
Seat 9: Vit94nit ($1.70 in chips)=20
Volk1001: posts small blind $0.01
JekaPoyniak: posts big blind $0.02
*** HOLE CARDS ***
Dealt to the_wickstar [9h Kc]
Kirhgof_1988: folds=20
Vit94nit: folds=20
Zybex696: folds=20
sekcboy: folds=20
the_wickstar: folds=20
Turbo777444: folds=20
Volk1001: raises $0.02 to $0.04
JekaPoyniak: folds=20
Uncalled bet ($0.02) returned to Volk1001
Volk1001 collected $0.04 from pot
*** SUMMARY ***
Total pot $0.04 | Rake $0=20
Seat 1: Zybex696 folded before Flop (didn't bet)
Seat 2: sekcboy folded before Flop (didn't bet)
Seat 4: the_wickstar folded before Flop (didn't bet)
Seat 5: Turbo777444 (button) folded before Flop (didn't bet)
Seat 6: Volk1001 (small blind) collected ($0.04)
Seat 7: JekaPoyniak (big blind) folded before Flop
Seat 8: Kirhgof_1988 folded before Flop (didn't bet)
Seat 9: Vit94nit folded before Flop (didn't bet)


*********** # 129 **************
PokerStars Hand #169800386588:  Hold'em No Limit ($0.01/$0.02 USD) - 20=
17/05/01 19:59:14 CUST [2017/05/01 5:59:14 ET]
Table 'Chandra' 9-max Seat #6 is the button
Seat 1: Ainur M ($1.61 in chips)=20
Seat 2: fomik33 ($2.05 in chips)=20
Seat 3: izy cykerman ($2.50 in chips)=20
Seat 4: And7888 ($1.26 in chips)=20
Seat 5: Sosiu82 ($0.69 in chips)=20
Seat 6: Assis2000 ($2.03 in chips)=20
Seat 7: JekaPoyniak ($2 in chips)=20
Seat 8: jays451 ($2.32 in chips)=20
Seat 9: the_wickstar ($0.81 in chips)=20
JekaPoyniak: posts small blind $0.01
jays451: posts big blind $0.02
*** HOLE CARDS ***
Dealt to the_wickstar [Qd Jh]
the_wickstar: calls $0.02
Ainur M: folds=20
fomik33: folds=20
izy cykerman: folds=20
And7888: calls $0.02
Sosiu82: calls $0.02
Assis2000: folds=20
JekaPoyniak: folds=20
jays451: checks=20
*** FLOP *** [4h 8c Qs]
jays451: checks=20
the_wickstar: bets $0.05
And7888: calls $0.05
Sosiu82: folds=20
jays451: folds=20
*** TURN *** [4h 8c Qs] [5s]
the_wickstar: checks=20
And7888: bets $0.09
the_wickstar: calls $0.09
*** RIVER *** [4h 8c Qs 5s] [8s]
the_wickstar: checks=20
And7888: checks=20
*** SHOW DOWN ***
the_wickstar: shows [Qd Jh] (two pair, Queens and Eights)
And7888: mucks hand=20
the_wickstar collected $0.36 from pot
*** SUMMARY ***
Total pot $0.37 | Rake $0.01=20
Board [4h 8c Qs 5s 8s]
Seat 1: Ainur M folded before Flop (didn't bet)
Seat 2: fomik33 folded before Flop (didn't bet)
Seat 3: izy cykerman folded before Flop (didn't bet)
Seat 4: And7888 mucked [Qh Td]
Seat 5: Sosiu82 folded on the Flop
Seat 6: Assis2000 (button) folded before Flop (didn't bet)
Seat 7: JekaPoyniak (small blind) folded before Flop
Seat 8: jays451 (big blind) folded on the Flop
Seat 9: the_wickstar showed [Qd Jh] and won ($0.36) with two pair, Quee=
ns and Eights


*********** # 130 **************
PokerStars Hand #169800385632:  Hold'em No Limit ($0.01/$0.02 USD) - 20=
17/05/01 19:59:12 CUST [2017/05/01 5:59:12 ET]
Table 'Andraimon II' 9-max Seat #4 is the button
Seat 1: Zybex696 ($0.77 in chips)=20
Seat 2: sekcboy ($2.88 in chips)=20
Seat 4: the_wickstar ($0.68 in chips)=20
Seat 5: Turbo777444 ($0.78 in chips)=20
Seat 6: Volk1001 ($1.08 in chips)=20
Seat 8: Kirhgof_1988 ($2 in chips)=20
Seat 9: Vit94nit ($1.70 in chips)=20
Turbo777444: posts small blind $0.01
Volk1001: posts big blind $0.02
JekaPoyniak: sits out=20
*** HOLE CARDS ***
Dealt to the_wickstar [8d 7c]
Kirhgof_1988: raises $0.04 to $0.06
Vit94nit: folds=20
Zybex696: calls $0.06
sekcboy: calls $0.06
the_wickstar: calls $0.06
Turbo777444: calls $0.05
Volk1001: folds=20
*** FLOP *** [3d Jc 9d]
Turbo777444: checks=20
Kirhgof_1988: bets $0.21
Zybex696: folds=20
sekcboy: folds=20
the_wickstar: folds=20
Turbo777444: folds=20
Uncalled bet ($0.21) returned to Kirhgof_1988
Kirhgof_1988 collected $0.31 from pot
Kirhgof_1988: doesn't show hand=20
*** SUMMARY ***
Total pot $0.32 | Rake $0.01=20
Board [3d Jc 9d]
Seat 1: Zybex696 folded on the Flop
Seat 2: sekcboy folded on the Flop
Seat 4: the_wickstar (button) folded on the Flop
Seat 5: Turbo777444 (small blind) folded on the Flop
Seat 6: Volk1001 (big blind) folded before Flop
Seat 8: Kirhgof_1988 collected ($0.31)
Seat 9: Vit94nit folded before Flop (didn't bet)


*********** # 131 **************
PokerStars Hand #169800365981:  Hold'em No Limit ($0.01/$0.02 USD) - 20=
17/05/01 19:58:19 CUST [2017/05/01 5:58:19 ET]
Table 'Andraimon II' 9-max Seat #2 is the button
Seat 1: Zybex696 ($0.77 in chips)=20
Seat 2: sekcboy ($2.88 in chips)=20
Seat 4: the_wickstar ($0.69 in chips)=20
Seat 5: Turbo777444 ($0.80 in chips)=20
Seat 6: Volk1001 ($0.88 in chips)=20
Seat 8: Kirhgof_1988 ($2 in chips)=20
Seat 9: Vit94nit ($1.88 in chips)=20
the_wickstar: posts small blind $0.01
Turbo777444: posts big blind $0.02
JekaPoyniak: sits out=20
*** HOLE CARDS ***
Dealt to the_wickstar [3h 5h]
Volk1001: raises $0.04 to $0.06
Kirhgof_1988: folds=20
Vit94nit: raises $0.06 to $0.12
Zybex696: folds=20
sekcboy: folds=20
the_wickstar: folds=20
Turbo777444: folds=20
Volk1001: calls $0.06
*** FLOP *** [Kh 9c Qd]
Volk1001: checks=20
Vit94nit: bets $0.06
Volk1001: calls $0.06
*** TURN *** [Kh 9c Qd] [Qc]
Volk1001: checks=20
Vit94nit: checks=20
*** RIVER *** [Kh 9c Qd Qc] [4s]
Volk1001: bets $0.14
Vit94nit: folds=20
Uncalled bet ($0.14) returned to Volk1001
Volk1001 collected $0.38 from pot
*** SUMMARY ***
Total pot $0.39 | Rake $0.01=20
Board [Kh 9c Qd Qc 4s]
Seat 1: Zybex696 folded before Flop (didn't bet)
Seat 2: sekcboy (button) folded before Flop (didn't bet)
Seat 4: the_wickstar (small blind) folded before Flop
Seat 5: Turbo777444 (big blind) folded before Flop
Seat 6: Volk1001 collected ($0.38)
Seat 8: Kirhgof_1988 folded before Flop (didn't bet)
Seat 9: Vit94nit folded on the River


*********** # 132 **************
PokerStars Hand #169800357124:  Hold'em No Limit ($0.01/$0.02 USD) - 20=
17/05/01 19:57:55 CUST [2017/05/01 5:57:55 ET]
Table 'Andraimon II' 9-max Seat #1 is the button
Seat 1: Zybex696 ($0.77 in chips)=20
Seat 2: sekcboy ($2.89 in chips)=20
Seat 4: the_wickstar ($0.68 in chips)=20
Seat 5: Turbo777444 ($0.80 in chips)=20
Seat 6: Volk1001 ($0.88 in chips)=20
Seat 8: Kirhgof_1988 ($2 in chips)=20
Seat 9: Vit94nit ($1.88 in chips)=20
sekcboy: posts small blind $0.01
the_wickstar: posts big blind $0.02
JekaPoyniak: sits out=20
*** HOLE CARDS ***
Dealt to the_wickstar [Jd Kd]
Turbo777444: folds=20
Volk1001: folds=20
Kirhgof_1988: folds=20
Vit94nit: folds=20
Zybex696: folds=20
sekcboy: folds=20
Uncalled bet ($0.01) returned to the_wickstar
the_wickstar collected $0.02 from pot
*** SUMMARY ***
Total pot $0.02 | Rake $0=20
Seat 1: Zybex696 (button) folded before Flop (didn't bet)
Seat 2: sekcboy (small blind) folded before Flop
Seat 4: the_wickstar (big blind) collected ($0.02)
Seat 5: Turbo777444 folded before Flop (didn't bet)
Seat 6: Volk1001 folded before Flop (didn't bet)
Seat 8: Kirhgof_1988 folded before Flop (didn't bet)
Seat 9: Vit94nit folded before Flop (didn't bet)


*********** # 133 **************
PokerStars Hand #169800344144:  Hold'em No Limit ($0.01/$0.02 USD) - 20=
17/05/01 19:57:20 CUST [2017/05/01 5:57:20 ET]
Table 'Chandra' 9-max Seat #5 is the button
Seat 1: Ainur M ($1.61 in chips)=20
Seat 2: fomik33 ($2.05 in chips)=20
Seat 3: izy cykerman ($2.50 in chips)=20
Seat 4: And7888 ($1.28 in chips)=20
Seat 5: Sosiu82 ($0.58 in chips)=20
Seat 6: Assis2000 ($2.05 in chips)=20
Seat 7: JekaPoyniak ($2 in chips)=20
Seat 8: jays451 ($2.32 in chips)=20
Seat 9: the_wickstar ($0.87 in chips)=20
Assis2000: posts small blind $0.01
JekaPoyniak: posts big blind $0.02
*** HOLE CARDS ***
Dealt to the_wickstar [Td Kd]
jays451: folds=20
the_wickstar: calls $0.02
Ainur M: folds=20
fomik33: folds=20
izy cykerman: folds=20
And7888 is disconnected=20
And7888 is connected=20
And7888: calls $0.02
Sosiu82: calls $0.02
Assis2000: calls $0.01
JekaPoyniak: checks=20
*** FLOP *** [6h Qh As]
Assis2000: checks=20
JekaPoyniak: checks=20
the_wickstar: checks=20
And7888: checks=20
Sosiu82: bets $0.04
Assis2000: folds=20
JekaPoyniak: folds=20
the_wickstar: calls $0.04
And7888: folds=20
*** TURN *** [6h Qh As] [9s]
the_wickstar: checks=20
Sosiu82: bets $0.09
the_wickstar: folds=20
Uncalled bet ($0.09) returned to Sosiu82
Sosiu82 collected $0.17 from pot
Sosiu82: doesn't show hand=20
*** SUMMARY ***
Total pot $0.18 | Rake $0.01=20
Board [6h Qh As 9s]
Seat 1: Ainur M folded before Flop (didn't bet)
Seat 2: fomik33 folded before Flop (didn't bet)
Seat 3: izy cykerman folded before Flop (didn't bet)
Seat 4: And7888 folded on the Flop
Seat 5: Sosiu82 (button) collected ($0.17)
Seat 6: Assis2000 (small blind) folded on the Flop
Seat 7: JekaPoyniak (big blind) folded on the Flop
Seat 8: jays451 folded before Flop (didn't bet)
Seat 9: the_wickstar folded on the Turn


*********** # 134 **************
PokerStars Hand #169800343226:  Hold'em No Limit ($0.01/$0.02 USD) - 20=
17/05/01 19:57:18 CUST [2017/05/01 5:57:18 ET]
Table 'Andraimon II' 9-max Seat #9 is the button
Seat 1: Zybex696 ($0.78 in chips)=20
Seat 2: sekcboy ($2.91 in chips)=20
Seat 4: the_wickstar ($0.68 in chips)=20
Seat 5: Turbo777444 ($0.80 in chips)=20
Seat 6: Volk1001 ($0.80 in chips)=20
Seat 8: Kirhgof_1988 ($2 in chips)=20
Seat 9: Vit94nit ($1.88 in chips)=20
Zybex696: posts small blind $0.01
sekcboy: posts big blind $0.02
JekaPoyniak: sits out=20
*** HOLE CARDS ***
Dealt to the_wickstar [2h 7s]
the_wickstar: folds=20
Turbo777444: folds=20
Volk1001: raises $0.04 to $0.06
Kirhgof_1988: calls $0.06
Vit94nit: folds=20
Zybex696: folds=20
sekcboy: folds=20
*** FLOP *** [4s 6c 4c]
Volk1001: checks=20
Kirhgof_1988: checks=20
*** TURN *** [4s 6c 4c] [Th]
Volk1001: bets $0.06
Kirhgof_1988: folds=20
Uncalled bet ($0.06) returned to Volk1001
Volk1001 collected $0.14 from pot
*** SUMMARY ***
Total pot $0.15 | Rake $0.01=20
Board [4s 6c 4c Th]
Seat 1: Zybex696 (small blind) folded before Flop
Seat 2: sekcboy (big blind) folded before Flop
Seat 4: the_wickstar folded before Flop (didn't bet)
Seat 5: Turbo777444 folded before Flop (didn't bet)
Seat 6: Volk1001 collected ($0.14)
Seat 8: Kirhgof_1988 folded on the Turn
Seat 9: Vit94nit (button) folded before Flop (didn't bet)


*********** # 135 **************
PokerStars Hand #169800336759:  Hold'em No Limit ($0.01/$0.02 USD) - 20=
17/05/01 19:57:00 CUST [2017/05/01 5:57:00 ET]
Table 'Andraimon II' 9-max Seat #8 is the button
Seat 1: Zybex696 ($0.77 in chips)=20
Seat 2: sekcboy ($2.91 in chips)=20
Seat 4: the_wickstar ($0.68 in chips)=20
Seat 5: Turbo777444 ($0.80 in chips)=20
Seat 6: Volk1001 ($0.80 in chips)=20
Seat 8: Kirhgof_1988 ($2 in chips)=20
Seat 9: Vit94nit ($1.89 in chips)=20
Vit94nit: posts small blind $0.01
Zybex696: posts big blind $0.02
JekaPoyniak: sits out=20
*** HOLE CARDS ***
Dealt to the_wickstar [4s 7c]
sekcboy: folds=20
the_wickstar: folds=20
Turbo777444: folds=20
Volk1001: folds=20
Kirhgof_1988: folds=20
Vit94nit: folds=20
Uncalled bet ($0.01) returned to Zybex696
Zybex696 collected $0.02 from pot
Zybex696: doesn't show hand=20
*** SUMMARY ***
Total pot $0.02 | Rake $0=20
Seat 1: Zybex696 (big blind) collected ($0.02)
Seat 2: sekcboy folded before Flop (didn't bet)
Seat 4: the_wickstar folded before Flop (didn't bet)
Seat 5: Turbo777444 folded before Flop (didn't bet)
Seat 6: Volk1001 folded before Flop (didn't bet)
Seat 8: Kirhgof_1988 (button) folded before Flop (didn't bet)
Seat 9: Vit94nit (small blind) folded before Flop


*********** # 136 **************
PokerStars Hand #169800329832:  Hold'em No Limit ($0.01/$0.02 USD) - 20=
17/05/01 19:56:42 CUST [2017/05/01 5:56:42 ET]
Table 'Andraimon II' 9-max Seat #6 is the button
Seat 1: Zybex696 ($0.77 in chips)=20
Seat 2: sekcboy ($2.91 in chips)=20
Seat 4: the_wickstar ($0.68 in chips)=20
Seat 6: Volk1001 ($0.77 in chips)=20
Seat 8: Kirhgof_1988 ($2 in chips)=20
Seat 9: Vit94nit ($1.91 in chips)=20
JekaPoyniak will be allowed to play after the button
Kirhgof_1988: posts small blind $0.01
Vit94nit: posts big blind $0.02
*** HOLE CARDS ***
Dealt to the_wickstar [8h Qc]
Zybex696: folds=20
sekcboy: folds=20
the_wickstar: folds=20
Volk1001: raises $0.02 to $0.04
Kirhgof_1988: folds=20
Vit94nit: folds=20
Uncalled bet ($0.02) returned to Volk1001
Volk1001 collected $0.05 from pot
*** SUMMARY ***
Total pot $0.05 | Rake $0=20
Seat 1: Zybex696 folded before Flop (didn't bet)
Seat 2: sekcboy folded before Flop (didn't bet)
Seat 4: the_wickstar folded before Flop (didn't bet)
Seat 6: Volk1001 (button) collected ($0.05)
Seat 8: Kirhgof_1988 (small blind) folded before Flop
Seat 9: Vit94nit (big blind) folded before Flop


*********** # 137 **************
PokerStars Hand #169800325145:  Hold'em No Limit ($0.01/$0.02 USD) - 20=
17/05/01 19:56:29 CUST [2017/05/01 5:56:29 ET]
Table 'Chandra' 9-max Seat #4 is the button
Seat 1: Ainur M ($1.61 in chips)=20
Seat 2: fomik33 ($2.05 in chips)=20
Seat 3: izy cykerman ($2.50 in chips)=20
Seat 4: And7888 ($1.28 in chips)=20
Seat 5: Sosiu82 ($0.56 in chips)=20
Seat 6: Assis2000 ($2.07 in chips)=20
Seat 8: jays451 ($2.32 in chips)=20
Seat 9: the_wickstar ($0.87 in chips)=20
Sosiu82: posts small blind $0.01
Assis2000: posts big blind $0.02
JekaPoyniak: sits out=20
*** HOLE CARDS ***
Dealt to the_wickstar [Qd 9s]
jays451: folds=20
the_wickstar: folds=20
Ainur M: folds=20
fomik33: folds=20
izy cykerman: folds=20
And7888: folds=20
Sosiu82: calls $0.01
Assis2000: checks=20
*** FLOP *** [Kc 6c Tc]
Sosiu82: checks=20
Assis2000: checks=20
*** TURN *** [Kc 6c Tc] [4s]
Sosiu82: checks=20
Assis2000: checks=20
*** RIVER *** [Kc 6c Tc 4s] [7h]
Sosiu82: checks=20
Assis2000: checks=20
*** SHOW DOWN ***
Sosiu82: shows [3h As] (high card Ace)
Assis2000: mucks hand=20
Sosiu82 collected $0.04 from pot
*** SUMMARY ***
Total pot $0.04 | Rake $0=20
Board [Kc 6c Tc 4s 7h]
Seat 1: Ainur M folded before Flop (didn't bet)
Seat 2: fomik33 folded before Flop (didn't bet)
Seat 3: izy cykerman folded before Flop (didn't bet)
Seat 4: And7888 (button) folded before Flop (didn't bet)
Seat 5: Sosiu82 (small blind) showed [3h As] and won ($0.04) with high =
card Ace
Seat 6: Assis2000 (big blind) mucked [2h 9h]
Seat 8: jays451 folded before Flop (didn't bet)
Seat 9: the_wickstar folded before Flop (didn't bet)


*********** # 138 **************
PokerStars Hand #169800312249:  Hold'em No Limit ($0.01/$0.02 USD) - 20=
17/05/01 19:55:54 CUST [2017/05/01 5:55:54 ET]
Table 'Chandra' 9-max Seat #3 is the button
Seat 1: Ainur M ($1.61 in chips)=20
Seat 2: fomik33 ($2.05 in chips)=20
Seat 3: izy cykerman ($2.50 in chips)=20
Seat 4: And7888 ($1.29 in chips)=20
Seat 5: Sosiu82 ($0.55 in chips)=20
Seat 6: Assis2000 ($2.07 in chips)=20
Seat 8: jays451 ($2.32 in chips)=20
Seat 9: the_wickstar ($0.87 in chips)=20
And7888: posts small blind $0.01
Sosiu82: posts big blind $0.02
JekaPoyniak: sits out=20
*** HOLE CARDS ***
Dealt to the_wickstar [Ah 6c]
Assis2000: folds=20
jays451: folds=20
the_wickstar: folds=20
Ainur M: folds=20
fomik33: folds=20
izy cykerman has timed out
izy cykerman: folds=20
And7888: folds=20
Uncalled bet ($0.01) returned to Sosiu82
Sosiu82 collected $0.02 from pot
Sosiu82: doesn't show hand=20
*** SUMMARY ***
Total pot $0.02 | Rake $0=20
Seat 1: Ainur M folded before Flop (didn't bet)
Seat 2: fomik33 folded before Flop (didn't bet)
Seat 3: izy cykerman (button) folded before Flop (didn't bet)
Seat 4: And7888 (small blind) folded before Flop
Seat 5: Sosiu82 (big blind) collected ($0.02)
Seat 6: Assis2000 folded before Flop (didn't bet)
Seat 8: jays451 folded before Flop (didn't bet)
Seat 9: the_wickstar folded before Flop (didn't bet)


*********** # 139 **************
PokerStars Hand #169800308094:  Hold'em No Limit ($0.01/$0.02 USD) - 20=
17/05/01 19:55:42 CUST [2017/05/01 5:55:42 ET]
Table 'Andraimon II' 9-max Seat #5 is the button
Seat 1: Zybex696 ($0.77 in chips)=20
Seat 2: sekcboy ($2.30 in chips)=20
Seat 4: the_wickstar ($0.68 in chips)=20
Seat 5: Turbo777444 ($0.62 in chips)=20
Seat 6: Volk1001 ($0.78 in chips)=20
Seat 8: Kirhgof_1988 ($2 in chips)=20
Seat 9: Vit94nit ($1.91 in chips)=20
Volk1001: posts small blind $0.01
SametsPickUp: is sitting out=20
Kirhgof_1988: posts big blind $0.02
SametsPickUp leaves the table
*** HOLE CARDS ***
Dealt to the_wickstar [5d Jh]
Vit94nit: folds=20
Zybex696: folds=20
JekaPoyniak joins the table at seat #7=20
sekcboy: raises $0.04 to $0.06
the_wickstar: folds=20
Turbo777444: calls $0.06
Volk1001: folds=20
Kirhgof_1988: folds=20
*** FLOP *** [9d 8c 8s]
sekcboy: bets $0.05
Turbo777444: calls $0.05
*** TURN *** [9d 8c 8s] [Th]
sekcboy: bets $0.09
Turbo777444: calls $0.09
*** RIVER *** [9d 8c 8s Th] [6h]
sekcboy: bets $2.10 and is all-in
Turbo777444: calls $0.42 and is all-in
Uncalled bet ($1.68) returned to sekcboy
*** SHOW DOWN ***
sekcboy: shows [Qs Js] (a straight, Eight to Queen)
Turbo777444: shows [3s 9s] (two pair, Nines and Eights)
sekcboy collected $1.23 from pot
*** SUMMARY ***
Total pot $1.27 | Rake $0.04=20
Board [9d 8c 8s Th 6h]
Seat 1: Zybex696 folded before Flop (didn't bet)
Seat 2: sekcboy showed [Qs Js] and won ($1.23) with a straight, Eight t=
o Queen
Seat 4: the_wickstar folded before Flop (didn't bet)
Seat 5: Turbo777444 (button) showed [3s 9s] and lost with two pair, Nin=
es and Eights
Seat 6: Volk1001 (small blind) folded before Flop
Seat 8: Kirhgof_1988 (big blind) folded before Flop
Seat 9: Vit94nit folded before Flop (didn't bet)


*********** # 140 **************
PokerStars Hand #169800295521:  Hold'em No Limit ($0.01/$0.02 USD) - 20=
17/05/01 19:55:08 CUST [2017/05/01 5:55:08 ET]
Table 'Andraimon II' 9-max Seat #4 is the button
Seat 1: Zybex696 ($0.77 in chips)=20
Seat 2: sekcboy ($2.30 in chips)=20
Seat 4: the_wickstar ($0.68 in chips)=20
Seat 5: Turbo777444 ($0.63 in chips)=20
Seat 6: Volk1001 ($0.80 in chips)=20
Seat 7: SametsPickUp ($2.49 in chips)=20
Seat 8: Kirhgof_1988 ($2 in chips)=20
Seat 9: Vit94nit ($1.86 in chips)=20
Turbo777444: posts small blind $0.01
Volk1001: posts big blind $0.02
*** HOLE CARDS ***
Dealt to the_wickstar [2s Th]
SametsPickUp: folds=20
Kirhgof_1988: calls $0.02
Vit94nit: raises $0.08 to $0.10
Zybex696: folds=20
sekcboy: folds=20
the_wickstar: folds=20
Turbo777444: folds=20
Volk1001: folds=20
Kirhgof_1988: folds=20
Uncalled bet ($0.08) returned to Vit94nit
Vit94nit collected $0.07 from pot
Vit94nit: doesn't show hand=20
*** SUMMARY ***
Total pot $0.07 | Rake $0=20
Seat 1: Zybex696 folded before Flop (didn't bet)
Seat 2: sekcboy folded before Flop (didn't bet)
Seat 4: the_wickstar (button) folded before Flop (didn't bet)
Seat 5: Turbo777444 (small blind) folded before Flop
Seat 6: Volk1001 (big blind) folded before Flop
Seat 7: SametsPickUp folded before Flop (didn't bet)
Seat 8: Kirhgof_1988 folded before Flop
Seat 9: Vit94nit collected ($0.07)


*********** # 141 **************
PokerStars Hand #169800292273:  Hold'em No Limit ($0.01/$0.02 USD) - 20=
17/05/01 19:55:00 CUST [2017/05/01 5:55:00 ET]
Table 'Chandra' 9-max Seat #2 is the button
Seat 1: Ainur M ($1.61 in chips)=20
Seat 2: fomik33 ($2 in chips)=20
Seat 3: izy cykerman ($2.51 in chips)=20
Seat 4: And7888 ($1.31 in chips)=20
Seat 5: Sosiu82 ($0.55 in chips)=20
Seat 6: Assis2000 ($2.07 in chips)=20
Seat 7: Yafets ($1.34 in chips)=20
Seat 8: jays451 ($2.32 in chips)=20
Seat 9: the_wickstar ($0.89 in chips)=20
izy cykerman: posts small blind $0.01
And7888: posts big blind $0.02
*** HOLE CARDS ***
Dealt to the_wickstar [3s 3d]
Sosiu82: folds=20
Assis2000: folds=20
Yafets: folds=20
Yafets leaves the table
jays451: folds=20
the_wickstar: calls $0.02
JekaPoyniak joins the table at seat #7=20
Ainur M: folds=20
fomik33: raises $0.03 to $0.05
izy cykerman: folds=20
And7888: folds=20
the_wickstar: folds=20
Uncalled bet ($0.03) returned to fomik33
fomik33 collected $0.07 from pot
fomik33: doesn't show hand=20
*** SUMMARY ***
Total pot $0.07 | Rake $0=20
Seat 1: Ainur M folded before Flop (didn't bet)
Seat 2: fomik33 (button) collected ($0.07)
Seat 3: izy cykerman (small blind) folded before Flop
Seat 4: And7888 (big blind) folded before Flop
Seat 5: Sosiu82 folded before Flop (didn't bet)
Seat 6: Assis2000 folded before Flop (didn't bet)
Seat 7: Yafets folded before Flop (didn't bet)
Seat 8: jays451 folded before Flop (didn't bet)
Seat 9: the_wickstar folded before Flop


*********** # 142 **************
PokerStars Hand #169800278375:  Hold'em No Limit ($0.01/$0.02 USD) - 20=
17/05/01 19:54:27 CUST [2017/05/01 5:54:27 ET]
Table 'Andraimon II' 9-max Seat #2 is the button
Seat 1: Zybex696 ($0.77 in chips)=20
Seat 2: sekcboy ($2.22 in chips)=20
Seat 4: the_wickstar ($0.74 in chips)=20
Seat 5: Turbo777444 ($0.65 in chips)=20
Seat 7: SametsPickUp ($2.49 in chips)=20
Seat 8: Kirhgof_1988 ($2 in chips)=20
Seat 9: Vit94nit ($1.86 in chips)=20
the_wickstar: posts small blind $0.01
Turbo777444: posts big blind $0.02
Volk1001: sits out=20
*** HOLE CARDS ***
Dealt to the_wickstar [Ks Qd]
SametsPickUp: folds=20
Kirhgof_1988: folds=20
Vit94nit: folds=20
Zybex696: folds=20
sekcboy: raises $0.04 to $0.06
the_wickstar: calls $0.05
Turbo777444: folds=20
*** FLOP *** [2d 5h 3h]
the_wickstar: checks=20
sekcboy: bets $0.07
the_wickstar: folds=20
Uncalled bet ($0.07) returned to sekcboy
sekcboy collected $0.14 from pot
sekcboy: doesn't show hand=20
*** SUMMARY ***
Total pot $0.14 | Rake $0=20
Board [2d 5h 3h]
Seat 1: Zybex696 folded before Flop (didn't bet)
Seat 2: sekcboy (button) collected ($0.14)
Seat 4: the_wickstar (small blind) folded on the Flop
Seat 5: Turbo777444 (big blind) folded before Flop
Seat 7: SametsPickUp folded before Flop (didn't bet)
Seat 8: Kirhgof_1988 folded before Flop (didn't bet)
Seat 9: Vit94nit folded before Flop (didn't bet)


*********** # 143 **************
PokerStars Hand #169800258876:  Hold'em No Limit ($0.01/$0.02 USD) - 20=
17/05/01 19:53:40 CUST [2017/05/01 5:53:40 ET]
Table 'Chandra' 9-max Seat #1 is the button
Seat 1: Ainur M ($1.61 in chips)=20
Seat 2: fomik33 ($2 in chips)=20
Seat 3: izy cykerman ($2.53 in chips)=20
Seat 4: And7888 ($1.31 in chips)=20
Seat 5: Sosiu82 ($0.68 in chips)=20
Seat 6: Assis2000 ($2.07 in chips)=20
Seat 7: Yafets ($1.34 in chips)=20
Seat 8: jays451 ($2.32 in chips)=20
Seat 9: the_wickstar ($0.74 in chips)=20
fomik33: posts small blind $0.01
izy cykerman: posts big blind $0.02
*** HOLE CARDS ***
Dealt to the_wickstar [Ad Jh]
And7888 is connected=20
And7888: folds=20
Sosiu82: calls $0.02
Assis2000: folds=20
Yafets: folds=20
jays451: folds=20
the_wickstar: raises $0.04 to $0.06
Ainur M: folds=20
fomik33: folds=20
izy cykerman: folds=20
Sosiu82: calls $0.04
*** FLOP *** [2s Js Qc]
Sosiu82: checks=20
Ainur M is disconnected=20
the_wickstar: bets $0.07
Sosiu82: calls $0.07
*** TURN *** [2s Js Qc] [Jd]
Sosiu82: checks=20
the_wickstar: bets $0.20
Sosiu82: folds=20
Uncalled bet ($0.20) returned to the_wickstar
the_wickstar collected $0.28 from pot
*** SUMMARY ***
Total pot $0.29 | Rake $0.01=20
Board [2s Js Qc Jd]
Seat 1: Ainur M (button) folded before Flop (didn't bet)
Seat 2: fomik33 (small blind) folded before Flop
Seat 3: izy cykerman (big blind) folded before Flop
Seat 4: And7888 folded before Flop (didn't bet)
Seat 5: Sosiu82 folded on the Turn
Seat 6: Assis2000 folded before Flop (didn't bet)
Seat 7: Yafets folded before Flop (didn't bet)
Seat 8: jays451 folded before Flop (didn't bet)
Seat 9: the_wickstar collected ($0.28)


*********** # 144 **************
PokerStars Hand #169800237196:  Hold'em No Limit ($0.01/$0.02 USD) - 20=
17/05/01 19:52:46 CUST [2017/05/01 5:52:46 ET]
Table 'Chandra' 9-max Seat #9 is the button
Seat 1: Ainur M ($1.62 in chips)=20
Seat 2: fomik33 ($2.01 in chips)=20
Seat 3: izy cykerman ($2.53 in chips)=20
Seat 4: And7888 ($1.31 in chips)=20
Seat 5: Sosiu82 ($0.68 in chips)=20
Seat 6: Assis2000 ($2.07 in chips)=20
Seat 7: Yafets ($1.34 in chips)=20
Seat 8: jays451 ($2.32 in chips)=20
Seat 9: the_wickstar ($0.71 in chips)=20
Ainur M: posts small blind $0.01
fomik33: posts big blind $0.02
*** HOLE CARDS ***
Dealt to the_wickstar [Kh Ad]
izy cykerman: folds=20
And7888: folds=20
Sosiu82: folds=20
Assis2000: folds=20
Yafets: folds=20
jays451: folds=20
the_wickstar: raises $0.04 to $0.06
Ainur M: folds=20
fomik33: folds=20
Uncalled bet ($0.04) returned to the_wickstar
the_wickstar collected $0.05 from pot
*** SUMMARY ***
Total pot $0.05 | Rake $0=20
Seat 1: Ainur M (small blind) folded before Flop
Seat 2: fomik33 (big blind) folded before Flop
Seat 3: izy cykerman folded before Flop (didn't bet)
Seat 4: And7888 folded before Flop (didn't bet)
Seat 5: Sosiu82 folded before Flop (didn't bet)
Seat 6: Assis2000 folded before Flop (didn't bet)
Seat 7: Yafets folded before Flop (didn't bet)
Seat 8: jays451 folded before Flop (didn't bet)
Seat 9: the_wickstar (button) collected ($0.05)


*********** # 145 **************
PokerStars Hand #169800236695:  Hold'em No Limit ($0.01/$0.02 USD) - 20=
17/05/01 19:52:45 CUST [2017/05/01 5:52:45 ET]
Table 'Andraimon II' 9-max Seat #1 is the button
Seat 1: Zybex696 ($0.77 in chips)=20
Seat 2: sekcboy ($2.23 in chips)=20
Seat 3: 3AllBlack ($0.80 in chips)=20
Seat 4: the_wickstar ($0.74 in chips)=20
Seat 5: Turbo777444 ($0.75 in chips)=20
Seat 7: SametsPickUp ($2.37 in chips)=20
Seat 8: Kirhgof_1988 ($2 in chips)=20
Seat 9: Vit94nit ($1.86 in chips)=20
sekcboy: posts small blind $0.01
3AllBlack: posts big blind $0.02
*** HOLE CARDS ***
Dealt to the_wickstar [Ah 6s]
the_wickstar: folds=20
Volk1001 joins the table at seat #6=20
Turbo777444: calls $0.02
SametsPickUp: raises $0.08 to $0.10
Kirhgof_1988: folds=20
Vit94nit: folds=20
Zybex696: folds=20
sekcboy: folds=20
3AllBlack is disconnected=20
3AllBlack has timed out while disconnected
3AllBlack: folds=20
Turbo777444: calls $0.08
*** FLOP *** [Th 7s Qd]
Turbo777444: checks=20
SametsPickUp: bets $0.12
Turbo777444: folds=20
Uncalled bet ($0.12) returned to SametsPickUp
SametsPickUp collected $0.22 from pot
SametsPickUp: doesn't show hand=20
*** SUMMARY ***
Total pot $0.23 | Rake $0.01=20
Board [Th 7s Qd]
Seat 1: Zybex696 (button) folded before Flop (didn't bet)
Seat 2: sekcboy (small blind) folded before Flop
Seat 3: 3AllBlack (big blind) folded before Flop
Seat 4: the_wickstar folded before Flop (didn't bet)
Seat 5: Turbo777444 folded on the Flop
Seat 7: SametsPickUp collected ($0.22)
Seat 8: Kirhgof_1988 folded before Flop (didn't bet)
Seat 9: Vit94nit folded before Flop (didn't bet)


*********** # 146 **************
PokerStars Hand #169800211448:  Hold'em No Limit ($0.01/$0.02 USD) - 20=
17/05/01 19:51:43 CUST [2017/05/01 5:51:43 ET]
Table 'Chandra' 9-max Seat #8 is the button
Seat 1: Ainur M ($1.60 in chips)=20
Seat 2: fomik33 ($2.01 in chips)=20
Seat 3: izy cykerman ($2.53 in chips)=20
Seat 4: And7888 ($1.31 in chips)=20
Seat 5: Sosiu82 ($0.68 in chips)=20
Seat 6: Assis2000 ($2.07 in chips)=20
Seat 7: Yafets ($1.34 in chips)=20
Seat 8: jays451 ($2.32 in chips)=20
Seat 9: the_wickstar ($0.73 in chips)=20
the_wickstar: posts small blind $0.01
Ainur M: posts big blind $0.02
*** HOLE CARDS ***
Dealt to the_wickstar [As 4c]
fomik33 has timed out
fomik33: folds=20
izy cykerman: folds=20
And7888: folds=20
Sosiu82: folds=20
Assis2000: folds=20
Yafets: folds=20
jays451: folds=20
the_wickstar: calls $0.01
Ainur M: raises $0.06 to $0.08
the_wickstar: folds=20
Uncalled bet ($0.06) returned to Ainur M
Ainur M collected $0.04 from pot
*** SUMMARY ***
Total pot $0.04 | Rake $0=20
Seat 1: Ainur M (big blind) collected ($0.04)
Seat 2: fomik33 folded before Flop (didn't bet)
Seat 3: izy cykerman folded before Flop (didn't bet)
Seat 4: And7888 folded before Flop (didn't bet)
Seat 5: Sosiu82 folded before Flop (didn't bet)
Seat 6: Assis2000 folded before Flop (didn't bet)
Seat 7: Yafets folded before Flop (didn't bet)
Seat 8: jays451 (button) folded before Flop (didn't bet)
Seat 9: the_wickstar (small blind) folded before Flop


*********** # 147 **************
PokerStars Hand #169800208410:  Hold'em No Limit ($0.01/$0.02 USD) - 20=
17/05/01 19:51:36 CUST [2017/05/01 5:51:36 ET]
Table 'Andraimon II' 9-max Seat #9 is the button
Seat 1: Zybex696 ($0.78 in chips)=20
Seat 2: sekcboy ($2.05 in chips)=20
Seat 4: the_wickstar ($0.74 in chips)=20
Seat 5: Turbo777444 ($0.81 in chips)=20
Seat 7: SametsPickUp ($2.37 in chips)=20
Seat 8: Kirhgof_1988 ($2 in chips)=20
Seat 9: Vit94nit ($1.92 in chips)=20
Zybex696: posts small blind $0.01
sekcboy: posts big blind $0.02
3AllBlack is connected=20
3AllBlack: sits out=20
*** HOLE CARDS ***
Dealt to the_wickstar [5s 6h]
the_wickstar: folds=20
Turbo777444: calls $0.02
SametsPickUp: folds=20
Kirhgof_1988: calls $0.02
Vit94nit: raises $0.04 to $0.06
Zybex696: folds=20
sekcboy: calls $0.04
Turbo777444: calls $0.04
Kirhgof_1988: calls $0.04
*** FLOP *** [3s 8s 6c]
sekcboy: bets $0.18
Turbo777444: folds=20
Kirhgof_1988: folds=20
Vit94nit: folds=20
Uncalled bet ($0.18) returned to sekcboy
sekcboy collected $0.24 from pot
sekcboy: doesn't show hand=20
*** SUMMARY ***
Total pot $0.25 | Rake $0.01=20
Board [3s 8s 6c]
Seat 1: Zybex696 (small blind) folded before Flop
Seat 2: sekcboy (big blind) collected ($0.24)
Seat 4: the_wickstar folded before Flop (didn't bet)
Seat 5: Turbo777444 folded on the Flop
Seat 7: SametsPickUp folded before Flop (didn't bet)
Seat 8: Kirhgof_1988 folded on the Flop
Seat 9: Vit94nit (button) folded on the Flop


*********** # 148 **************
PokerStars Hand #169800179991:  Hold'em No Limit ($0.01/$0.02 USD) - 20=
17/05/01 19:50:27 CUST [2017/05/01 5:50:27 ET]
Table 'Chandra' 9-max Seat #7 is the button
Seat 2: fomik33 ($2.01 in chips)=20
Seat 3: izy cykerman ($2.53 in chips)=20
Seat 4: And7888 ($1.31 in chips)=20
Seat 5: Sosiu82 ($0.68 in chips)=20
Seat 6: Assis2000 ($1.95 in chips)=20
Seat 7: Yafets ($1.40 in chips)=20
Seat 8: jays451 ($2.33 in chips)=20
Seat 9: the_wickstar ($0.79 in chips)=20
jays451: posts small blind $0.01
the_wickstar: posts big blind $0.02
Ainur M: sits out=20
*** HOLE CARDS ***
Dealt to the_wickstar [Th Jc]
fomik33 has timed out while disconnected
fomik33: folds=20
izy cykerman: folds=20
And7888: folds=20
Sosiu82: folds=20
Assis2000: raises $0.04 to $0.06
Yafets: calls $0.06
jays451: folds=20
the_wickstar: calls $0.04
*** FLOP *** [Kc Ac 7c]
the_wickstar: checks=20
Assis2000: bets $0.20
Yafets: folds=20
the_wickstar: folds=20
Uncalled bet ($0.20) returned to Assis2000
Assis2000 collected $0.18 from pot
Assis2000: doesn't show hand=20
*** SUMMARY ***
Total pot $0.19 | Rake $0.01=20
Board [Kc Ac 7c]
Seat 2: fomik33 folded before Flop (didn't bet)
Seat 3: izy cykerman folded before Flop (didn't bet)
Seat 4: And7888 folded before Flop (didn't bet)
Seat 5: Sosiu82 folded before Flop (didn't bet)
Seat 6: Assis2000 collected ($0.18)
Seat 7: Yafets (button) folded on the Flop
Seat 8: jays451 (small blind) folded before Flop
Seat 9: the_wickstar (big blind) folded on the Flop


*********** # 149 **************
PokerStars Hand #169800168904:  Hold'em No Limit ($0.01/$0.02 USD) - 20=
17/05/01 19:49:59 CUST [2017/05/01 5:49:59 ET]
Table 'Andraimon II' 9-max Seat #8 is the button
Seat 1: Zybex696 ($0.84 in chips)=20
Seat 2: sekcboy ($2.05 in chips)=20
Seat 4: the_wickstar ($0.84 in chips)=20
Seat 5: Turbo777444 ($0.60 in chips)=20
Seat 7: SametsPickUp ($2.37 in chips)=20
Seat 8: Kirhgof_1988 ($2 in chips)=20
Seat 9: Vit94nit ($1.98 in chips)=20
Vit94nit: posts small blind $0.01
Zybex696: posts big blind $0.02
*** HOLE CARDS ***
Dealt to the_wickstar [Tc Td]
sekcboy: folds=20
the_wickstar: raises $0.04 to $0.06
Turbo777444: calls $0.06
SametsPickUp: folds=20
3AllBlack joins the table at seat #3=20
Kirhgof_1988: folds=20
Vit94nit: calls $0.05
Zybex696: calls $0.04
*** FLOP *** [2d As Qs]
Vit94nit: checks=20
Zybex696: checks=20
the_wickstar: checks=20
Turbo777444: bets $0.04
Vit94nit: folds=20
Zybex696: folds=20
the_wickstar: calls $0.04
*** TURN *** [2d As Qs] [4s]
3AllBlack is disconnected=20
the_wickstar: checks=20
Turbo777444: bets $0.10
the_wickstar: folds=20
Uncalled bet ($0.10) returned to Turbo777444
Turbo777444 collected $0.31 from pot
Turbo777444: doesn't show hand=20
*** SUMMARY ***
Total pot $0.32 | Rake $0.01=20
Board [2d As Qs 4s]
Seat 1: Zybex696 (big blind) folded on the Flop
Seat 2: sekcboy folded before Flop (didn't bet)
Seat 4: the_wickstar folded on the Turn
Seat 5: Turbo777444 collected ($0.31)
Seat 7: SametsPickUp folded before Flop (didn't bet)
Seat 8: Kirhgof_1988 (button) folded before Flop (didn't bet)
Seat 9: Vit94nit (small blind) folded on the Flop


*********** # 150 **************
PokerStars Hand #169800157787:  Hold'em No Limit ($0.01/$0.02 USD) - 20=
17/05/01 19:49:32 CUST [2017/05/01 5:49:32 ET]
Table 'Andraimon II' 9-max Seat #7 is the button
Seat 1: Zybex696 ($0.84 in chips)=20
Seat 2: sekcboy ($2.05 in chips)=20
Seat 4: the_wickstar ($0.84 in chips)=20
Seat 5: Turbo777444 ($0.60 in chips)=20
Seat 7: SametsPickUp ($2.37 in chips)=20
Seat 8: Kirhgof_1988 ($2 in chips)=20
Seat 9: Vit94nit ($1.97 in chips)=20
Kirhgof_1988: posts small blind $0.01
Vit94nit: posts big blind $0.02
*** HOLE CARDS ***
Dealt to the_wickstar [5s 6h]
Zybex696: folds=20
sekcboy: folds=20
the_wickstar: folds=20
Turbo777444: folds=20
SametsPickUp: folds=20
Kirhgof_1988: folds=20
Uncalled bet ($0.01) returned to Vit94nit
Vit94nit collected $0.02 from pot
Vit94nit: doesn't show hand=20
*** SUMMARY ***
Total pot $0.02 | Rake $0=20
Seat 1: Zybex696 folded before Flop (didn't bet)
Seat 2: sekcboy folded before Flop (didn't bet)
Seat 4: the_wickstar folded before Flop (didn't bet)
Seat 5: Turbo777444 folded before Flop (didn't bet)
Seat 7: SametsPickUp (button) folded before Flop (didn't bet)
Seat 8: Kirhgof_1988 (small blind) folded before Flop
Seat 9: Vit94nit (big blind) collected ($0.02)


*********** # 151 **************
PokerStars Hand #169800139583:  Hold'em No Limit ($0.01/$0.02 USD) - 20=
17/05/01 19:48:47 CUST [2017/05/01 5:48:47 ET]
Table 'Andraimon II' 9-max Seat #5 is the button
Seat 1: Zybex696 ($0.84 in chips)=20
Seat 2: sekcboy ($2.05 in chips)=20
Seat 4: the_wickstar ($0.84 in chips)=20
Seat 5: Turbo777444 ($0.60 in chips)=20
Seat 7: SametsPickUp ($2.41 in chips)=20
Seat 8: Kirhgof_1988 ($2 in chips)=20
Seat 9: Vit94nit ($1.91 in chips)=20
SametsPickUp: posts small blind $0.01
Kirhgof_1988: posts big blind $0.02
*** HOLE CARDS ***
Dealt to the_wickstar [5d 8d]
Vit94nit: raises $0.02 to $0.04
Zybex696: folds=20
sekcboy: folds=20
SOSSSSS leaves the table
the_wickstar: folds=20
Turbo777444: folds=20
SametsPickUp: calls $0.03
Kirhgof_1988: folds=20
*** FLOP *** [6d Qh 7h]
SametsPickUp: checks=20
Vit94nit: bets $0.04
SametsPickUp: folds=20
Uncalled bet ($0.04) returned to Vit94nit
Vit94nit collected $0.10 from pot
Vit94nit: doesn't show hand=20
*** SUMMARY ***
Total pot $0.10 | Rake $0=20
Board [6d Qh 7h]
Seat 1: Zybex696 folded before Flop (didn't bet)
Seat 2: sekcboy folded before Flop (didn't bet)
Seat 4: the_wickstar folded before Flop (didn't bet)
Seat 5: Turbo777444 (button) folded before Flop (didn't bet)
Seat 7: SametsPickUp (small blind) folded on the Flop
Seat 8: Kirhgof_1988 (big blind) folded before Flop
Seat 9: Vit94nit collected ($0.10)


*********** # 152 **************
PokerStars Hand #169800137222:  Hold'em No Limit ($0.01/$0.02 USD) - 20=
17/05/01 19:48:41 CUST [2017/05/01 5:48:41 ET]
Table 'Chandra' 9-max Seat #6 is the button
Seat 2: fomik33 ($2.01 in chips)=20
Seat 3: izy cykerman ($2.53 in chips)=20
Seat 4: And7888 ($1.31 in chips)=20
Seat 5: Sosiu82 ($0.68 in chips)=20
Seat 6: Assis2000 ($1.97 in chips)=20
Seat 7: Yafets ($1.41 in chips)=20
Seat 8: jays451 ($2.28 in chips)=20
Seat 9: the_wickstar ($0.81 in chips)=20
Yafets: posts small blind $0.01
jays451: posts big blind $0.02
*** HOLE CARDS ***
Dealt to the_wickstar [Qs Jd]
the_wickstar: calls $0.02
fomik33: folds=20
izy cykerman: folds=20
SOSSSSS leaves the table
And7888: folds=20
Sosiu82: folds=20
Assis2000: calls $0.02
Yafets: folds=20
jays451: checks=20
*** FLOP *** [5h Ad 9s]
jays451: checks=20
the_wickstar: checks=20
Ainur M joins the table at seat #1=20
Assis2000: checks=20
*** TURN *** [5h Ad 9s] [7c]
And7888 is disconnected=20
jays451: checks=20
the_wickstar: checks=20
Assis2000: checks=20
*** RIVER *** [5h Ad 9s 7c] [3h]
jays451: checks=20
the_wickstar: checks=20
Assis2000: checks=20
*** SHOW DOWN ***
jays451: shows [2s 2d] (a pair of Deuces)
the_wickstar: mucks hand=20
Assis2000: mucks hand=20
jays451 collected $0.07 from pot
fomik33 is disconnected=20
*** SUMMARY ***
Total pot $0.07 | Rake $0=20
Board [5h Ad 9s 7c 3h]
Seat 2: fomik33 folded before Flop (didn't bet)
Seat 3: izy cykerman folded before Flop (didn't bet)
Seat 4: And7888 folded before Flop (didn't bet)
Seat 5: Sosiu82 folded before Flop (didn't bet)
Seat 6: Assis2000 (button) mucked [Qc Jc]
Seat 7: Yafets (small blind) folded before Flop
Seat 8: jays451 (big blind) showed [2s 2d] and won ($0.07) with a pair =
of Deuces
Seat 9: the_wickstar mucked [Qs Jd]


*********** # 153 **************
PokerStars Hand #169800119917:  Hold'em No Limit ($0.01/$0.02 USD) - 20=
17/05/01 19:47:59 CUST [2017/05/01 5:47:59 ET]
Table 'Andraimon II' 9-max Seat #4 is the button
Seat 1: Zybex696 ($0.84 in chips)=20
Seat 2: sekcboy ($2.05 in chips)=20
Seat 3: ChkRaizDaBTN ($2.18 in chips)=20
Seat 4: the_wickstar ($0.84 in chips)=20
Seat 5: Turbo777444 ($0.58 in chips)=20
Seat 6: SOSSSSS ($2 in chips)=20
Seat 7: SametsPickUp ($2.41 in chips)=20
Seat 8: Kirhgof_1988 ($2 in chips)=20
Seat 9: Vit94nit ($1.91 in chips)=20
Turbo777444: posts small blind $0.01
SOSSSSS: posts big blind $0.02
*** HOLE CARDS ***
Dealt to the_wickstar [3d 8d]
SametsPickUp: folds=20
Kirhgof_1988: folds=20
Vit94nit: folds=20
Zybex696: folds=20
sekcboy: folds=20
ChkRaizDaBTN: folds=20
ChkRaizDaBTN leaves the table
the_wickstar: folds=20
Turbo777444: calls $0.01
SOSSSSS: checks=20
*** FLOP *** [Ts As Kh]
Turbo777444: checks=20
SOSSSSS: checks=20
*** TURN *** [Ts As Kh] [Qc]
Turbo777444: bets $0.02
SOSSSSS: folds=20
Uncalled bet ($0.02) returned to Turbo777444
Turbo777444 collected $0.04 from pot
Turbo777444: doesn't show hand=20
*** SUMMARY ***
Total pot $0.04 | Rake $0=20
Board [Ts As Kh Qc]
Seat 1: Zybex696 folded before Flop (didn't bet)
Seat 2: sekcboy folded before Flop (didn't bet)
Seat 3: ChkRaizDaBTN folded before Flop (didn't bet)
Seat 4: the_wickstar (button) folded before Flop (didn't bet)
Seat 5: Turbo777444 (small blind) collected ($0.04)
Seat 6: SOSSSSS (big blind) folded on the Turn
Seat 7: SametsPickUp folded before Flop (didn't bet)
Seat 8: Kirhgof_1988 folded before Flop (didn't bet)
Seat 9: Vit94nit folded before Flop (didn't bet)


*********** # 154 **************
PokerStars Hand #169800109479:  Hold'em No Limit ($0.01/$0.02 USD) - 20=
17/05/01 19:47:34 CUST [2017/05/01 5:47:34 ET]
Table 'Chandra' 9-max Seat #5 is the button
Seat 1: SOSSSSS ($2 in chips)=20
Seat 2: fomik33 ($2.01 in chips)=20
Seat 3: izy cykerman ($2.53 in chips)=20
Seat 4: And7888 ($1.31 in chips)=20
Seat 5: Sosiu82 ($0.68 in chips)=20
Seat 6: Assis2000 ($1.98 in chips)=20
Seat 7: Yafets ($1.43 in chips)=20
Seat 8: jays451 ($2.28 in chips)=20
Seat 9: the_wickstar ($0.61 in chips)=20
Assis2000: posts small blind $0.01
Yafets: posts big blind $0.02
*** HOLE CARDS ***
Dealt to the_wickstar [Qd As]
jays451: folds=20
the_wickstar: calls $0.02
SOSSSSS: raises $0.06 to $0.08
fomik33: folds=20
izy cykerman: folds=20
And7888: folds=20
Sosiu82: folds=20
Assis2000: folds=20
Yafets: folds=20
the_wickstar: calls $0.06
*** FLOP *** [3h 7c Ts]
the_wickstar: checks=20
SOSSSSS: checks=20
*** TURN *** [3h 7c Ts] [9s]
the_wickstar: bets $0.10
SOSSSSS: calls $0.10
*** RIVER *** [3h 7c Ts 9s] [2c]
the_wickstar: checks=20
SOSSSSS: checks=20
*** SHOW DOWN ***
the_wickstar: shows [Qd As] (high card Ace)
SOSSSSS: mucks hand=20
the_wickstar collected $0.38 from pot
*** SUMMARY ***
Total pot $0.39 | Rake $0.01=20
Board [3h 7c Ts 9s 2c]
Seat 1: SOSSSSS mucked [Kd Js]
Seat 2: fomik33 folded before Flop (didn't bet)
Seat 3: izy cykerman folded before Flop (didn't bet)
Seat 4: And7888 folded before Flop (didn't bet)
Seat 5: Sosiu82 (button) folded before Flop (didn't bet)
Seat 6: Assis2000 (small blind) folded before Flop
Seat 7: Yafets (big blind) folded before Flop
Seat 8: jays451 folded before Flop (didn't bet)
Seat 9: the_wickstar showed [Qd As] and won ($0.38) with high card Ace


*********** # 155 **************
PokerStars Hand #169800102093:  Hold'em No Limit ($0.01/$0.02 USD) - 20=
17/05/01 19:47:16 CUST [2017/05/01 5:47:16 ET]
Table 'Andraimon II' 9-max Seat #3 is the button
Seat 1: Zybex696 ($0.77 in chips)=20
Seat 2: sekcboy ($2.05 in chips)=20
Seat 3: ChkRaizDaBTN ($2.18 in chips)=20
Seat 4: the_wickstar ($0.85 in chips)=20
Seat 5: Turbo777444 ($0.64 in chips)=20
Seat 6: SOSSSSS ($2 in chips)=20
Seat 7: SametsPickUp ($2.41 in chips)=20
Seat 8: Kirhgof_1988 ($2 in chips)=20
Seat 9: Vit94nit ($1.91 in chips)=20
the_wickstar: posts small blind $0.01
Turbo777444: posts big blind $0.02
*** HOLE CARDS ***
Dealt to the_wickstar [Jc 2c]
SOSSSSS: folds=20
SametsPickUp: folds=20
Kirhgof_1988: folds=20
Vit94nit: folds=20
Zybex696: raises $0.04 to $0.06
sekcboy: folds=20
ChkRaizDaBTN: folds=20
the_wickstar: folds=20
Turbo777444: calls $0.04
*** FLOP *** [Kh 4h Tc]
Turbo777444: checks=20
Zybex696: bets $0.10
Turbo777444: folds=20
Uncalled bet ($0.10) returned to Zybex696
Zybex696 collected $0.13 from pot
Zybex696: doesn't show hand=20
*** SUMMARY ***
Total pot $0.13 | Rake $0=20
Board [Kh 4h Tc]
Seat 1: Zybex696 collected ($0.13)
Seat 2: sekcboy folded before Flop (didn't bet)
Seat 3: ChkRaizDaBTN (button) folded before Flop (didn't bet)
Seat 4: the_wickstar (small blind) folded before Flop
Seat 5: Turbo777444 (big blind) folded on the Flop
Seat 6: SOSSSSS folded before Flop (didn't bet)
Seat 7: SametsPickUp folded before Flop (didn't bet)
Seat 8: Kirhgof_1988 folded before Flop (didn't bet)
Seat 9: Vit94nit folded before Flop (didn't bet)


*********** # 156 **************
PokerStars Hand #169800086327:  Hold'em No Limit ($0.01/$0.02 USD) - 20=
17/05/01 19:46:37 CUST [2017/05/01 5:46:37 ET]
Table 'Chandra' 9-max Seat #4 is the button
Seat 1: SOSSSSS ($2 in chips)=20
Seat 2: fomik33 ($2.01 in chips)=20
Seat 3: izy cykerman ($2.53 in chips)=20
Seat 4: And7888 ($1.31 in chips)=20
Seat 5: Sosiu82 ($0.74 in chips)=20
Seat 6: Assis2000 ($2 in chips)=20
Seat 7: Yafets ($1.43 in chips)=20
Seat 8: jays451 ($2.20 in chips)=20
Seat 9: the_wickstar ($0.61 in chips)=20
Sosiu82: posts small blind $0.01
Assis2000: posts big blind $0.02
*** HOLE CARDS ***
Dealt to the_wickstar [Kc 8s]
Yafets: folds=20
jays451: raises $0.04 to $0.06
the_wickstar: folds=20
SOSSSSS: folds=20
fomik33: folds=20
izy cykerman: folds=20
And7888: folds=20
Sosiu82: calls $0.05
Assis2000: folds=20
*** FLOP *** [Js 2s 9c]
Sosiu82: checks=20
jays451: bets $0.10
Sosiu82: folds=20
Uncalled bet ($0.10) returned to jays451
jays451 collected $0.14 from pot
jays451: doesn't show hand=20
*** SUMMARY ***
Total pot $0.14 | Rake $0=20
Board [Js 2s 9c]
Seat 1: SOSSSSS folded before Flop (didn't bet)
Seat 2: fomik33 folded before Flop (didn't bet)
Seat 3: izy cykerman folded before Flop (didn't bet)
Seat 4: And7888 (button) folded before Flop (didn't bet)
Seat 5: Sosiu82 (small blind) folded on the Flop
Seat 6: Assis2000 (big blind) folded before Flop
Seat 7: Yafets folded before Flop (didn't bet)
Seat 8: jays451 collected ($0.14)
Seat 9: the_wickstar folded before Flop (didn't bet)


*********** # 157 **************
PokerStars Hand #169800074392:  Hold'em No Limit ($0.01/$0.02 USD) - 20=
17/05/01 19:46:08 CUST [2017/05/01 5:46:08 ET]
Table 'Andraimon II' 9-max Seat #2 is the button
Seat 1: Zybex696 ($0.77 in chips)=20
Seat 2: sekcboy ($2.05 in chips)=20
Seat 3: ChkRaizDaBTN ($2.16 in chips)=20
Seat 4: the_wickstar ($0.87 in chips)=20
Seat 5: Turbo777444 ($0.64 in chips)=20
Seat 6: SOSSSSS ($2 in chips)=20
Seat 7: SametsPickUp ($2.41 in chips)=20
Seat 8: Kirhgof_1988 ($2 in chips)=20
Seat 9: Vit94nit ($1.91 in chips)=20
ChkRaizDaBTN: posts small blind $0.01
the_wickstar: posts big blind $0.02
*** HOLE CARDS ***
Dealt to the_wickstar [Td Qh]
Turbo777444: folds=20
SOSSSSS: folds=20
SametsPickUp: folds=20
Kirhgof_1988: folds=20
Vit94nit: folds=20
Zybex696 has timed out
Zybex696: folds=20
sekcboy: folds=20
ChkRaizDaBTN: raises $0.04 to $0.06
the_wickstar: folds=20
Uncalled bet ($0.04) returned to ChkRaizDaBTN
ChkRaizDaBTN collected $0.04 from pot
*** SUMMARY ***
Total pot $0.04 | Rake $0=20
Seat 1: Zybex696 folded before Flop (didn't bet)
Seat 2: sekcboy (button) folded before Flop (didn't bet)
Seat 3: ChkRaizDaBTN (small blind) collected ($0.04)
Seat 4: the_wickstar (big blind) folded before Flop
Seat 5: Turbo777444 folded before Flop (didn't bet)
Seat 6: SOSSSSS folded before Flop (didn't bet)
Seat 7: SametsPickUp folded before Flop (didn't bet)
Seat 8: Kirhgof_1988 folded before Flop (didn't bet)
Seat 9: Vit94nit folded before Flop (didn't bet)


*********** # 158 **************
PokerStars Hand #169800063735:  Hold'em No Limit ($0.01/$0.02 USD) - 20=
17/05/01 19:45:43 CUST [2017/05/01 5:45:43 ET]
Table 'Andraimon II' 9-max Seat #1 is the button
Seat 1: Zybex696 ($0.77 in chips)=20
Seat 2: sekcboy ($2.06 in chips)=20
Seat 3: ChkRaizDaBTN ($2.18 in chips)=20
Seat 4: the_wickstar ($0.87 in chips)=20
Seat 5: Turbo777444 ($0.61 in chips)=20
Seat 6: SOSSSSS ($2 in chips)=20
Seat 7: SametsPickUp ($2.41 in chips)=20
Seat 8: Kirhgof_1988 ($2 in chips)=20
Seat 9: Vit94nit ($1.91 in chips)=20
sekcboy: posts small blind $0.01
ChkRaizDaBTN: posts big blind $0.02
*** HOLE CARDS ***
Dealt to the_wickstar [7c 9d]
the_wickstar: folds=20
Turbo777444: raises $0.02 to $0.04
SOSSSSS: folds=20
SametsPickUp: folds=20
Kirhgof_1988: folds=20
Vit94nit: folds=20
Zybex696: folds=20
sekcboy: folds=20
ChkRaizDaBTN: folds=20
Uncalled bet ($0.02) returned to Turbo777444
Turbo777444 collected $0.05 from pot
Turbo777444: doesn't show hand=20
*** SUMMARY ***
Total pot $0.05 | Rake $0=20
Seat 1: Zybex696 (button) folded before Flop (didn't bet)
Seat 2: sekcboy (small blind) folded before Flop
Seat 3: ChkRaizDaBTN (big blind) folded before Flop
Seat 4: the_wickstar folded before Flop (didn't bet)
Seat 5: Turbo777444 collected ($0.05)
Seat 6: SOSSSSS folded before Flop (didn't bet)
Seat 7: SametsPickUp folded before Flop (didn't bet)
Seat 8: Kirhgof_1988 folded before Flop (didn't bet)
Seat 9: Vit94nit folded before Flop (didn't bet)


*********** # 159 **************
PokerStars Hand #169800062245:  Hold'em No Limit ($0.01/$0.02 USD) - 20=
17/05/01 19:45:39 CUST [2017/05/01 5:45:39 ET]
Table 'Chandra' 9-max Seat #3 is the button
Seat 1: SOSSSSS ($2 in chips)=20
Seat 2: fomik33 ($2.01 in chips)=20
Seat 3: izy cykerman ($2.53 in chips)=20
Seat 4: And7888 ($1.25 in chips)=20
Seat 5: Sosiu82 ($0.80 in chips)=20
Seat 7: Yafets ($1.43 in chips)=20
Seat 8: jays451 ($2.20 in chips)=20
Seat 9: the_wickstar ($0.61 in chips)=20
And7888: posts small blind $0.01
Sosiu82: posts big blind $0.02
Assis2000: sits out=20
*** HOLE CARDS ***
Dealt to the_wickstar [Qd 9c]
Yafets: folds=20
jays451: folds=20
the_wickstar: folds=20
SOSSSSS: folds=20
fomik33: folds=20
izy cykerman: folds=20
And7888: raises $0.04 to $0.06
Sosiu82: calls $0.04
*** FLOP *** [Jd 9d 2d]
And7888: bets $0.12
Sosiu82: folds=20
Uncalled bet ($0.12) returned to And7888
And7888 collected $0.12 from pot
And7888: doesn't show hand=20
*** SUMMARY ***
Total pot $0.12 | Rake $0=20
Board [Jd 9d 2d]
Seat 1: SOSSSSS folded before Flop (didn't bet)
Seat 2: fomik33 folded before Flop (didn't bet)
Seat 3: izy cykerman (button) folded before Flop (didn't bet)
Seat 4: And7888 (small blind) collected ($0.12)
Seat 5: Sosiu82 (big blind) folded on the Flop
Seat 7: Yafets folded before Flop (didn't bet)
Seat 8: jays451 folded before Flop (didn't bet)
Seat 9: the_wickstar folded before Flop (didn't bet)


*********** # 160 **************
PokerStars Hand #169800048341:  Hold'em No Limit ($0.01/$0.02 USD) - 20=
17/05/01 19:45:05 CUST [2017/05/01 5:45:05 ET]
Table 'Andraimon II' 9-max Seat #9 is the button
Seat 1: Zybex696 ($0.78 in chips)=20
Seat 2: sekcboy ($1.99 in chips)=20
Seat 3: ChkRaizDaBTN ($2.18 in chips)=20
Seat 4: the_wickstar ($0.87 in chips)=20
Seat 5: Turbo777444 ($0.61 in chips)=20
Seat 6: SOSSSSS ($2 in chips)=20
Seat 7: SametsPickUp ($2.47 in chips)=20
Seat 8: Kirhgof_1988 ($2 in chips)=20
Seat 9: Vit94nit ($1.91 in chips)=20
Zybex696: posts small blind $0.01
sekcboy: posts big blind $0.02
*** HOLE CARDS ***
Dealt to the_wickstar [8h 4h]
ChkRaizDaBTN: folds=20
the_wickstar: folds=20
Turbo777444: folds=20
SOSSSSS: folds=20
SametsPickUp: raises $0.04 to $0.06
Kirhgof_1988: folds=20
Vit94nit: folds=20
Zybex696: folds=20
sekcboy: calls $0.04
*** FLOP *** [7c 7h 9c]
sekcboy: checks=20
SametsPickUp: checks=20
*** TURN *** [7c 7h 9c] [Js]
sekcboy: bets $0.06
SametsPickUp: folds=20
Uncalled bet ($0.06) returned to sekcboy
sekcboy collected $0.13 from pot
sekcboy: doesn't show hand=20
*** SUMMARY ***
Total pot $0.13 | Rake $0=20
Board [7c 7h 9c Js]
Seat 1: Zybex696 (small blind) folded before Flop
Seat 2: sekcboy (big blind) collected ($0.13)
Seat 3: ChkRaizDaBTN folded before Flop (didn't bet)
Seat 4: the_wickstar folded before Flop (didn't bet)
Seat 5: Turbo777444 folded before Flop (didn't bet)
Seat 6: SOSSSSS folded before Flop (didn't bet)
Seat 7: SametsPickUp folded on the Turn
Seat 8: Kirhgof_1988 folded before Flop (didn't bet)
Seat 9: Vit94nit (button) folded before Flop (didn't bet)


*********** # 161 **************
PokerStars Hand #169800016508:  Hold'em No Limit ($0.01/$0.02 USD) - 20=
17/05/01 19:43:48 CUST [2017/05/01 5:43:48 ET]
Table 'Andraimon II' 9-max Seat #8 is the button
Seat 1: Zybex696 ($0.80 in chips)=20
Seat 2: sekcboy ($1.99 in chips)=20
Seat 3: ChkRaizDaBTN ($2.18 in chips)=20
Seat 4: the_wickstar ($0.87 in chips)=20
Seat 5: Turbo777444 ($0.73 in chips)=20
Seat 6: SOSSSSS ($2 in chips)=20
Seat 7: SametsPickUp ($2.21 in chips)=20
Seat 8: Kirhgof_1988 ($2 in chips)=20
Seat 9: Vit94nit ($1.92 in chips)=20
Vit94nit: posts small blind $0.01
Zybex696: posts big blind $0.02
*** HOLE CARDS ***
Dealt to the_wickstar [8c 3h]
sekcboy: folds=20
ChkRaizDaBTN: folds=20
the_wickstar: folds=20
Turbo777444: calls $0.02
SOSSSSS: folds=20
SametsPickUp: raises $0.10 to $0.12
Kirhgof_1988: calls $0.12
Vit94nit: folds=20
Zybex696: folds=20
Turbo777444: calls $0.10
*** FLOP *** [2d Td 7h]
Turbo777444: checks=20
SametsPickUp: checks=20
Kirhgof_1988: checks=20
*** TURN *** [2d Td 7h] [Qh]
Turbo777444: checks=20
SametsPickUp: checks=20
Kirhgof_1988: checks=20
*** RIVER *** [2d Td 7h Qh] [Jd]
Turbo777444: checks=20
SametsPickUp: bets $0.18
Kirhgof_1988: folds=20
Turbo777444: folds=20
Uncalled bet ($0.18) returned to SametsPickUp
SametsPickUp collected $0.38 from pot
SametsPickUp: doesn't show hand=20
*** SUMMARY ***
Total pot $0.39 | Rake $0.01=20
Board [2d Td 7h Qh Jd]
Seat 1: Zybex696 (big blind) folded before Flop
Seat 2: sekcboy folded before Flop (didn't bet)
Seat 3: ChkRaizDaBTN folded before Flop (didn't bet)
Seat 4: the_wickstar folded before Flop (didn't bet)
Seat 5: Turbo777444 folded on the River
Seat 6: SOSSSSS folded before Flop (didn't bet)
Seat 7: SametsPickUp collected ($0.38)
Seat 8: Kirhgof_1988 (button) folded on the River
Seat 9: Vit94nit (small blind) folded before Flop


*********** # 162 **************
PokerStars Hand #169800014851:  Hold'em No Limit ($0.01/$0.02 USD) - 20=
17/05/01 19:43:44 CUST [2017/05/01 5:43:44 ET]
Table 'Chandra' 9-max Seat #2 is the button
Seat 1: SOSSSSS ($2 in chips)=20
Seat 2: fomik33 ($2.01 in chips)=20
Seat 3: izy cykerman ($2.54 in chips)=20
Seat 4: And7888 ($1.35 in chips)=20
Seat 6: mkzoo ($1.97 in chips)=20
Seat 7: Yafets ($1.53 in chips)=20
Seat 8: jays451 ($2 in chips)=20
Seat 9: the_wickstar ($0.61 in chips)=20
izy cykerman: posts small blind $0.01
And7888: posts big blind $0.02
Sosiu82: sits out=20
*** HOLE CARDS ***
Dealt to the_wickstar [2s 7h]
mkzoo: folds=20
Yafets: calls $0.02
mkzoo leaves the table
jays451: calls $0.02
the_wickstar: folds=20
Assis2000 joins the table at seat #6=20
SOSSSSS: folds=20
fomik33: folds=20
izy cykerman: folds=20
And7888: checks=20
*** FLOP *** [9d 8d Js]
And7888: checks=20
Yafets: bets $0.04
jays451: calls $0.04
And7888: calls $0.04
*** TURN *** [9d 8d Js] [5h]
And7888: checks=20
Yafets: bets $0.04
jays451: calls $0.04
And7888 is connected=20
And7888: calls $0.04
*** RIVER *** [9d 8d Js 5h] [6d]
And7888: checks=20
Yafets: checks=20
jays451: checks=20
*** SHOW DOWN ***
And7888: shows [5c Tc] (a pair of Fives)
Yafets: shows [Ac 8c] (a pair of Eights)
jays451: shows [Jc Qh] (a pair of Jacks)
jays451 collected $0.30 from pot
*** SUMMARY ***
Total pot $0.31 | Rake $0.01=20
Board [9d 8d Js 5h 6d]
Seat 1: SOSSSSS folded before Flop (didn't bet)
Seat 2: fomik33 (button) folded before Flop (didn't bet)
Seat 3: izy cykerman (small blind) folded before Flop
Seat 4: And7888 (big blind) showed [5c Tc] and lost with a pair of Fives
Seat 6: mkzoo folded before Flop (didn't bet)
Seat 7: Yafets showed [Ac 8c] and lost with a pair of Eights
Seat 8: jays451 showed [Jc Qh] and won ($0.30) with a pair of Jacks
Seat 9: the_wickstar folded before Flop (didn't bet)


*********** # 163 **************
PokerStars Hand #169800006929:  Hold'em No Limit ($0.01/$0.02 USD) - 20=
17/05/01 19:43:25 CUST [2017/05/01 5:43:25 ET]
Table 'Andraimon II' 9-max Seat #7 is the button
Seat 2: sekcboy ($1.96 in chips)=20
Seat 3: ChkRaizDaBTN ($2.18 in chips)=20
Seat 4: the_wickstar ($0.87 in chips)=20
Seat 5: Turbo777444 ($0.73 in chips)=20
Seat 6: SOSSSSS ($2 in chips)=20
Seat 7: SametsPickUp ($2.21 in chips)=20
Seat 8: Kirhgof_1988 ($2 in chips)=20
Seat 9: Vit94nit ($1.94 in chips)=20
Kirhgof_1988: posts small blind $0.01
Vit94nit: posts big blind $0.02
Zybex696: sits out=20
*** HOLE CARDS ***
Dealt to the_wickstar [8c Kc]
sekcboy: raises $0.04 to $0.06
ChkRaizDaBTN: folds=20
the_wickstar: folds=20
Turbo777444: folds=20
SOSSSSS: folds=20
SametsPickUp: folds=20
Kirhgof_1988: folds=20
Vit94nit: folds=20
Uncalled bet ($0.04) returned to sekcboy
sekcboy collected $0.05 from pot
*** SUMMARY ***
Total pot $0.05 | Rake $0=20
Seat 2: sekcboy collected ($0.05)
Seat 3: ChkRaizDaBTN folded before Flop (didn't bet)
Seat 4: the_wickstar folded before Flop (didn't bet)
Seat 5: Turbo777444 folded before Flop (didn't bet)
Seat 6: SOSSSSS folded before Flop (didn't bet)
Seat 7: SametsPickUp (button) folded before Flop (didn't bet)
Seat 8: Kirhgof_1988 (small blind) folded before Flop
Seat 9: Vit94nit (big blind) folded before Flop


*********** # 164 **************
PokerStars Hand #169799994915:  Hold'em No Limit ($0.01/$0.02 USD) - 20=
17/05/01 19:42:55 CUST [2017/05/01 5:42:55 ET]
Table 'Andraimon II' 9-max Seat #6 is the button
Seat 2: sekcboy ($2.02 in chips)=20
Seat 3: ChkRaizDaBTN ($2.18 in chips)=20
Seat 4: the_wickstar ($0.87 in chips)=20
Seat 5: Turbo777444 ($0.73 in chips)=20
Seat 6: SOSSSSS ($2 in chips)=20
Seat 7: SametsPickUp ($2.13 in chips)=20
Seat 8: Kirhgof_1988 ($2 in chips)=20
Seat 9: Vit94nit ($1.94 in chips)=20
SametsPickUp: posts small blind $0.01
Kirhgof_1988: posts big blind $0.02
Zybex696: sits out=20
*** HOLE CARDS ***
Dealt to the_wickstar [Jd 4s]
Vit94nit: folds=20
sekcboy: raises $0.04 to $0.06
ChkRaizDaBTN: folds=20
the_wickstar: folds=20
Turbo777444: folds=20
SOSSSSS: folds=20
SametsPickUp: raises $0.14 to $0.20
Kirhgof_1988: folds=20
sekcboy: folds=20
Uncalled bet ($0.14) returned to SametsPickUp
SametsPickUp collected $0.14 from pot
SametsPickUp: doesn't show hand=20
*** SUMMARY ***
Total pot $0.14 | Rake $0=20
Seat 2: sekcboy folded before Flop
Seat 3: ChkRaizDaBTN folded before Flop (didn't bet)
Seat 4: the_wickstar folded before Flop (didn't bet)
Seat 5: Turbo777444 folded before Flop (didn't bet)
Seat 6: SOSSSSS (button) folded before Flop (didn't bet)
Seat 7: SametsPickUp (small blind) collected ($0.14)
Seat 8: Kirhgof_1988 (big blind) folded before Flop
Seat 9: Vit94nit folded before Flop (didn't bet)


*********** # 165 **************
PokerStars Hand #169799991614:  Hold'em No Limit ($0.01/$0.02 USD) - 20=
17/05/01 19:42:48 CUST [2017/05/01 5:42:48 ET]
Table 'Chandra' 9-max Seat #1 is the button
Seat 1: SOSSSSS ($2 in chips)=20
Seat 2: fomik33 ($2.03 in chips)=20
Seat 3: izy cykerman ($2.56 in chips)=20
Seat 4: And7888 ($1.35 in chips)=20
Seat 5: hardcoreMD ($2.26 in chips)=20
Seat 6: mkzoo ($1.97 in chips)=20
Seat 7: Yafets ($1.49 in chips)=20
Seat 8: jays451 ($2 in chips)=20
Seat 9: the_wickstar ($0.61 in chips)=20
fomik33: posts small blind $0.01
izy cykerman: posts big blind $0.02
*** HOLE CARDS ***
Dealt to the_wickstar [3c Ah]
And7888: folds=20
hardcoreMD: folds=20
hardcoreMD leaves the table
mkzoo: folds=20
Sosiu82 joins the table at seat #5=20
Yafets: calls $0.02
jays451: folds=20
the_wickstar: folds=20
SOSSSSS: folds=20
fomik33: calls $0.01
izy cykerman: checks=20
*** FLOP *** [As Jd 2c]
fomik33: checks=20
izy cykerman: checks=20
Yafets: bets $0.06
fomik33: folds=20
izy cykerman: folds=20
Uncalled bet ($0.06) returned to Yafets
Yafets collected $0.06 from pot
Yafets: doesn't show hand=20
*** SUMMARY ***
Total pot $0.06 | Rake $0=20
Board [As Jd 2c]
Seat 1: SOSSSSS (button) folded before Flop (didn't bet)
Seat 2: fomik33 (small blind) folded on the Flop
Seat 3: izy cykerman (big blind) folded on the Flop
Seat 4: And7888 folded before Flop (didn't bet)
Seat 5: hardcoreMD folded before Flop (didn't bet)
Seat 6: mkzoo folded before Flop (didn't bet)
Seat 7: Yafets collected ($0.06)
Seat 8: jays451 folded before Flop (didn't bet)
Seat 9: the_wickstar folded before Flop (didn't bet)


*********** # 166 **************
PokerStars Hand #169799961584:  Hold'em No Limit ($0.01/$0.02 USD) - 20=
17/05/01 19:41:34 CUST [2017/05/01 5:41:34 ET]
Table 'Andraimon II' 9-max Seat #5 is the button
Seat 2: sekcboy ($2.02 in chips)=20
Seat 3: ChkRaizDaBTN ($2.18 in chips)=20
Seat 4: the_wickstar ($0.70 in chips)=20
Seat 5: Turbo777444 ($0.79 in chips)=20
Seat 6: SOSSSSS ($2.04 in chips)=20
Seat 7: SametsPickUp ($2.19 in chips)=20
Seat 8: Kirhgof_1988 ($2 in chips)=20
Seat 9: Vit94nit ($1.94 in chips)=20
SOSSSSS: posts small blind $0.01
SametsPickUp: posts big blind $0.02
*** HOLE CARDS ***
Dealt to the_wickstar [Kc Ah]
Kirhgof_1988: folds=20
Vit94nit: folds=20
sekcboy: folds=20
ChkRaizDaBTN: folds=20
the_wickstar: raises $0.04 to $0.06
Turbo777444: calls $0.06
SOSSSSS: calls $0.05
SametsPickUp: calls $0.04
*** FLOP *** [Ks Js 9s]
Zybex696 joins the table at seat #1=20
SOSSSSS: checks=20
SametsPickUp: checks=20
the_wickstar: bets $0.12
Turbo777444: folds=20
SOSSSSS: folds=20
SametsPickUp: folds=20
Uncalled bet ($0.12) returned to the_wickstar
the_wickstar collected $0.23 from pot
*** SUMMARY ***
Total pot $0.24 | Rake $0.01=20
Board [Ks Js 9s]
Seat 2: sekcboy folded before Flop (didn't bet)
Seat 3: ChkRaizDaBTN folded before Flop (didn't bet)
Seat 4: the_wickstar collected ($0.23)
Seat 5: Turbo777444 (button) folded on the Flop
Seat 6: SOSSSSS (small blind) folded on the Flop
Seat 7: SametsPickUp (big blind) folded on the Flop
Seat 8: Kirhgof_1988 folded before Flop (didn't bet)
Seat 9: Vit94nit folded before Flop (didn't bet)


*********** # 167 **************
PokerStars Hand #169799942774:  Hold'em No Limit ($0.01/$0.02 USD) - 20=
17/05/01 19:40:49 CUST [2017/05/01 5:40:49 ET]
Table 'Andraimon II' 9-max Seat #4 is the button
Seat 2: sekcboy ($2.01 in chips)=20
Seat 3: ChkRaizDaBTN ($2.18 in chips)=20
Seat 4: the_wickstar ($0.70 in chips)=20
Seat 5: Turbo777444 ($0.78 in chips)=20
Seat 6: SOSSSSS ($2.06 in chips)=20
Seat 7: SametsPickUp ($2.19 in chips)=20
Seat 8: Kirhgof_1988 ($2 in chips)=20
Seat 9: Vit94nit ($2 in chips)=20
Turbo777444: posts small blind $0.01
SOSSSSS: posts big blind $0.02
*** HOLE CARDS ***
Dealt to the_wickstar [9d 8s]
SametsPickUp: folds=20
Kirhgof_1988: folds=20
Vit94nit: raises $0.04 to $0.06
sekcboy: raises $0.12 to $0.18
ChkRaizDaBTN: folds=20
the_wickstar: folds=20
Turbo777444: calls $0.17
SOSSSSS: folds=20
Vit94nit: folds=20
*** FLOP *** [Qh Jc 7d]
Turbo777444: checks=20
sekcboy: bets $1.83 and is all-in
Turbo777444: calls $0.60 and is all-in
Uncalled bet ($1.23) returned to sekcboy
*** TURN *** [Qh Jc 7d] [4s]
*** RIVER *** [Qh Jc 7d 4s] [Js]
*** SHOW DOWN ***
Turbo777444: shows [As Kd] (a pair of Jacks)
sekcboy: shows [Ah Ks] (a pair of Jacks)
Turbo777444 collected $0.79 from pot
sekcboy collected $0.79 from pot
*** SUMMARY ***
Total pot $1.64 | Rake $0.06=20
Board [Qh Jc 7d 4s Js]
Seat 2: sekcboy showed [Ah Ks] and won ($0.79) with a pair of Jacks
Seat 3: ChkRaizDaBTN folded before Flop (didn't bet)
Seat 4: the_wickstar (button) folded before Flop (didn't bet)
Seat 5: Turbo777444 (small blind) showed [As Kd] and won ($0.79) with a=
 pair of Jacks
Seat 6: SOSSSSS (big blind) folded before Flop
Seat 7: SametsPickUp folded before Flop (didn't bet)
Seat 8: Kirhgof_1988 folded before Flop (didn't bet)
Seat 9: Vit94nit folded before Flop


*********** # 168 **************
PokerStars Hand #169799942573:  Hold'em No Limit ($0.01/$0.02 USD) - 20=
17/05/01 19:40:49 CUST [2017/05/01 5:40:49 ET]
Table 'Chandra' 9-max Seat #9 is the button
Seat 1: SOSSSSS ($2 in chips)=20
Seat 2: fomik33 ($2.05 in chips)=20
Seat 4: And7888 ($1.07 in chips)=20
Seat 5: hardcoreMD ($2.26 in chips)=20
Seat 6: mkzoo ($1.97 in chips)=20
Seat 7: Yafets ($1.49 in chips)=20
Seat 8: jays451 ($2 in chips)=20
Seat 9: the_wickstar ($0.61 in chips)=20
SOSSSSS: posts small blind $0.01
fomik33: posts big blind $0.02
*** HOLE CARDS ***
Dealt to the_wickstar [6d 2h]
And7888: raises $0.04 to $0.06
hardcoreMD: folds=20
mkzoo: folds=20
Yafets: folds=20
And7888 is disconnected=20
jays451: calls $0.06
the_wickstar: folds=20
SOSSSSS: folds=20
fomik33: folds=20
*** FLOP *** [Js 5s Th]
And7888: bets $0.07
jays451: calls $0.07
*** TURN *** [Js 5s Th] [8s]
And7888: bets $0.14
jays451: calls $0.14
*** RIVER *** [Js 5s Th 8s] [5c]
And7888: bets $0.28
jays451: folds=20
Uncalled bet ($0.28) returned to And7888
And7888 collected $0.55 from pot
And7888: doesn't show hand=20
*** SUMMARY ***
Total pot $0.57 | Rake $0.02=20
Board [Js 5s Th 8s 5c]
Seat 1: SOSSSSS (small blind) folded before Flop
Seat 2: fomik33 (big blind) folded before Flop
Seat 4: And7888 collected ($0.55)
Seat 5: hardcoreMD folded before Flop (didn't bet)
Seat 6: mkzoo folded before Flop (didn't bet)
Seat 7: Yafets folded before Flop (didn't bet)
Seat 8: jays451 folded on the River
Seat 9: the_wickstar (button) folded before Flop (didn't bet)


*********** # 169 **************
PokerStars Hand #169799931424:  Hold'em No Limit ($0.01/$0.02 USD) - 20=
17/05/01 19:40:21 CUST [2017/05/01 5:40:21 ET]
Table 'Chandra' 9-max Seat #8 is the button
Seat 1: SOSSSSS ($2 in chips)=20
Seat 2: fomik33 ($2.05 in chips)=20
Seat 4: And7888 ($1.07 in chips)=20
Seat 5: hardcoreMD ($2.23 in chips)=20
Seat 6: mkzoo ($1.97 in chips)=20
Seat 7: Yafets ($1.49 in chips)=20
Seat 8: jays451 ($2 in chips)=20
Seat 9: the_wickstar ($0.62 in chips)=20
the_wickstar: posts small blind $0.01
SOSSSSS: posts big blind $0.02
*** HOLE CARDS ***
Dealt to the_wickstar [4d 5c]
fomik33: folds=20
And7888: folds=20
hardcoreMD: raises $0.04 to $0.06
mkzoo: folds=20
Yafets: folds=20
jays451: folds=20
the_wickstar: folds=20
SOSSSSS: folds=20
Uncalled bet ($0.04) returned to hardcoreMD
hardcoreMD collected $0.05 from pot
hardcoreMD: doesn't show hand=20
*** SUMMARY ***
Total pot $0.05 | Rake $0=20
Seat 1: SOSSSSS (big blind) folded before Flop
Seat 2: fomik33 folded before Flop (didn't bet)
Seat 4: And7888 folded before Flop (didn't bet)
Seat 5: hardcoreMD collected ($0.05)
Seat 6: mkzoo folded before Flop (didn't bet)
Seat 7: Yafets folded before Flop (didn't bet)
Seat 8: jays451 (button) folded before Flop (didn't bet)
Seat 9: the_wickstar (small blind) folded before Flop


*********** # 170 **************
PokerStars Hand #169799923040:  Hold'em No Limit ($0.01/$0.02 USD) - 20=
17/05/01 19:40:00 CUST [2017/05/01 5:40:00 ET]
Table 'Andraimon II' 9-max Seat #3 is the button
Seat 2: sekcboy ($2.01 in chips)=20
Seat 3: ChkRaizDaBTN ($2.18 in chips)=20
Seat 4: the_wickstar ($0.71 in chips)=20
Seat 5: Turbo777444 ($0.80 in chips)=20
Seat 6: SOSSSSS ($2.06 in chips)=20
Seat 7: SametsPickUp ($2.16 in chips)=20
Seat 8: Kirhgof_1988 ($2 in chips)=20
Seat 9: Vit94nit ($2 in chips)=20
the_wickstar: posts small blind $0.01
Turbo777444: posts big blind $0.02
*** HOLE CARDS ***
Dealt to the_wickstar [Th 6s]
SOSSSSS: folds=20
SametsPickUp: raises $0.04 to $0.06
Kirhgof_1988: folds=20
Vit94nit: folds=20
sekcboy: folds=20
ChkRaizDaBTN: folds=20
the_wickstar: folds=20
Turbo777444: folds=20
Uncalled bet ($0.04) returned to SametsPickUp
SametsPickUp collected $0.05 from pot
SametsPickUp: doesn't show hand=20
*** SUMMARY ***
Total pot $0.05 | Rake $0=20
Seat 2: sekcboy folded before Flop (didn't bet)
Seat 3: ChkRaizDaBTN (button) folded before Flop (didn't bet)
Seat 4: the_wickstar (small blind) folded before Flop
Seat 5: Turbo777444 (big blind) folded before Flop
Seat 6: SOSSSSS folded before Flop (didn't bet)
Seat 7: SametsPickUp collected ($0.05)
Seat 8: Kirhgof_1988 folded before Flop (didn't bet)
Seat 9: Vit94nit folded before Flop (didn't bet)


*********** # 171 **************
PokerStars Hand #169799907758:  Hold'em No Limit ($0.01/$0.02 USD) - 20=
17/05/01 19:39:23 CUST [2017/05/01 5:39:23 ET]
Table 'Chandra' 9-max Seat #7 is the button
Seat 1: SOSSSSS ($2 in chips)=20
Seat 2: fomik33 ($2.05 in chips)=20
Seat 3: izy cykerman ($2.56 in chips)=20
Seat 4: And7888 ($1.04 in chips)=20
Seat 5: hardcoreMD ($2.23 in chips)=20
Seat 6: mkzoo ($1.97 in chips)=20
Seat 7: Yafets ($1.49 in chips)=20
Seat 8: jays451 ($2 in chips)=20
Seat 9: the_wickstar ($0.64 in chips)=20
jays451: posts small blind $0.01
the_wickstar: posts big blind $0.02
*** HOLE CARDS ***
Dealt to the_wickstar [4d Jh]
SOSSSSS: folds=20
fomik33: folds=20
izy cykerman has timed out
izy cykerman: folds=20
And7888: raises $0.04 to $0.06
hardcoreMD: folds=20
mkzoo: folds=20
Yafets: folds=20
jays451: folds=20
the_wickstar: folds=20
Uncalled bet ($0.04) returned to And7888
And7888 collected $0.05 from pot
And7888: doesn't show hand=20
*** SUMMARY ***
Total pot $0.05 | Rake $0=20
Seat 1: SOSSSSS folded before Flop (didn't bet)
Seat 2: fomik33 folded before Flop (didn't bet)
Seat 3: izy cykerman folded before Flop (didn't bet)
Seat 4: And7888 collected ($0.05)
Seat 5: hardcoreMD folded before Flop (didn't bet)
Seat 6: mkzoo folded before Flop (didn't bet)
Seat 7: Yafets (button) folded before Flop (didn't bet)
Seat 8: jays451 (small blind) folded before Flop
Seat 9: the_wickstar (big blind) folded before Flop


*********** # 172 **************
PokerStars Hand #169799906469:  Hold'em No Limit ($0.01/$0.02 USD) - 20=
17/05/01 19:39:20 CUST [2017/05/01 5:39:20 ET]
Table 'Andraimon II' 9-max Seat #2 is the button
Seat 2: sekcboy ($1.98 in chips)=20
Seat 3: ChkRaizDaBTN ($2.19 in chips)=20
Seat 4: the_wickstar ($0.73 in chips)=20
Seat 5: Bo.Susik ($1.41 in chips)=20
Seat 6: SOSSSSS ($2.06 in chips)=20
Seat 7: SametsPickUp ($2.16 in chips)=20
Seat 8: Kirhgof_1988 ($2 in chips)=20
Seat 9: Vit94nit ($2 in chips)=20
ChkRaizDaBTN: posts small blind $0.01
the_wickstar: posts big blind $0.02
*** HOLE CARDS ***
Dealt to the_wickstar [4s Tc]
Bo.Susik: folds=20
Bo.Susik leaves the table
SOSSSSS: folds=20
SametsPickUp: folds=20
Kirhgof_1988: folds=20
Vit94nit: folds=20
sekcboy: raises $0.04 to $0.06
ChkRaizDaBTN: folds=20
Turbo777444 joins the table at seat #5=20
the_wickstar: folds=20
Uncalled bet ($0.04) returned to sekcboy
sekcboy collected $0.05 from pot
*** SUMMARY ***
Total pot $0.05 | Rake $0=20
Seat 2: sekcboy (button) collected ($0.05)
Seat 3: ChkRaizDaBTN (small blind) folded before Flop
Seat 4: the_wickstar (big blind) folded before Flop
Seat 5: Bo.Susik folded before Flop (didn't bet)
Seat 6: SOSSSSS folded before Flop (didn't bet)
Seat 7: SametsPickUp folded before Flop (didn't bet)
Seat 8: Kirhgof_1988 folded before Flop (didn't bet)
Seat 9: Vit94nit folded before Flop (didn't bet)


*********** # 173 **************
PokerStars Hand #169799883416:  Hold'em No Limit ($0.01/$0.02 USD) - 20=
17/05/01 19:38:24 CUST [2017/05/01 5:38:24 ET]
Table 'Andraimon II' 9-max Seat #1 is the button
Seat 1: suzuki362 ($1.77 in chips)=20
Seat 2: sekcboy ($1.99 in chips)=20
Seat 3: ChkRaizDaBTN ($2.21 in chips)=20
Seat 4: the_wickstar ($0.73 in chips)=20
Seat 5: Bo.Susik ($1.41 in chips)=20
Seat 6: SOSSSSS ($2.06 in chips)=20
Seat 7: SametsPickUp ($2.13 in chips)=20
Seat 8: Kirhgof_1988 ($2 in chips)=20
Seat 9: Vit94nit ($2 in chips)=20
sekcboy: posts small blind $0.01
ChkRaizDaBTN: posts big blind $0.02
*** HOLE CARDS ***
Dealt to the_wickstar [5d Qc]
the_wickstar: folds=20
Bo.Susik: folds=20
SOSSSSS: folds=20
SametsPickUp: raises $0.04 to $0.06
Kirhgof_1988: folds=20
Vit94nit: folds=20
suzuki362: folds=20
sekcboy: folds=20
suzuki362 leaves the table
ChkRaizDaBTN: folds=20
Uncalled bet ($0.04) returned to SametsPickUp
SametsPickUp collected $0.05 from pot
SametsPickUp: doesn't show hand=20
*** SUMMARY ***
Total pot $0.05 | Rake $0=20
Seat 1: suzuki362 (button) folded before Flop (didn't bet)
Seat 2: sekcboy (small blind) folded before Flop
Seat 3: ChkRaizDaBTN (big blind) folded before Flop
Seat 4: the_wickstar folded before Flop (didn't bet)
Seat 5: Bo.Susik folded before Flop (didn't bet)
Seat 6: SOSSSSS folded before Flop (didn't bet)
Seat 7: SametsPickUp collected ($0.05)
Seat 8: Kirhgof_1988 folded before Flop (didn't bet)
Seat 9: Vit94nit folded before Flop (didn't bet)


*********** # 174 **************
PokerStars Hand #169799866512:  Hold'em No Limit ($0.01/$0.02 USD) - 20=
17/05/01 19:37:43 CUST [2017/05/01 5:37:43 ET]
Table 'Andraimon II' 9-max Seat #9 is the button
Seat 1: suzuki362 ($1.83 in chips)=20
Seat 2: sekcboy ($2.01 in chips)=20
Seat 3: ChkRaizDaBTN ($2.21 in chips)=20
Seat 4: the_wickstar ($0.73 in chips)=20
Seat 5: Bo.Susik ($1.41 in chips)=20
Seat 6: SOSSSSS ($2.06 in chips)=20
Seat 7: SametsPickUp ($2.05 in chips)=20
Seat 8: Kirhgof_1988 ($2 in chips)=20
Seat 9: Vit94nit ($2 in chips)=20
suzuki362: posts small blind $0.01
sekcboy: posts big blind $0.02
*** HOLE CARDS ***
Dealt to the_wickstar [6s 7c]
ChkRaizDaBTN: folds=20
the_wickstar: folds=20
Bo.Susik: folds=20
SOSSSSS: folds=20
SametsPickUp: raises $0.04 to $0.06
Kirhgof_1988: folds=20
Vit94nit: folds=20
suzuki362: calls $0.05
sekcboy: folds=20
*** FLOP *** [3s Kd 8d]
suzuki362: checks=20
SametsPickUp: bets $0.09
suzuki362: folds=20
Uncalled bet ($0.09) returned to SametsPickUp
SametsPickUp collected $0.14 from pot
SametsPickUp: doesn't show hand=20
*** SUMMARY ***
Total pot $0.14 | Rake $0=20
Board [3s Kd 8d]
Seat 1: suzuki362 (small blind) folded on the Flop
Seat 2: sekcboy (big blind) folded before Flop
Seat 3: ChkRaizDaBTN folded before Flop (didn't bet)
Seat 4: the_wickstar folded before Flop (didn't bet)
Seat 5: Bo.Susik folded before Flop (didn't bet)
Seat 6: SOSSSSS folded before Flop (didn't bet)
Seat 7: SametsPickUp collected ($0.14)
Seat 8: Kirhgof_1988 folded before Flop (didn't bet)
Seat 9: Vit94nit (button) folded before Flop (didn't bet)


*********** # 175 **************
PokerStars Hand #169799857193:  Hold'em No Limit ($0.01/$0.02 USD) - 20=
17/05/01 19:37:20 CUST [2017/05/01 5:37:20 ET]
Table 'Chandra' 9-max Seat #6 is the button
Seat 1: SOSSSSS ($2 in chips)=20
Seat 2: fomik33 ($2.05 in chips)=20
Seat 3: izy cykerman ($2.56 in chips)=20
Seat 4: And7888 ($1.06 in chips)=20
Seat 5: hardcoreMD ($2.13 in chips)=20
Seat 6: mkzoo ($1.97 in chips)=20
Seat 7: Yafets ($1.50 in chips)=20
Seat 8: jays451 ($2 in chips)=20
Seat 9: the_wickstar ($0.64 in chips)=20
Yafets: posts small blind $0.01
jays451: posts big blind $0.02
*** HOLE CARDS ***
Dealt to the_wickstar [7c 3c]
the_wickstar: folds=20
SOSSSSS: folds=20
fomik33: folds=20
izy cykerman: folds=20
And7888: calls $0.02
hardcoreMD: raises $0.06 to $0.08
mkzoo: folds=20
Yafets: folds=20
jays451: calls $0.06
And7888: folds=20
*** FLOP *** [6h 9h 3d]
jays451: checks=20
hardcoreMD: checks=20
*** TURN *** [6h 9h 3d] [Qh]
jays451: checks=20
hardcoreMD: checks=20
*** RIVER *** [6h 9h 3d Qh] [2h]
jays451: checks=20
hardcoreMD: checks=20
*** SHOW DOWN ***
jays451: shows [Kd Jc] (high card King)
hardcoreMD: shows [8s As] (high card Ace)
hardcoreMD collected $0.18 from pot
*** SUMMARY ***
Total pot $0.19 | Rake $0.01=20
Board [6h 9h 3d Qh 2h]
Seat 1: SOSSSSS folded before Flop (didn't bet)
Seat 2: fomik33 folded before Flop (didn't bet)
Seat 3: izy cykerman folded before Flop (didn't bet)
Seat 4: And7888 folded before Flop
Seat 5: hardcoreMD showed [8s As] and won ($0.18) with high card Ace
Seat 6: mkzoo (button) folded before Flop (didn't bet)
Seat 7: Yafets (small blind) folded before Flop
Seat 8: jays451 (big blind) showed [Kd Jc] and lost with high card King
Seat 9: the_wickstar folded before Flop (didn't bet)


*********** # 176 **************
PokerStars Hand #169799845331:  Hold'em No Limit ($0.01/$0.02 USD) - 20=
17/05/01 19:36:51 CUST [2017/05/01 5:36:51 ET]
Table 'Andraimon II' 9-max Seat #8 is the button
Seat 1: suzuki362 ($1.85 in chips)=20
Seat 2: sekcboy ($2.01 in chips)=20
Seat 3: ChkRaizDaBTN ($2.07 in chips)=20
Seat 4: the_wickstar ($0.79 in chips)=20
Seat 5: Bo.Susik ($1.41 in chips)=20
Seat 6: SOSSSSS ($2.06 in chips)=20
Seat 7: SametsPickUp ($2.05 in chips)=20
Seat 8: Kirhgof_1988 ($2 in chips)=20
Seat 9: Vit94nit ($2.01 in chips)=20
Vit94nit: posts small blind $0.01
suzuki362: posts big blind $0.02
*** HOLE CARDS ***
Dealt to the_wickstar [Qh As]
sekcboy: folds=20
ChkRaizDaBTN: raises $0.04 to $0.06
the_wickstar: calls $0.06
Bo.Susik: folds=20
SOSSSSS: folds=20
SametsPickUp: folds=20
Kirhgof_1988: calls $0.06
Vit94nit: folds=20
suzuki362: folds=20
*** FLOP *** [3h Th 2s]
ChkRaizDaBTN: bets $0.10
the_wickstar: folds=20
Kirhgof_1988: folds=20
Uncalled bet ($0.10) returned to ChkRaizDaBTN
ChkRaizDaBTN collected $0.20 from pot
ChkRaizDaBTN: doesn't show hand=20
*** SUMMARY ***
Total pot $0.21 | Rake $0.01=20
Board [3h Th 2s]
Seat 1: suzuki362 (big blind) folded before Flop
Seat 2: sekcboy folded before Flop (didn't bet)
Seat 3: ChkRaizDaBTN collected ($0.20)
Seat 4: the_wickstar folded on the Flop
Seat 5: Bo.Susik folded before Flop (didn't bet)
Seat 6: SOSSSSS folded before Flop (didn't bet)
Seat 7: SametsPickUp folded before Flop (didn't bet)
Seat 8: Kirhgof_1988 (button) folded on the Flop
Seat 9: Vit94nit (small blind) folded before Flop


*********** # 177 **************
PokerStars Hand #169799827509:  Hold'em No Limit ($0.01/$0.02 USD) - 20=
17/05/01 19:36:07 CUST [2017/05/01 5:36:07 ET]
Table 'Chandra' 9-max Seat #5 is the button
Seat 1: SOSSSSS ($2 in chips)=20
Seat 2: fomik33 ($2.05 in chips)=20
Seat 3: izy cykerman ($2.56 in chips)=20
Seat 4: And7888 ($1.08 in chips)=20
Seat 5: hardcoreMD ($2.06 in chips)=20
Seat 6: mkzoo ($1.98 in chips)=20
Seat 7: Yafets ($1.52 in chips)=20
Seat 9: the_wickstar ($0.66 in chips)=20
mkzoo: posts small blind $0.01
Yafets: posts big blind $0.02
*** HOLE CARDS ***
Dealt to the_wickstar [7s 7d]
the_wickstar: calls $0.02
SOSSSSS: folds=20
fomik33: folds=20
izy cykerman: folds=20
And7888: calls $0.02
hardcoreMD: raises $0.08 to $0.10
mkzoo: folds=20
Yafets: folds=20
the_wickstar: folds=20
jays451 joins the table at seat #8=20
And7888 is disconnected=20
And7888 is connected=20
And7888: folds=20
Uncalled bet ($0.08) returned to hardcoreMD
hardcoreMD collected $0.09 from pot
hardcoreMD: doesn't show hand=20
*** SUMMARY ***
Total pot $0.09 | Rake $0=20
Seat 1: SOSSSSS folded before Flop (didn't bet)
Seat 2: fomik33 folded before Flop (didn't bet)
Seat 3: izy cykerman folded before Flop (didn't bet)
Seat 4: And7888 folded before Flop
Seat 5: hardcoreMD (button) collected ($0.09)
Seat 6: mkzoo (small blind) folded before Flop
Seat 7: Yafets (big blind) folded before Flop
Seat 9: the_wickstar folded before Flop


*********** # 178 **************
PokerStars Hand #169799822308:  Hold'em No Limit ($0.01/$0.02 USD) - 20=
17/05/01 19:35:54 CUST [2017/05/01 5:35:54 ET]
Table 'Andraimon II' 9-max Seat #7 is the button
Seat 1: suzuki362 ($1.87 in chips)=20
Seat 2: sekcboy ($2.01 in chips)=20
Seat 3: ChkRaizDaBTN ($2.07 in chips)=20
Seat 4: the_wickstar ($0.79 in chips)=20
Seat 5: Bo.Susik ($1.41 in chips)=20
Seat 6: SOSSSSS ($2.06 in chips)=20
Seat 7: SametsPickUp ($2 in chips)=20
Seat 8: Kirhgof_1988 ($2 in chips)=20
Seat 9: Vit94nit ($2.03 in chips)=20
Kirhgof_1988: posts small blind $0.01
Vit94nit: posts big blind $0.02
*** HOLE CARDS ***
Dealt to the_wickstar [9s 5h]
suzuki362: calls $0.02
sekcboy: folds=20
ChkRaizDaBTN: folds=20
the_wickstar: folds=20
Bo.Susik: folds=20
SOSSSSS: folds=20
SametsPickUp: raises $0.06 to $0.08
Kirhgof_1988: folds=20
Vit94nit: folds=20
suzuki362: folds=20
Uncalled bet ($0.06) returned to SametsPickUp
SametsPickUp collected $0.07 from pot
SametsPickUp: doesn't show hand=20
*** SUMMARY ***
Total pot $0.07 | Rake $0=20
Seat 1: suzuki362 folded before Flop
Seat 2: sekcboy folded before Flop (didn't bet)
Seat 3: ChkRaizDaBTN folded before Flop (didn't bet)
Seat 4: the_wickstar folded before Flop (didn't bet)
Seat 5: Bo.Susik folded before Flop (didn't bet)
Seat 6: SOSSSSS folded before Flop (didn't bet)
Seat 7: SametsPickUp (button) collected ($0.07)
Seat 8: Kirhgof_1988 (small blind) folded before Flop
Seat 9: Vit94nit (big blind) folded before Flop


*********** # 179 **************
PokerStars Hand #169799813789:  Hold'em No Limit ($0.01/$0.02 USD) - 20=
17/05/01 19:35:33 CUST [2017/05/01 5:35:33 ET]
Table 'Chandra' 9-max Seat #4 is the button
Seat 1: SOSSSSS ($2 in chips)=20
Seat 2: fomik33 ($2.05 in chips)=20
Seat 3: izy cykerman ($2.56 in chips)=20
Seat 4: And7888 ($1.05 in chips)=20
Seat 5: hardcoreMD ($2.07 in chips)=20
Seat 6: mkzoo ($2 in chips)=20
Seat 7: Yafets ($1.52 in chips)=20
Seat 9: the_wickstar ($0.66 in chips)=20
hardcoreMD: posts small blind $0.01
mkzoo: posts big blind $0.02
*** HOLE CARDS ***
Dealt to the_wickstar [7s 4c]
Yafets: folds=20
the_wickstar: folds=20
SOSSSSS: folds=20
fomik33: folds=20
izy cykerman: folds=20
And7888: raises $0.02 to $0.04
hardcoreMD: folds=20
mkzoo: folds=20
Uncalled bet ($0.02) returned to And7888
And7888 collected $0.05 from pot
And7888: doesn't show hand=20
*** SUMMARY ***
Total pot $0.05 | Rake $0=20
Seat 1: SOSSSSS folded before Flop (didn't bet)
Seat 2: fomik33 folded before Flop (didn't bet)
Seat 3: izy cykerman folded before Flop (didn't bet)
Seat 4: And7888 (button) collected ($0.05)
Seat 5: hardcoreMD (small blind) folded before Flop
Seat 6: mkzoo (big blind) folded before Flop
Seat 7: Yafets folded before Flop (didn't bet)
Seat 9: the_wickstar folded before Flop (didn't bet)


*********** # 180 **************
PokerStars Hand #169799793180:  Hold'em No Limit ($0.01/$0.02 USD) - 20=
17/05/01 19:34:42 CUST [2017/05/01 5:34:42 ET]
Table 'Andraimon II' 9-max Seat #6 is the button
Seat 1: suzuki362 ($1.83 in chips)=20
Seat 2: sekcboy ($2.01 in chips)=20
Seat 3: ChkRaizDaBTN ($2.07 in chips)=20
Seat 4: the_wickstar ($0.79 in chips)=20
Seat 5: Bo.Susik ($1.41 in chips)=20
Seat 6: SOSSSSS ($2.06 in chips)=20
Seat 7: SametsPickUp ($2 in chips)=20
Seat 8: Kirhgof_1988 ($2 in chips)=20
Seat 9: Vit94nit ($2.03 in chips)=20
SametsPickUp: posts small blind $0.01
Kirhgof_1988: posts big blind $0.02
*** HOLE CARDS ***
Dealt to the_wickstar [6h 4d]
Vit94nit: folds=20
suzuki362: calls $0.02
sekcboy: folds=20
ChkRaizDaBTN: folds=20
the_wickstar: folds=20
Bo.Susik: folds=20
SOSSSSS: folds=20
SametsPickUp: calls $0.01
Kirhgof_1988: checks=20
*** FLOP *** [Jh Ad 6s]
SametsPickUp: checks=20
Kirhgof_1988: checks=20
suzuki362: bets $0.06
SametsPickUp: folds=20
Kirhgof_1988: folds=20
Uncalled bet ($0.06) returned to suzuki362
suzuki362 collected $0.06 from pot
suzuki362: doesn't show hand=20
*** SUMMARY ***
Total pot $0.06 | Rake $0=20
Board [Jh Ad 6s]
Seat 1: suzuki362 collected ($0.06)
Seat 2: sekcboy folded before Flop (didn't bet)
Seat 3: ChkRaizDaBTN folded before Flop (didn't bet)
Seat 4: the_wickstar folded before Flop (didn't bet)
Seat 5: Bo.Susik folded before Flop (didn't bet)
Seat 6: SOSSSSS (button) folded before Flop (didn't bet)
Seat 7: SametsPickUp (small blind) folded on the Flop
Seat 8: Kirhgof_1988 (big blind) folded on the Flop
Seat 9: Vit94nit folded before Flop (didn't bet)


*********** # 181 **************
PokerStars Hand #169799780229:  Hold'em No Limit ($0.01/$0.02 USD) - 20=
17/05/01 19:34:10 CUST [2017/05/01 5:34:10 ET]
Table 'Chandra' 9-max Seat #3 is the button
Seat 1: SOSSSSS ($2.16 in chips)=20
Seat 2: fomik33 ($2.05 in chips)=20
Seat 3: izy cykerman ($1.85 in chips)=20
Seat 4: And7888 ($1.06 in chips)=20
Seat 5: hardcoreMD ($2.09 in chips)=20
Seat 6: xth17 ($0.93 in chips)=20
Seat 7: Yafets ($1.54 in chips)=20
Seat 9: the_wickstar ($0.76 in chips)=20
And7888: posts small blind $0.01
hardcoreMD: posts big blind $0.02
*** HOLE CARDS ***
Dealt to the_wickstar [Qh Jh]
xth17: folds=20
Yafets: calls $0.02
xth17 leaves the table
the_wickstar: calls $0.02
SOSSSSS: calls $0.02
fomik33: folds=20
izy cykerman: raises $0.08 to $0.10
And7888: folds=20
hardcoreMD: folds=20
Yafets: folds=20
the_wickstar: calls $0.08
SOSSSSS: calls $0.08
*** FLOP *** [7s 3d Kd]
the_wickstar: checks=20
SOSSSSS: checks=20
izy cykerman: bets $0.17
mkzoo joins the table at seat #6=20
the_wickstar: folds=20
SOSSSSS: calls $0.17
*** TURN *** [7s 3d Kd] [5h]
SOSSSSS: checks=20
izy cykerman: bets $0.34
SOSSSSS: calls $0.34
*** RIVER *** [7s 3d Kd 5h] [3c]
SOSSSSS: checks=20
izy cykerman: bets $0.66
SOSSSSS: folds=20
Uncalled bet ($0.66) returned to izy cykerman
izy cykerman collected $1.32 from pot
izy cykerman: doesn't show hand=20
*** SUMMARY ***
Total pot $1.37 | Rake $0.05=20
Board [7s 3d Kd 5h 3c]
Seat 1: SOSSSSS folded on the River
Seat 2: fomik33 folded before Flop (didn't bet)
Seat 3: izy cykerman (button) collected ($1.32)
Seat 4: And7888 (small blind) folded before Flop
Seat 5: hardcoreMD (big blind) folded before Flop
Seat 6: xth17 folded before Flop (didn't bet)
Seat 7: Yafets folded before Flop
Seat 9: the_wickstar folded on the Flop


*********** # 182 **************
PokerStars Hand #169799780074:  Hold'em No Limit ($0.01/$0.02 USD) - 20=
17/05/01 19:34:10 CUST [2017/05/01 5:34:10 ET]
Table 'Andraimon II' 9-max Seat #5 is the button
Seat 1: suzuki362 ($1.83 in chips)=20
Seat 2: sekcboy ($2.01 in chips)=20
Seat 3: ChkRaizDaBTN ($2.07 in chips)=20
Seat 4: the_wickstar ($0.79 in chips)=20
Seat 5: Bo.Susik ($1.41 in chips)=20
Seat 6: SOSSSSS ($2.04 in chips)=20
Seat 7: SametsPickUp ($2 in chips)=20
Seat 9: Vit94nit ($2.03 in chips)=20
SOSSSSS: posts small blind $0.01
SametsPickUp: posts big blind $0.02
Kirhgof_1988: sits out=20
*** HOLE CARDS ***
Dealt to the_wickstar [3c 4h]
Vit94nit: folds=20
suzuki362: folds=20
sekcboy: folds=20
ChkRaizDaBTN: folds=20
the_wickstar: folds=20
Bo.Susik: folds=20
SOSSSSS: raises $0.05 to $0.07
SametsPickUp: folds=20
Uncalled bet ($0.05) returned to SOSSSSS
SOSSSSS collected $0.04 from pot
SOSSSSS: doesn't show hand=20
*** SUMMARY ***
Total pot $0.04 | Rake $0=20
Seat 1: suzuki362 folded before Flop (didn't bet)
Seat 2: sekcboy folded before Flop (didn't bet)
Seat 3: ChkRaizDaBTN folded before Flop (didn't bet)
Seat 4: the_wickstar folded before Flop (didn't bet)
Seat 5: Bo.Susik (button) folded before Flop (didn't bet)
Seat 6: SOSSSSS (small blind) collected ($0.04)
Seat 7: SametsPickUp (big blind) folded before Flop
Seat 9: Vit94nit folded before Flop (didn't bet)


*********** # 183 **************
PokerStars Hand #169799764757:  Hold'em No Limit ($0.01/$0.02 USD) - 20=
17/05/01 19:33:32 CUST [2017/05/01 5:33:32 ET]
Table 'Andraimon II' 9-max Seat #4 is the button
Seat 1: suzuki362 ($1.83 in chips)=20
Seat 2: sekcboy ($2.01 in chips)=20
Seat 3: ChkRaizDaBTN ($2.07 in chips)=20
Seat 4: the_wickstar ($0.79 in chips)=20
Seat 5: Bo.Susik ($1.42 in chips)=20
Seat 6: SOSSSSS ($2.03 in chips)=20
Seat 7: SametsPickUp ($2 in chips)=20
Seat 9: Vit94nit ($2.03 in chips)=20
Bo.Susik: posts small blind $0.01
SOSSSSS: posts big blind $0.02
Kirhgof_1988: sits out=20
*** HOLE CARDS ***
Dealt to the_wickstar [5h 9d]
SametsPickUp: folds=20
Vit94nit: folds=20
suzuki362: folds=20
sekcboy: folds=20
ChkRaizDaBTN: folds=20
the_wickstar: folds=20
Bo.Susik: folds=20
Uncalled bet ($0.01) returned to SOSSSSS
SOSSSSS collected $0.02 from pot
SOSSSSS: doesn't show hand=20
*** SUMMARY ***
Total pot $0.02 | Rake $0=20
Seat 1: suzuki362 folded before Flop (didn't bet)
Seat 2: sekcboy folded before Flop (didn't bet)
Seat 3: ChkRaizDaBTN folded before Flop (didn't bet)
Seat 4: the_wickstar (button) folded before Flop (didn't bet)
Seat 5: Bo.Susik (small blind) folded before Flop
Seat 6: SOSSSSS (big blind) collected ($0.02)
Seat 7: SametsPickUp folded before Flop (didn't bet)
Seat 9: Vit94nit folded before Flop (didn't bet)


*********** # 184 **************
PokerStars Hand #169799752351:  Hold'em No Limit ($0.01/$0.02 USD) - 20=
17/05/01 19:33:01 CUST [2017/05/01 5:33:01 ET]
Table 'Chandra' 9-max Seat #2 is the button
Seat 1: SOSSSSS ($2.16 in chips)=20
Seat 2: fomik33 ($2.02 in chips)=20
Seat 3: izy cykerman ($1.86 in chips)=20
Seat 4: And7888 ($1.08 in chips)=20
Seat 5: hardcoreMD ($2.09 in chips)=20
Seat 6: xth17 ($0.93 in chips)=20
Seat 7: Yafets ($1.54 in chips)=20
Seat 9: the_wickstar ($0.76 in chips)=20
izy cykerman: posts small blind $0.01
And7888 is disconnected=20
And7888 is connected=20
And7888: posts big blind $0.02
kidkazino: is sitting out=20
kidkazino leaves the table
*** HOLE CARDS ***
Dealt to the_wickstar [Ks 7s]
hardcoreMD: folds=20
xth17: folds=20
Yafets: folds=20
the_wickstar: folds=20
SOSSSSS: folds=20
fomik33: raises $0.03 to $0.05
izy cykerman: folds=20
And7888: folds=20
Uncalled bet ($0.03) returned to fomik33
fomik33 collected $0.05 from pot
fomik33: doesn't show hand=20
*** SUMMARY ***
Total pot $0.05 | Rake $0=20
Seat 1: SOSSSSS folded before Flop (didn't bet)
Seat 2: fomik33 (button) collected ($0.05)
Seat 3: izy cykerman (small blind) folded before Flop
Seat 4: And7888 (big blind) folded before Flop
Seat 5: hardcoreMD folded before Flop (didn't bet)
Seat 6: xth17 folded before Flop (didn't bet)
Seat 7: Yafets folded before Flop (didn't bet)
Seat 9: the_wickstar folded before Flop (didn't bet)


*********** # 185 **************
PokerStars Hand #169799743916:  Hold'em No Limit ($0.01/$0.02 USD) - 20=
17/05/01 19:32:41 CUST [2017/05/01 5:32:41 ET]
Table 'Andraimon II' 9-max Seat #3 is the button
Seat 1: suzuki362 ($1.83 in chips)=20
Seat 2: sekcboy ($2.01 in chips)=20
Seat 3: ChkRaizDaBTN ($2.07 in chips)=20
Seat 4: the_wickstar ($0.81 in chips)=20
Seat 5: Bo.Susik ($1.40 in chips)=20
Seat 6: SOSSSSS ($2.03 in chips)=20
Seat 7: SametsPickUp ($2 in chips)=20
Seat 9: Vit94nit ($2.03 in chips)=20
the_wickstar: posts small blind $0.01
Bo.Susik: posts big blind $0.02
Kirhgof_1988: sits out=20
*** HOLE CARDS ***
Dealt to the_wickstar [6d Ad]
SOSSSSS: folds=20
SametsPickUp: folds=20
Vit94nit: folds=20
suzuki362: folds=20
sekcboy: folds=20
ChkRaizDaBTN: folds=20
the_wickstar: calls $0.01
Bo.Susik: raises $0.06 to $0.08
the_wickstar: folds=20
Uncalled bet ($0.06) returned to Bo.Susik
Bo.Susik collected $0.04 from pot
Bo.Susik: doesn't show hand=20
*** SUMMARY ***
Total pot $0.04 | Rake $0=20
Seat 1: suzuki362 folded before Flop (didn't bet)
Seat 2: sekcboy folded before Flop (didn't bet)
Seat 3: ChkRaizDaBTN (button) folded before Flop (didn't bet)
Seat 4: the_wickstar (small blind) folded before Flop
Seat 5: Bo.Susik (big blind) collected ($0.04)
Seat 6: SOSSSSS folded before Flop (didn't bet)
Seat 7: SametsPickUp folded before Flop (didn't bet)
Seat 9: Vit94nit folded before Flop (didn't bet)


*********** # 186 **************
PokerStars Hand #169799728941:  Hold'em No Limit ($0.01/$0.02 USD) - 20=
17/05/01 19:32:04 CUST [2017/05/01 5:32:04 ET]
Table 'Chandra' 9-max Seat #1 is the button
Seat 1: SOSSSSS ($2.16 in chips)=20
Seat 2: fomik33 ($2 in chips)=20
Seat 3: izy cykerman ($1.88 in chips)=20
Seat 4: And7888 ($1.08 in chips)=20
Seat 5: hardcoreMD ($2.09 in chips)=20
Seat 6: xth17 ($0.93 in chips)=20
Seat 7: Yafets ($1.54 in chips)=20
Seat 9: the_wickstar ($0.76 in chips)=20
fomik33: posts small blind $0.01
izy cykerman: posts big blind $0.02
kidkazino: sits out=20
*** HOLE CARDS ***
Dealt to the_wickstar [9s 3c]
And7888: folds=20
hardcoreMD: folds=20
xth17: folds=20
Yafets: folds=20
the_wickstar: folds=20
SOSSSSS: folds=20
fomik33: raises $0.03 to $0.05
izy cykerman: folds=20
Uncalled bet ($0.03) returned to fomik33
fomik33 collected $0.04 from pot
fomik33: doesn't show hand=20
*** SUMMARY ***
Total pot $0.04 | Rake $0=20
Seat 1: SOSSSSS (button) folded before Flop (didn't bet)
Seat 2: fomik33 (small blind) collected ($0.04)
Seat 3: izy cykerman (big blind) folded before Flop
Seat 4: And7888 folded before Flop (didn't bet)
Seat 5: hardcoreMD folded before Flop (didn't bet)
Seat 6: xth17 folded before Flop (didn't bet)
Seat 7: Yafets folded before Flop (didn't bet)
Seat 9: the_wickstar folded before Flop (didn't bet)


*********** # 187 **************
PokerStars Hand #169799720102:  Hold'em No Limit ($0.01/$0.02 USD) - 20=
17/05/01 19:31:42 CUST [2017/05/01 5:31:42 ET]
Table 'Andraimon II' 9-max Seat #2 is the button
Seat 1: suzuki362 ($1.83 in chips)=20
Seat 2: sekcboy ($2.07 in chips)=20
Seat 3: ChkRaizDaBTN ($2.08 in chips)=20
Seat 4: the_wickstar ($0.74 in chips)=20
Seat 5: Bo.Susik ($1.40 in chips)=20
Seat 6: SOSSSSS ($2.03 in chips)=20
Seat 7: SametsPickUp ($2 in chips)=20
Seat 9: Vit94nit ($2.03 in chips)=20
ChkRaizDaBTN: posts small blind $0.01
the_wickstar: posts big blind $0.02
*** HOLE CARDS ***
Dealt to the_wickstar [Ac Kh]
Bo.Susik: folds=20
kafa72 was removed from the table for failing to post
SOSSSSS: folds=20
Kirhgof_1988 joins the table at seat #8=20
SametsPickUp: folds=20
Vit94nit: folds=20
suzuki362: folds=20
sekcboy: raises $0.04 to $0.06
ChkRaizDaBTN: folds=20
the_wickstar: raises $0.12 to $0.18
sekcboy: folds=20
Uncalled bet ($0.12) returned to the_wickstar
the_wickstar collected $0.13 from pot
*** SUMMARY ***
Total pot $0.13 | Rake $0=20
Seat 1: suzuki362 folded before Flop (didn't bet)
Seat 2: sekcboy (button) folded before Flop
Seat 3: ChkRaizDaBTN (small blind) folded before Flop
Seat 4: the_wickstar (big blind) collected ($0.13)
Seat 5: Bo.Susik folded before Flop (didn't bet)
Seat 6: SOSSSSS folded before Flop (didn't bet)
Seat 7: SametsPickUp folded before Flop (didn't bet)
Seat 9: Vit94nit folded before Flop (didn't bet)


*********** # 188 **************
PokerStars Hand #169799698349:  Hold'em No Limit ($0.01/$0.02 USD) - 20=
17/05/01 19:30:48 CUST [2017/05/01 5:30:48 ET]
Table 'Chandra' 9-max Seat #9 is the button
Seat 1: SOSSSSS ($2.20 in chips)=20
Seat 2: fomik33 ($2 in chips)=20
Seat 3: izy cykerman ($1.78 in chips)=20
Seat 4: And7888 ($1.08 in chips)=20
Seat 5: hardcoreMD ($2.09 in chips)=20
Seat 6: xth17 ($0.93 in chips)=20
Seat 7: Yafets ($1.58 in chips)=20
Seat 9: the_wickstar ($0.76 in chips)=20
SOSSSSS: posts small blind $0.01
fomik33: posts big blind $0.02
kidkazino: sits out=20
*** HOLE CARDS ***
Dealt to the_wickstar [5s 2c]
izy cykerman: raises $0.02 to $0.04
And7888: folds=20
hardcoreMD: folds=20
xth17: folds=20
Yafets: calls $0.04
the_wickstar: folds=20
SOSSSSS: calls $0.03
fomik33: folds=20
*** FLOP *** [4h 7s 5d]
SOSSSSS: checks=20
izy cykerman: checks=20
Yafets: checks=20
*** TURN *** [4h 7s 5d] [4c]
SOSSSSS: checks=20
izy cykerman: bets $0.07
Yafets: folds=20
SOSSSSS: folds=20
Uncalled bet ($0.07) returned to izy cykerman
izy cykerman collected $0.14 from pot
izy cykerman: doesn't show hand=20
*** SUMMARY ***
Total pot $0.14 | Rake $0=20
Board [4h 7s 5d 4c]
Seat 1: SOSSSSS (small blind) folded on the Turn
Seat 2: fomik33 (big blind) folded before Flop
Seat 3: izy cykerman collected ($0.14)
Seat 4: And7888 folded before Flop (didn't bet)
Seat 5: hardcoreMD folded before Flop (didn't bet)
Seat 6: xth17 folded before Flop (didn't bet)
Seat 7: Yafets folded on the Turn
Seat 9: the_wickstar (button) folded before Flop (didn't bet)


*********** # 189 **************
PokerStars Hand #169799686282:  Hold'em No Limit ($0.01/$0.02 USD) - 20=
17/05/01 19:30:18 CUST [2017/05/01 5:30:18 ET]
Table 'Chandra' 9-max Seat #7 is the button
Seat 1: SOSSSSS ($2.19 in chips)=20
Seat 2: fomik33 ($2 in chips)=20
Seat 3: izy cykerman ($1.78 in chips)=20
Seat 4: And7888 ($1.08 in chips)=20
Seat 5: hardcoreMD ($2.09 in chips)=20
Seat 6: xth17 ($0.93 in chips)=20
Seat 7: Yafets ($1.58 in chips)=20
Seat 9: the_wickstar ($0.77 in chips)=20
kidkazino will be allowed to play after the button
the_wickstar: posts small blind $0.01
SOSSSSS: posts big blind $0.02
*** HOLE CARDS ***
Dealt to the_wickstar [Kh 6d]
fomik33: folds=20
izy cykerman: folds=20
And7888: folds=20
hardcoreMD: folds=20
xth17: folds=20
Yafets: folds=20
the_wickstar: folds=20
Uncalled bet ($0.01) returned to SOSSSSS
SOSSSSS collected $0.02 from pot
SOSSSSS: doesn't show hand=20
*** SUMMARY ***
Total pot $0.02 | Rake $0=20
Seat 1: SOSSSSS (big blind) collected ($0.02)
Seat 2: fomik33 folded before Flop (didn't bet)
Seat 3: izy cykerman folded before Flop (didn't bet)
Seat 4: And7888 folded before Flop (didn't bet)
Seat 5: hardcoreMD folded before Flop (didn't bet)
Seat 6: xth17 folded before Flop (didn't bet)
Seat 7: Yafets (button) folded before Flop (didn't bet)
Seat 9: the_wickstar (small blind) folded before Flop


*********** # 190 **************
PokerStars Hand #169799671962:  Hold'em No Limit ($0.01/$0.02 USD) - 20=
17/05/01 19:29:42 CUST [2017/05/01 5:29:42 ET]
Table 'Chandra' 9-max Seat #6 is the button
Seat 1: SOSSSSS ($2.19 in chips)=20
Seat 2: fomik33 ($2 in chips)=20
Seat 3: izy cykerman ($1.78 in chips)=20
Seat 4: And7888 ($1.08 in chips)=20
Seat 5: hardcoreMD ($2.06 in chips)=20
Seat 6: xth17 ($0.93 in chips)=20
Seat 7: Yafets ($1.59 in chips)=20
Seat 9: the_wickstar ($0.79 in chips)=20
Yafets: posts small blind $0.01
the_wickstar: posts big blind $0.02
*** HOLE CARDS ***
Dealt to the_wickstar [5c 2d]
SOSSSSS: folds=20
fomik33: folds=20
kidkazino joins the table at seat #8=20
izy cykerman: folds=20
And7888: folds=20
hardcoreMD: raises $0.04 to $0.06
xth17: folds=20
Yafets: folds=20
the_wickstar: folds=20
Uncalled bet ($0.04) returned to hardcoreMD
hardcoreMD collected $0.05 from pot
hardcoreMD: doesn't show hand=20
*** SUMMARY ***
Total pot $0.05 | Rake $0=20
Seat 1: SOSSSSS folded before Flop (didn't bet)
Seat 2: fomik33 folded before Flop (didn't bet)
Seat 3: izy cykerman folded before Flop (didn't bet)
Seat 4: And7888 folded before Flop (didn't bet)
Seat 5: hardcoreMD collected ($0.05)
Seat 6: xth17 (button) folded before Flop (didn't bet)
Seat 7: Yafets (small blind) folded before Flop
Seat 9: the_wickstar (big blind) folded before Flop


*********** # 191 **************
PokerStars Hand #169799599339:  Hold'em No Limit ($0.01/$0.02 USD) - 20=
17/05/01 19:26:42 CUST [2017/05/01 5:26:42 ET]
Table 'Chandra' 9-max Seat #3 is the button
Seat 1: SOSSSSS ($2.19 in chips)=20
Seat 2: fomik33 ($2 in chips)=20
Seat 3: izy cykerman ($1.78 in chips)=20
Seat 4: And7888 ($1.06 in chips)=20
Seat 5: hardcoreMD ($2 in chips)=20
Seat 6: xth17 ($0.96 in chips)=20
Seat 7: Yafets ($1.64 in chips)=20
Seat 8: seemore96 ($1.90 in chips)=20
Seat 9: the_wickstar ($0.79 in chips)=20
And7888: posts small blind $0.01
hardcoreMD: posts big blind $0.02
*** HOLE CARDS ***
Dealt to the_wickstar [Ah Ac]
xth17: folds=20
Yafets: folds=20
seemore96: folds=20
the_wickstar has timed out
the_wickstar: folds=20
SOSSSSS: folds=20
fomik33: folds=20
izy cykerman: folds=20
And7888: raises $0.04 to $0.06
hardcoreMD: folds=20
Uncalled bet ($0.04) returned to And7888
And7888 collected $0.04 from pot
And7888: doesn't show hand=20
*** SUMMARY ***
Total pot $0.04 | Rake $0=20
Seat 1: SOSSSSS folded before Flop (didn't bet)
Seat 2: fomik33 folded before Flop (didn't bet)
Seat 3: izy cykerman (button) folded before Flop (didn't bet)
Seat 4: And7888 (small blind) collected ($0.04)
Seat 5: hardcoreMD (big blind) folded before Flop
Seat 6: xth17 folded before Flop (didn't bet)
Seat 7: Yafets folded before Flop (didn't bet)
Seat 8: seemore96 folded before Flop (didn't bet)
Seat 9: the_wickstar folded before Flop (didn't bet)


*********** # 192 **************
PokerStars Hand #169799591502:  Hold'em No Limit ($0.01/$0.02 USD) - 20=
17/05/01 19:26:23 CUST [2017/05/01 5:26:23 ET]
Table 'Andraimon II' 9-max Seat #1 is the button
Seat 1: suzuki362 ($1.77 in chips)=20
Seat 3: ChkRaizDaBTN ($1.85 in chips)=20
Seat 4: the_wickstar ($0.76 in chips)=20
Seat 5: Bo.Susik ($1.41 in chips)=20
Seat 6: SOSSSSS ($2.15 in chips)=20
Seat 7: SametsPickUp ($2.07 in chips)=20
Seat 9: Vit94nit ($2.01 in chips)=20
ChkRaizDaBTN: posts small blind $0.01
the_wickstar: posts big blind $0.02
*** HOLE CARDS ***
Dealt to the_wickstar [5c Ac]
Bo.Susik: folds=20
SOSSSSS: folds=20
SametsPickUp: folds=20
Vit94nit: folds=20
suzuki362: folds=20
ChkRaizDaBTN: raises $0.04 to $0.06
the_wickstar has timed out
the_wickstar: folds=20
Uncalled bet ($0.04) returned to ChkRaizDaBTN
ChkRaizDaBTN collected $0.04 from pot
*** SUMMARY ***
Total pot $0.04 | Rake $0=20
Seat 1: suzuki362 (button) folded before Flop (didn't bet)
Seat 3: ChkRaizDaBTN (small blind) collected ($0.04)
Seat 4: the_wickstar (big blind) folded before Flop
Seat 5: Bo.Susik folded before Flop (didn't bet)
Seat 6: SOSSSSS folded before Flop (didn't bet)
Seat 7: SametsPickUp folded before Flop (didn't bet)
Seat 9: Vit94nit folded before Flop (didn't bet)


*********** # 193 **************
PokerStars Hand #169799562328:  Hold'em No Limit ($0.01/$0.02 USD) - 20=
17/05/01 19:25:09 CUST [2017/05/01 5:25:09 ET]
Table 'Andraimon II' 9-max Seat #9 is the button
Seat 1: suzuki362 ($1.84 in chips)=20
Seat 3: ChkRaizDaBTN ($1.87 in chips)=20
Seat 4: the_wickstar ($0.76 in chips)=20
Seat 5: Bo.Susik ($1.41 in chips)=20
Seat 6: SOSSSSS ($2.15 in chips)=20
Seat 7: SametsPickUp ($2.07 in chips)=20
Seat 9: Vit94nit ($1.93 in chips)=20
suzuki362: posts small blind $0.01
ChkRaizDaBTN: posts big blind $0.02
*** HOLE CARDS ***
Dealt to the_wickstar [Js 5s]
the_wickstar: folds=20
Bo.Susik: folds=20
SOSSSSS: folds=20
SametsPickUp: folds=20
Vit94nit: raises $0.05 to $0.07
suzuki362: calls $0.06
ChkRaizDaBTN: folds=20
*** FLOP *** [Ks Qh 4h]
suzuki362: checks=20
Vit94nit: checks=20
*** TURN *** [Ks Qh 4h] [Ac]
suzuki362: checks=20
Vit94nit: bets $0.08
suzuki362: folds=20
Uncalled bet ($0.08) returned to Vit94nit
Vit94nit collected $0.15 from pot
Vit94nit: doesn't show hand=20
*** SUMMARY ***
Total pot $0.16 | Rake $0.01=20
Board [Ks Qh 4h Ac]
Seat 1: suzuki362 (small blind) folded on the Turn
Seat 3: ChkRaizDaBTN (big blind) folded before Flop
Seat 4: the_wickstar folded before Flop (didn't bet)
Seat 5: Bo.Susik folded before Flop (didn't bet)
Seat 6: SOSSSSS folded before Flop (didn't bet)
Seat 7: SametsPickUp folded before Flop (didn't bet)
Seat 9: Vit94nit (button) collected ($0.15)


*********** # 194 **************
PokerStars Hand #169799555620:  Hold'em No Limit ($0.01/$0.02 USD) - 20=
17/05/01 19:24:53 CUST [2017/05/01 5:24:53 ET]
Table 'Chandra' 9-max Seat #2 is the button
Seat 1: SOSSSSS ($2.19 in chips)=20
Seat 2: fomik33 ($2 in chips)=20
Seat 3: izy cykerman ($1.79 in chips)=20
Seat 4: And7888 ($0.83 in chips)=20
Seat 5: hardcoreMD ($2 in chips)=20
Seat 6: xth17 ($0.96 in chips)=20
Seat 7: Yafets ($1.64 in chips)=20
Seat 8: seemore96 ($1.96 in chips)=20
Seat 9: the_wickstar ($0.79 in chips)=20
izy cykerman: posts small blind $0.01
And7888: posts big blind $0.02
*** HOLE CARDS ***
Dealt to the_wickstar [9d 8c]
hardcoreMD: raises $0.04 to $0.06
xth17: folds=20
Yafets: folds=20
seemore96: calls $0.06
the_wickstar: folds=20
SOSSSSS: folds=20
fomik33: folds=20
izy cykerman: folds=20
And7888: calls $0.04
*** FLOP *** [9s Qc 9c]
And7888: checks=20
hardcoreMD: bets $0.12
seemore96: folds=20
And7888: calls $0.12
*** TURN *** [9s Qc 9c] [7c]
And7888: checks=20
hardcoreMD: checks=20
*** RIVER *** [9s Qc 9c 7c] [7h]
And7888: bets $0.21
hardcoreMD: folds=20
Uncalled bet ($0.21) returned to And7888
And7888 collected $0.41 from pot
And7888: doesn't show hand=20
*** SUMMARY ***
Total pot $0.43 | Rake $0.02=20
Board [9s Qc 9c 7c 7h]
Seat 1: SOSSSSS folded before Flop (didn't bet)
Seat 2: fomik33 (button) folded before Flop (didn't bet)
Seat 3: izy cykerman (small blind) folded before Flop
Seat 4: And7888 (big blind) collected ($0.41)
Seat 5: hardcoreMD folded on the River
Seat 6: xth17 folded before Flop (didn't bet)
Seat 7: Yafets folded before Flop (didn't bet)
Seat 8: seemore96 folded on the Flop
Seat 9: the_wickstar folded before Flop (didn't bet)


*********** # 195 **************
PokerStars Hand #169799536662:  Hold'em No Limit ($0.01/$0.02 USD) - 20=
17/05/01 19:24:06 CUST [2017/05/01 5:24:06 ET]
Table 'Andraimon II' 9-max Seat #7 is the button
Seat 1: suzuki362 ($1.86 in chips)=20
Seat 3: ChkRaizDaBTN ($1.87 in chips)=20
Seat 4: the_wickstar ($0.82 in chips)=20
Seat 5: Bo.Susik ($1.47 in chips)=20
Seat 6: SOSSSSS ($2 in chips)=20
Seat 7: SametsPickUp ($2.07 in chips)=20
Seat 9: Vit94nit ($1.94 in chips)=20
Vit94nit: posts small blind $0.01
suzuki362: posts big blind $0.02
*** HOLE CARDS ***
Dealt to the_wickstar [Kd Js]
ChkRaizDaBTN: folds=20
the_wickstar: raises $0.04 to $0.06
Bo.Susik: calls $0.06
SOSSSSS: raises $0.21 to $0.27
SametsPickUp: folds=20
Vit94nit: folds=20
suzuki362: folds=20
the_wickstar: folds=20
Bo.Susik: folds=20
Uncalled bet ($0.21) returned to SOSSSSS
SOSSSSS collected $0.21 from pot
SOSSSSS: doesn't show hand=20
*** SUMMARY ***
Total pot $0.21 | Rake $0=20
Seat 1: suzuki362 (big blind) folded before Flop
Seat 3: ChkRaizDaBTN folded before Flop (didn't bet)
Seat 4: the_wickstar folded before Flop
Seat 5: Bo.Susik folded before Flop
Seat 6: SOSSSSS collected ($0.21)
Seat 7: SametsPickUp (button) folded before Flop (didn't bet)
Seat 9: Vit94nit (small blind) folded before Flop


*********** # 196 **************
PokerStars Hand #169799518928:  Hold'em No Limit ($0.01/$0.02 USD) - 20=
17/05/01 19:23:21 CUST [2017/05/01 5:23:21 ET]
Table 'Chandra' 9-max Seat #1 is the button
Seat 1: SOSSSSS ($2.14 in chips)=20
Seat 2: fomik33 ($2.01 in chips)=20
Seat 3: izy cykerman ($1.81 in chips)=20
Seat 4: And7888 ($0.83 in chips)=20
Seat 5: hardcoreMD ($2 in chips)=20
Seat 6: xth17 ($0.98 in chips)=20
Seat 7: Yafets ($1.64 in chips)=20
Seat 8: seemore96 ($1.96 in chips)=20
Seat 9: the_wickstar ($0.79 in chips)=20
fomik33: posts small blind $0.01
izy cykerman: posts big blind $0.02
*** HOLE CARDS ***
Dealt to the_wickstar [Ks 8s]
And7888: folds=20
hardcoreMD: folds=20
xth17: calls $0.02
Yafets: folds=20
seemore96 has timed out
seemore96: folds=20
the_wickstar: folds=20
SOSSSSS: calls $0.02
fomik33: folds=20
izy cykerman: checks=20
*** FLOP *** [9d Kd Th]
izy cykerman: checks=20
xth17: checks=20
SOSSSSS: checks=20
*** TURN *** [9d Kd Th] [3c]
izy cykerman: checks=20
xth17: checks=20
SOSSSSS: checks=20
*** RIVER *** [9d Kd Th 3c] [8d]
izy cykerman: checks=20
xth17: checks=20
SOSSSSS: checks=20
*** SHOW DOWN ***
izy cykerman: shows [6h 4d] (high card King)
xth17: shows [2d 2c] (a pair of Deuces)
SOSSSSS: shows [7s 7h] (a pair of Sevens)
SOSSSSS collected $0.07 from pot
*** SUMMARY ***
Total pot $0.07 | Rake $0=20
Board [9d Kd Th 3c 8d]
Seat 1: SOSSSSS (button) showed [7s 7h] and won ($0.07) with a pair of =
Sevens
Seat 2: fomik33 (small blind) folded before Flop
Seat 3: izy cykerman (big blind) showed [6h 4d] and lost with high card=
 King
Seat 4: And7888 folded before Flop (didn't bet)
Seat 5: hardcoreMD folded before Flop (didn't bet)
Seat 6: xth17 showed [2d 2c] and lost with a pair of Deuces
Seat 7: Yafets folded before Flop (didn't bet)
Seat 8: seemore96 folded before Flop (didn't bet)
Seat 9: the_wickstar folded before Flop (didn't bet)


*********** # 197 **************
PokerStars Hand #169799507194:  Hold'em No Limit ($0.01/$0.02 USD) - 20=
17/05/01 19:22:52 CUST [2017/05/01 5:22:52 ET]
Table 'Andraimon II' 9-max Seat #6 is the button
Seat 1: suzuki362 ($1.92 in chips)=20
Seat 3: ChkRaizDaBTN ($1.87 in chips)=20
Seat 4: the_wickstar ($0.70 in chips)=20
Seat 5: Bo.Susik ($1.47 in chips)=20
Seat 6: SOSSSSS ($2 in chips)=20
Seat 7: SametsPickUp ($2.08 in chips)=20
Seat 9: Vit94nit ($2 in chips)=20
SametsPickUp: posts small blind $0.01
Vit94nit: posts big blind $0.02
*** HOLE CARDS ***
Dealt to the_wickstar [Td Ac]
suzuki362: calls $0.02
ChkRaizDaBTN: folds=20
the_wickstar: raises $0.04 to $0.06
Bo.Susik: folds=20
SOSSSSS: folds=20
SametsPickUp: folds=20
Vit94nit: calls $0.04
suzuki362: calls $0.04
*** FLOP *** [7h 9d 7s]
Vit94nit: checks=20
suzuki362: checks=20
the_wickstar: checks=20
*** TURN *** [7h 9d 7s] [8h]
Vit94nit: checks=20
suzuki362: checks=20
the_wickstar: bets $0.12
Vit94nit: folds=20
suzuki362: folds=20
Uncalled bet ($0.12) returned to the_wickstar
the_wickstar collected $0.18 from pot
*** SUMMARY ***
Total pot $0.19 | Rake $0.01=20
Board [7h 9d 7s 8h]
Seat 1: suzuki362 folded on the Turn
Seat 3: ChkRaizDaBTN folded before Flop (didn't bet)
Seat 4: the_wickstar collected ($0.18)
Seat 5: Bo.Susik folded before Flop (didn't bet)
Seat 6: SOSSSSS (button) folded before Flop (didn't bet)
Seat 7: SametsPickUp (small blind) folded before Flop
Seat 9: Vit94nit (big blind) folded on the Turn


*********** # 198 **************
PokerStars Hand #169799492474:  Hold'em No Limit ($0.01/$0.02 USD) - 20=
17/05/01 19:22:15 CUST [2017/05/01 5:22:15 ET]
Table 'Chandra' 9-max Seat #9 is the button
Seat 1: SOSSSSS ($2.33 in chips)=20
Seat 2: fomik33 ($2.03 in chips)=20
Seat 3: izy cykerman ($1.81 in chips)=20
Seat 4: And7888 ($0.83 in chips)=20
Seat 5: hardcoreMD ($2 in chips)=20
Seat 6: xth17 ($0.98 in chips)=20
Seat 7: Yafets ($1.43 in chips)=20
Seat 8: seemore96 ($1.96 in chips)=20
Seat 9: the_wickstar ($0.79 in chips)=20
SOSSSSS: posts small blind $0.01
fomik33: posts big blind $0.02
*** HOLE CARDS ***
Dealt to the_wickstar [6h As]
izy cykerman: folds=20
And7888: folds=20
hardcoreMD: folds=20
xth17: folds=20
Yafets: raises $0.04 to $0.06
seemore96: folds=20
the_wickstar: folds=20
SOSSSSS: raises $0.13 to $0.19
fomik33: folds=20
Yafets: raises $0.21 to $0.40
SOSSSSS: folds=20
Uncalled bet ($0.21) returned to Yafets
Yafets collected $0.40 from pot
Yafets: doesn't show hand=20
*** SUMMARY ***
Total pot $0.40 | Rake $0=20
Seat 1: SOSSSSS (small blind) folded before Flop
Seat 2: fomik33 (big blind) folded before Flop
Seat 3: izy cykerman folded before Flop (didn't bet)
Seat 4: And7888 folded before Flop (didn't bet)
Seat 5: hardcoreMD folded before Flop (didn't bet)
Seat 6: xth17 folded before Flop (didn't bet)
Seat 7: Yafets collected ($0.40)
Seat 8: seemore96 folded before Flop (didn't bet)
Seat 9: the_wickstar (button) folded before Flop (didn't bet)


*********** # 199 **************
PokerStars Hand #169799481141:  Hold'em No Limit ($0.01/$0.02 USD) - 20=
17/05/01 19:21:47 CUST [2017/05/01 5:21:47 ET]
Table 'Andraimon II' 9-max Seat #5 is the button
Seat 1: suzuki362 ($1.92 in chips)=20
Seat 3: ChkRaizDaBTN ($1.87 in chips)=20
Seat 4: the_wickstar ($0.76 in chips)=20
Seat 5: Bo.Susik ($1.47 in chips)=20
Seat 6: SOSSSSS ($2 in chips)=20
Seat 7: SametsPickUp ($2 in chips)=20
Seat 9: Vit94nit ($2 in chips)=20
SOSSSSS: posts small blind $0.01
SametsPickUp: posts big blind $0.02
*** HOLE CARDS ***
Dealt to the_wickstar [Js Tc]
Vit94nit: folds=20
kafa72 is disconnected=20
suzuki362: folds=20
ChkRaizDaBTN: folds=20
the_wickstar: calls $0.02
Bo.Susik: folds=20
SOSSSSS: calls $0.01
SametsPickUp: checks=20
*** FLOP *** [6h 9d 5s]
SOSSSSS: checks=20
SametsPickUp: checks=20
the_wickstar: bets $0.04
SOSSSSS: folds=20
SametsPickUp: calls $0.04
*** TURN *** [6h 9d 5s] [7c]
SametsPickUp: bets $0.10
the_wickstar: folds=20
Uncalled bet ($0.10) returned to SametsPickUp
SametsPickUp collected $0.14 from pot
SametsPickUp: doesn't show hand=20
*** SUMMARY ***
Total pot $0.14 | Rake $0=20
Board [6h 9d 5s 7c]
Seat 1: suzuki362 folded before Flop (didn't bet)
Seat 3: ChkRaizDaBTN folded before Flop (didn't bet)
Seat 4: the_wickstar folded on the Turn
Seat 5: Bo.Susik (button) folded before Flop (didn't bet)
Seat 6: SOSSSSS (small blind) folded on the Flop
Seat 7: SametsPickUp (big blind) collected ($0.14)
Seat 9: Vit94nit folded before Flop (didn't bet)


*********** # 200 **************
PokerStars Hand #169799454672:  Hold'em No Limit ($0.01/$0.02 USD) - 20=
17/05/01 19:20:41 CUST [2017/05/01 5:20:41 ET]
Table 'Andraimon II' 9-max Seat #4 is the button
Seat 1: suzuki362 ($1.92 in chips)=20
Seat 3: ChkRaizDaBTN ($1.99 in chips)=20
Seat 4: the_wickstar ($0.76 in chips)=20
Seat 5: Bo.Susik ($1.34 in chips)=20
Seat 6: SOSSSSS ($2 in chips)=20
Seat 7: boogiehoss ($2 in chips)=20
Seat 8: kafa72 ($2.12 in chips)=20
Seat 9: Vit94nit ($2 in chips)=20
Bo.Susik: posts small blind $0.01
SOSSSSS: posts big blind $0.02
*** HOLE CARDS ***
Dealt to the_wickstar [8s 5d]
boogiehoss: folds=20
boogiehoss leaves the table
sekcboy is disconnected=20
kafa72: folds=20
Vit94nit: folds=20
suzuki362: folds=20
SametsPickUp joins the table at seat #7=20
ChkRaizDaBTN: raises $0.04 to $0.06
the_wickstar: folds=20
Bo.Susik: calls $0.05
SOSSSSS: folds=20
*** FLOP *** [Tc Kd 4s]
Bo.Susik: checks=20
ChkRaizDaBTN: bets $0.06
Bo.Susik: calls $0.06
*** TURN *** [Tc Kd 4s] [Ts]
Bo.Susik: bets $0.13
ChkRaizDaBTN: folds=20
Uncalled bet ($0.13) returned to Bo.Susik
Bo.Susik collected $0.25 from pot
Bo.Susik: doesn't show hand=20
*** SUMMARY ***
Total pot $0.26 | Rake $0.01=20
Board [Tc Kd 4s Ts]
Seat 1: suzuki362 folded before Flop (didn't bet)
Seat 3: ChkRaizDaBTN folded on the Turn
Seat 4: the_wickstar (button) folded before Flop (didn't bet)
Seat 5: Bo.Susik (small blind) collected ($0.25)
Seat 6: SOSSSSS (big blind) folded before Flop
Seat 7: boogiehoss folded before Flop (didn't bet)
Seat 8: kafa72 folded before Flop (didn't bet)
Seat 9: Vit94nit folded before Flop (didn't bet)



If you have any questions, please contact us at "PokerStars Support" <s=
upport@pokerstars.com>


