Delivered-To: sherhan.wicky@gmail.com
Received: by 10.79.136.132 with SMTP id k126csp752066ivd;
        Fri, 5 May 2017 20:33:52 -0700 (PDT)
X-Received: by 10.80.135.214 with SMTP id 22mr7985437edz.124.1494041632410;
        Fri, 05 May 2017 20:33:52 -0700 (PDT)
Return-Path: <support@pokerstars.com>
Received: from mx13.pokerstars.eu (mx13.pokerstars.eu. [77.87.179.125])
        by mx.google.com with ESMTPS id f13si5521060ede.120.2017.05.05.20.33.51
        for <sherhan.wicky@gmail.com>
        (version=TLS1_2 cipher=ECDHE-RSA-AES128-GCM-SHA256 bits=128/128);
        Fri, 05 May 2017 20:33:52 -0700 (PDT)
Received-SPF: pass (google.com: domain of support@pokerstars.com designates 77.87.179.125 as permitted sender) client-ip=77.87.179.125;
Authentication-Results: mx.google.com;
       dkim=pass (test mode) header.i=@pokerstars.com;
       spf=pass (google.com: domain of support@pokerstars.com designates 77.87.179.125 as permitted sender) smtp.mailfrom=support@pokerstars.com;
       dmarc=pass (p=NONE sp=NONE dis=NONE) header.from=pokerstars.com
Received: by mx13.pokerstars.eu (mailer, from userid 4004)
	id 3BAC21400D27; Fri,  5 May 2017 23:33:51 -0400 (EDT)
DKIM-Signature: v=1; a=rsa-sha1; c=relaxed; d=pokerstars.com; h=date
	:from:to:subject:message-id:mime-version:content-type
	:content-transfer-encoding; s=s1024; bh=fqOWEJ5FZmKGv6LDGE3fpOyY
	NlQ=; b=KJXATu/Ft23i7+cn48WiGwNNC7ID8JRnzcDxUyQq4OSRUpCJm+k/OTrM
	V8j/nff4Edxb/mx8byrQBXJYwzhfcx/79/kE24Yl5j3xM53/5SBcqTzSA0Dtg2Nm
	INMp/meVjNJt1oUP8alIAotHXMBcAcvGmUvZe//e2uH4sYsbhm8=
X-PS-ID: c2hlcmhhbi53aWNreUBnbWFpbC5jb20=
Received: from pokerstars.com (unknown [192.168.8.81])
	by mx13.pokerstars.eu (mailer) with SMTP id 211061400D3F
	for <sherhan.wicky@gmail.com>; Fri,  5 May 2017 23:33:51 -0400 (EDT)
Date: Fri, 5 May 2017 23:33:51 -0400
From: "PokerStars Support" <support@pokerstars.com>
To: sherhan.wicky@gmail.com
Subject: PokerStars Hand History Request - last 1 day of play
Message-Id: <590D441F.B89F0079B608A@pokerstars.com>
MIME-Version: 1.0
Content-Type: text/plain;
 charset="windows-1252"
Content-Transfer-Encoding: quoted-printable


Transcript for last 1 day of play requested by the_wickstar (sherhan.wi=
cky@gmail.com)

*********** # 1 **************
PokerStars Hand #170016604589:  Hold'em No Limit ($0.01/$0.02 USD) - 20=
17/05/06 13:32:39 CUST [2017/05/05 23:32:39 ET]
Table 'Wodan' 9-max Seat #6 is the button
Seat 1: H1JackH1gh ($2 in chips)=20
Seat 2: alonwu ($1.91 in chips)=20
Seat 3: StarsEyeDee ($2.70 in chips)=20
Seat 4: Lanesra_90 ($2.21 in chips)=20
Seat 5: Luks_Jr ($2.15 in chips)=20
Seat 6: 1Asthma1 ($2 in chips)=20
Seat 7: the_wickstar ($1.22 in chips)=20
Seat 8: Luigi507 ($2.12 in chips)=20
the_wickstar: posts small blind $0.01
Luigi507: posts big blind $0.02
*** HOLE CARDS ***
Dealt to the_wickstar [Ac Js]
H1JackH1gh: folds=20
alonwu: folds=20
StarsEyeDee: folds=20
Lanesra_90: folds=20
Luks_Jr: raises $0.04 to $0.06
1Asthma1: folds=20
the_wickstar: folds=20
Luigi507: calls $0.04
*** FLOP *** [Kd Qh 4c]
the_wickstar leaves the table
Luigi507: checks=20
Luks_Jr: bets $0.07
Luigi507: folds=20
Uncalled bet ($0.07) returned to Luks_Jr
Luks_Jr collected $0.13 from pot
Luks_Jr: doesn't show hand=20
*** SUMMARY ***
Total pot $0.13 | Rake $0=20
Board [Kd Qh 4c]
Seat 1: H1JackH1gh folded before Flop (didn't bet)
Seat 2: alonwu folded before Flop (didn't bet)
Seat 3: StarsEyeDee folded before Flop (didn't bet)
Seat 4: Lanesra_90 folded before Flop (didn't bet)
Seat 5: Luks_Jr collected ($0.13)
Seat 6: 1Asthma1 (button) folded before Flop (didn't bet)
Seat 7: the_wickstar (small blind) folded before Flop
Seat 8: Luigi507 (big blind) folded on the Flop


*********** # 2 **************
PokerStars Hand #170016590167:  Hold'em No Limit ($0.01/$0.02 USD) - 20=
17/05/06 13:31:55 CUST [2017/05/05 23:31:55 ET]
Table 'Diotima' 9-max Seat #6 is the button
Seat 1: windy417 ($2 in chips)=20
Seat 2: yhchang ($2.14 in chips)=20
Seat 3: guga01101974 ($1.47 in chips)=20
Seat 4: H1JackH1gh ($2.75 in chips)=20
Seat 5: the_wickstar ($1.41 in chips)=20
Seat 6: vbg92 ($2.52 in chips)=20
Seat 7: BRAT PIDD ($2.42 in chips)=20
Seat 8: pdgnqn28 ($1.69 in chips)=20
Seat 9: settecba ($2.11 in chips)=20
BRAT PIDD: posts small blind $0.01
pdgnqn28: posts big blind $0.02
*** HOLE CARDS ***
Dealt to the_wickstar [5h 2d]
settecba: folds=20
windy417: folds=20
yhchang: raises $0.04 to $0.06
guga01101974: folds=20
H1JackH1gh: folds=20
the_wickstar: folds=20
vbg92: folds=20
BRAT PIDD: folds=20
the_wickstar leaves the table
pdgnqn28: folds=20
Uncalled bet ($0.04) returned to yhchang
nikolai218 joins the table at seat #5=20
yhchang collected $0.05 from pot
yhchang: doesn't show hand=20
*** SUMMARY ***
Total pot $0.05 | Rake $0=20
Seat 1: windy417 folded before Flop (didn't bet)
Seat 2: yhchang collected ($0.05)
Seat 3: guga01101974 folded before Flop (didn't bet)
Seat 4: H1JackH1gh folded before Flop (didn't bet)
Seat 5: the_wickstar folded before Flop (didn't bet)
Seat 6: vbg92 (button) folded before Flop (didn't bet)
Seat 7: BRAT PIDD (small blind) folded before Flop
Seat 8: pdgnqn28 (big blind) folded before Flop
Seat 9: settecba folded before Flop (didn't bet)


*********** # 3 **************
PokerStars Hand #170016586846:  Hold'em No Limit ($0.01/$0.02 USD) - 20=
17/05/06 13:31:45 CUST [2017/05/05 23:31:45 ET]
Table 'Wodan' 9-max Seat #5 is the button
Seat 1: H1JackH1gh ($2 in chips)=20
Seat 2: alonwu ($1.91 in chips)=20
Seat 3: StarsEyeDee ($2.70 in chips)=20
Seat 4: Lanesra_90 ($2.21 in chips)=20
Seat 5: Luks_Jr ($2.03 in chips)=20
Seat 6: 1Asthma1 ($2 in chips)=20
Seat 7: the_wickstar ($1.34 in chips)=20
Seat 8: Luigi507 ($2.12 in chips)=20
Seat 9: micksta58 ($1.92 in chips)=20
1Asthma1: posts small blind $0.01
the_wickstar: posts big blind $0.02
*** HOLE CARDS ***
Dealt to the_wickstar [Th As]
Luigi507: folds=20
micksta58: folds=20
H1JackH1gh: folds=20
alonwu: folds=20
StarsEyeDee: folds=20
Lanesra_90: folds=20
Luks_Jr: calls $0.02
1Asthma1: folds=20
the_wickstar: checks=20
*** FLOP *** [Ac 9d 5h]
micksta58 leaves the table
the_wickstar: checks=20
Luks_Jr: checks=20
*** TURN *** [Ac 9d 5h] [Ad]
the_wickstar: bets $0.02
Luks_Jr: calls $0.02
*** RIVER *** [Ac 9d 5h Ad] [8h]
the_wickstar: checks=20
Luks_Jr: bets $0.08
the_wickstar: calls $0.08
*** SHOW DOWN ***
Luks_Jr: shows [Ah Jd] (three of a kind, Aces)
the_wickstar: mucks hand=20
Luks_Jr collected $0.24 from pot
*** SUMMARY ***
Total pot $0.25 | Rake $0.01=20
Board [Ac 9d 5h Ad 8h]
Seat 1: H1JackH1gh folded before Flop (didn't bet)
Seat 2: alonwu folded before Flop (didn't bet)
Seat 3: StarsEyeDee folded before Flop (didn't bet)
Seat 4: Lanesra_90 folded before Flop (didn't bet)
Seat 5: Luks_Jr (button) showed [Ah Jd] and won ($0.24) with three of a=
 kind, Aces
Seat 6: 1Asthma1 (small blind) folded before Flop
Seat 7: the_wickstar (big blind) mucked [Th As]
Seat 8: Luigi507 folded before Flop (didn't bet)
Seat 9: micksta58 folded before Flop (didn't bet)


*********** # 4 **************
PokerStars Hand #170016580908:  Hold'em No Limit ($0.01/$0.02 USD) - 20=
17/05/06 13:31:26 CUST [2017/05/05 23:31:26 ET]
Table 'Mathilde III' 9-max Seat #8 is the button
Seat 2: agrespan ($2.57 in chips)=20
Seat 3: howata ($2.58 in chips)=20
Seat 6: hieukta ($2 in chips)=20
Seat 7: July Van7 ($3.80 in chips)=20
Seat 8: the_wickstar ($0.93 in chips)=20
Seat 9: WadRambo ($1.25 in chips)=20
WadRambo: posts small blind $0.01
Kabit510: is sitting out=20
agrespan: posts big blind $0.02
jony jd is disconnected=20
Kabit510 leaves the table
jony jd has timed out while disconnected
jony jd: is sitting out=20
*** HOLE CARDS ***
Dealt to the_wickstar [Ts 4h]
howata: raises $0.04 to $0.06
hieukta: folds=20
July Van7: folds=20
the_wickstar: folds=20
WadRambo: calls $0.05
the_wickstar leaves the table
agrespan: calls $0.04
*** FLOP *** [5d 6d 8s]
WadRambo: bets $0.18
agrespan: folds=20
howata: folds=20
Uncalled bet ($0.18) returned to WadRambo
WadRambo collected $0.17 from pot
WadRambo: doesn't show hand=20
*** SUMMARY ***
Total pot $0.18 | Rake $0.01=20
Board [5d 6d 8s]
Seat 2: agrespan (big blind) folded on the Flop
Seat 3: howata folded on the Flop
Seat 6: hieukta folded before Flop (didn't bet)
Seat 7: July Van7 folded before Flop (didn't bet)
Seat 8: the_wickstar (button) folded before Flop (didn't bet)
Seat 9: WadRambo (small blind) collected ($0.17)


*********** # 5 **************
PokerStars Hand #170016563889:  Hold'em No Limit ($0.01/$0.02 USD) - 20=
17/05/06 13:30:34 CUST [2017/05/05 23:30:34 ET]
Table 'Mathilde III' 9-max Seat #7 is the button
Seat 1: Kabit510 ($2.40 in chips)=20
Seat 2: agrespan ($2.42 in chips)=20
Seat 3: howata ($2.58 in chips)=20
Seat 6: hieukta ($2 in chips)=20
Seat 7: July Van7 ($3.80 in chips)=20
Seat 8: the_wickstar ($0.94 in chips)=20
Seat 9: WadRambo ($1.39 in chips)=20
the_wickstar: posts small blind $0.01
WadRambo: posts big blind $0.02
*** HOLE CARDS ***
Dealt to the_wickstar [Ts Qh]
Kabit510: folds=20
agrespan: raises $0.06 to $0.08
howata: folds=20
hieukta: folds=20
July Van7: folds=20
the_wickstar: folds=20
WadRambo: raises $0.06 to $0.14
agrespan: raises $2.28 to $2.42 and is all-in
WadRambo: folds=20
Uncalled bet ($2.28) returned to agrespan
agrespan collected $0.29 from pot
*** SUMMARY ***
Total pot $0.29 | Rake $0=20
Seat 1: Kabit510 folded before Flop (didn't bet)
Seat 2: agrespan collected ($0.29)
Seat 3: howata folded before Flop (didn't bet)
Seat 6: hieukta folded before Flop (didn't bet)
Seat 7: July Van7 (button) folded before Flop (didn't bet)
Seat 8: the_wickstar (small blind) folded before Flop
Seat 9: WadRambo (big blind) folded before Flop


*********** # 6 **************
PokerStars Hand #170016562597:  Hold'em No Limit ($0.01/$0.02 USD) - 20=
17/05/06 13:30:30 CUST [2017/05/05 23:30:30 ET]
Table 'Wodan' 9-max Seat #4 is the button
Seat 1: H1JackH1gh ($2 in chips)=20
Seat 2: alonwu ($1.91 in chips)=20
Seat 3: StarsEyeDee ($2.59 in chips)=20
Seat 4: Lanesra_90 ($2.21 in chips)=20
Seat 5: Luks_Jr ($2.13 in chips)=20
Seat 6: 1Asthma1 ($2 in chips)=20
Seat 7: the_wickstar ($1.34 in chips)=20
Seat 8: Luigi507 ($2.12 in chips)=20
Seat 9: micksta58 ($1.92 in chips)=20
Luks_Jr: posts small blind $0.01
1Asthma1: posts big blind $0.02
*** HOLE CARDS ***
Dealt to the_wickstar [6s 4d]
the_wickstar: folds=20
Luigi507: folds=20
micksta58: folds=20
H1JackH1gh: folds=20
alonwu: folds=20
StarsEyeDee: calls $0.02
Lanesra_90: folds=20
Luks_Jr: calls $0.01
1Asthma1: checks=20
*** FLOP *** [3d Kd Td]
Luks_Jr: bets $0.02
1Asthma1: folds=20
StarsEyeDee: calls $0.02
*** TURN *** [3d Kd Td] [4s]
Luks_Jr: checks=20
StarsEyeDee: bets $0.06
Luks_Jr: calls $0.06
*** RIVER *** [3d Kd Td 4s] [5c]
Luks_Jr: checks=20
StarsEyeDee: bets $0.21
Luks_Jr: folds=20
Uncalled bet ($0.21) returned to StarsEyeDee
StarsEyeDee collected $0.21 from pot
StarsEyeDee: doesn't show hand=20
*** SUMMARY ***
Total pot $0.22 | Rake $0.01=20
Board [3d Kd Td 4s 5c]
Seat 1: H1JackH1gh folded before Flop (didn't bet)
Seat 2: alonwu folded before Flop (didn't bet)
Seat 3: StarsEyeDee collected ($0.21)
Seat 4: Lanesra_90 (button) folded before Flop (didn't bet)
Seat 5: Luks_Jr (small blind) folded on the River
Seat 6: 1Asthma1 (big blind) folded on the Flop
Seat 7: the_wickstar folded before Flop (didn't bet)
Seat 8: Luigi507 folded before Flop (didn't bet)
Seat 9: micksta58 folded before Flop (didn't bet)


*********** # 7 **************
PokerStars Hand #170016562148:  Hold'em No Limit ($0.01/$0.02 USD) - 20=
17/05/06 13:30:29 CUST [2017/05/05 23:30:29 ET]
Table 'Diotima' 9-max Seat #5 is the button
Seat 1: windy417 ($2 in chips)=20
Seat 2: yhchang ($2.14 in chips)=20
Seat 3: guga01101974 ($1.53 in chips)=20
Seat 4: H1JackH1gh ($2.75 in chips)=20
Seat 5: the_wickstar ($1.47 in chips)=20
Seat 6: vbg92 ($2.53 in chips)=20
Seat 7: BRAT PIDD ($2 in chips)=20
Seat 8: pdgnqn28 ($2.01 in chips)=20
Seat 9: settecba ($2.11 in chips)=20
vbg92: posts small blind $0.01
BRAT PIDD: posts big blind $0.02
*** HOLE CARDS ***
Dealt to the_wickstar [8d 9d]
pdgnqn28: raises $0.04 to $0.06
settecba: folds=20
windy417: folds=20
yhchang: folds=20
guga01101974: calls $0.06
H1JackH1gh: folds=20
the_wickstar: calls $0.06
vbg92: folds=20
BRAT PIDD: raises $0.26 to $0.32
pdgnqn28: calls $0.26
guga01101974: folds=20
the_wickstar: folds=20
*** FLOP *** [4s 2s 6c]
BRAT PIDD: bets $0.39
pdgnqn28: folds=20
Uncalled bet ($0.39) returned to BRAT PIDD
BRAT PIDD collected $0.74 from pot
BRAT PIDD: doesn't show hand=20
*** SUMMARY ***
Total pot $0.77 | Rake $0.03=20
Board [4s 2s 6c]
Seat 1: windy417 folded before Flop (didn't bet)
Seat 2: yhchang folded before Flop (didn't bet)
Seat 3: guga01101974 folded before Flop
Seat 4: H1JackH1gh folded before Flop (didn't bet)
Seat 5: the_wickstar (button) folded before Flop
Seat 6: vbg92 (small blind) folded before Flop
Seat 7: BRAT PIDD (big blind) collected ($0.74)
Seat 8: pdgnqn28 folded on the Flop
Seat 9: settecba folded before Flop (didn't bet)


*********** # 8 **************
PokerStars Hand #170016546424:  Hold'em No Limit ($0.01/$0.02 USD) - 20=
17/05/06 13:30:00 CUST [2017/05/05 23:30:00 ET]
Table 'Mathilde III' 9-max Seat #6 is the button
Seat 1: Kabit510 ($2.40 in chips)=20
Seat 2: agrespan ($2.39 in chips)=20
Seat 3: howata ($2.58 in chips)=20
Seat 6: hieukta ($2 in chips)=20
Seat 7: July Van7 ($3.81 in chips)=20
Seat 8: the_wickstar ($0.96 in chips)=20
Seat 9: WadRambo ($1.39 in chips)=20
July Van7: posts small blind $0.01
the_wickstar: posts big blind $0.02
*** HOLE CARDS ***
Dealt to the_wickstar [6h Qh]
WadRambo: folds=20
Kabit510: folds=20
agrespan: raises $0.04 to $0.06
howata: folds=20
hieukta: folds=20
July Van7: folds=20
the_wickstar: folds=20
Uncalled bet ($0.04) returned to agrespan
agrespan collected $0.05 from pot
*** SUMMARY ***
Total pot $0.05 | Rake $0=20
Seat 1: Kabit510 folded before Flop (didn't bet)
Seat 2: agrespan collected ($0.05)
Seat 3: howata folded before Flop (didn't bet)
Seat 6: hieukta (button) folded before Flop (didn't bet)
Seat 7: July Van7 (small blind) folded before Flop
Seat 8: the_wickstar (big blind) folded before Flop
Seat 9: WadRambo folded before Flop (didn't bet)


*********** # 9 **************
PokerStars Hand #170016535905:  Hold'em No Limit ($0.01/$0.02 USD) - 20=
17/05/06 13:29:28 CUST [2017/05/05 23:29:28 ET]
Table 'Wodan' 9-max Seat #3 is the button
Seat 1: H1JackH1gh ($2 in chips)=20
Seat 2: alonwu ($1.91 in chips)=20
Seat 3: StarsEyeDee ($2.71 in chips)=20
Seat 4: Lanesra_90 ($2.22 in chips)=20
Seat 5: Luks_Jr ($1.95 in chips)=20
Seat 6: 1Asthma1 ($2 in chips)=20
Seat 7: the_wickstar ($1.34 in chips)=20
Seat 8: Luigi507 ($2.12 in chips)=20
Seat 9: micksta58 ($1.92 in chips)=20
Lanesra_90: posts small blind $0.01
Luks_Jr: posts big blind $0.02
*** HOLE CARDS ***
Dealt to the_wickstar [2c 4c]
1Asthma1: folds=20
the_wickstar: folds=20
Luigi507: folds=20
micksta58: folds=20
H1JackH1gh: raises $0.04 to $0.06
alonwu: folds=20
StarsEyeDee: raises $0.04 to $0.10
Lanesra_90: folds=20
Luks_Jr: calls $0.08
H1JackH1gh: folds=20
*** FLOP *** [Ad Ah 2d]
Luks_Jr: bets $0.02
StarsEyeDee: calls $0.02
*** TURN *** [Ad Ah 2d] [4d]
Luks_Jr: checks=20
StarsEyeDee: checks=20
*** RIVER *** [Ad Ah 2d 4d] [Td]
Luks_Jr: bets $0.15
StarsEyeDee: folds=20
Uncalled bet ($0.15) returned to Luks_Jr
Luks_Jr collected $0.30 from pot
Luks_Jr: doesn't show hand=20
*** SUMMARY ***
Total pot $0.31 | Rake $0.01=20
Board [Ad Ah 2d 4d Td]
Seat 1: H1JackH1gh folded before Flop
Seat 2: alonwu folded before Flop (didn't bet)
Seat 3: StarsEyeDee (button) folded on the River
Seat 4: Lanesra_90 (small blind) folded before Flop
Seat 5: Luks_Jr (big blind) collected ($0.30)
Seat 6: 1Asthma1 folded before Flop (didn't bet)
Seat 7: the_wickstar folded before Flop (didn't bet)
Seat 8: Luigi507 folded before Flop (didn't bet)
Seat 9: micksta58 folded before Flop (didn't bet)


*********** # 10 **************
PokerStars Hand #170016533777:  Hold'em No Limit ($0.01/$0.02 USD) - 20=
17/05/06 13:29:21 CUST [2017/05/05 23:29:21 ET]
Table 'Diotima' 9-max Seat #4 is the button
Seat 1: windy417 ($2 in chips)=20
Seat 2: yhchang ($2 in chips)=20
Seat 3: guga01101974 ($1.59 in chips)=20
Seat 4: H1JackH1gh ($2.81 in chips)=20
Seat 5: the_wickstar ($1.48 in chips)=20
Seat 6: vbg92 ($2.55 in chips)=20
Seat 8: pdgnqn28 ($2.01 in chips)=20
Seat 9: settecba ($2.11 in chips)=20
the_wickstar: posts small blind $0.01
vbg92: posts big blind $0.02
BRAT PIDD: sits out=20
*** HOLE CARDS ***
Dealt to the_wickstar [5s 3d]
pdgnqn28: folds=20
settecba: folds=20
windy417: folds=20
yhchang: raises $0.04 to $0.06
guga01101974: calls $0.06
H1JackH1gh: calls $0.06
the_wickstar: folds=20
vbg92: folds=20
*** FLOP *** [Ac Td 9c]
yhchang: bets $0.14
guga01101974: folds=20
H1JackH1gh: folds=20
Uncalled bet ($0.14) returned to yhchang
yhchang collected $0.20 from pot
yhchang: doesn't show hand=20
*** SUMMARY ***
Total pot $0.21 | Rake $0.01=20
Board [Ac Td 9c]
Seat 1: windy417 folded before Flop (didn't bet)
Seat 2: yhchang collected ($0.20)
Seat 3: guga01101974 folded on the Flop
Seat 4: H1JackH1gh (button) folded on the Flop
Seat 5: the_wickstar (small blind) folded before Flop
Seat 6: vbg92 (big blind) folded before Flop
Seat 8: pdgnqn28 folded before Flop (didn't bet)
Seat 9: settecba folded before Flop (didn't bet)


*********** # 11 **************
PokerStars Hand #170016532673:  Hold'em No Limit ($0.01/$0.02 USD) - 20=
17/05/06 13:29:18 CUST [2017/05/05 23:29:18 ET]
Table 'Mathilde III' 9-max Seat #3 is the button
Seat 1: Kabit510 ($2.40 in chips)=20
Seat 2: agrespan ($2.39 in chips)=20
Seat 3: howata ($2.58 in chips)=20
Seat 6: hieukta ($2 in chips)=20
Seat 7: July Van7 ($3.83 in chips)=20
Seat 8: the_wickstar ($0.96 in chips)=20
Seat 9: WadRambo ($1.36 in chips)=20
hieukta: posts small blind $0.01
July Van7: posts big blind $0.02
*** HOLE CARDS ***
Dealt to the_wickstar [Qd 2h]
the_wickstar: folds=20
WadRambo: raises $0.04 to $0.06
Kabit510: folds=20
agrespan: folds=20
howata: folds=20
hieukta: folds=20
July Van7: folds=20
Uncalled bet ($0.04) returned to WadRambo
WadRambo collected $0.05 from pot
WadRambo: doesn't show hand=20
*** SUMMARY ***
Total pot $0.05 | Rake $0=20
Seat 1: Kabit510 folded before Flop (didn't bet)
Seat 2: agrespan folded before Flop (didn't bet)
Seat 3: howata (button) folded before Flop (didn't bet)
Seat 6: hieukta (small blind) folded before Flop
Seat 7: July Van7 (big blind) folded before Flop
Seat 8: the_wickstar folded before Flop (didn't bet)
Seat 9: WadRambo collected ($0.05)


*********** # 12 **************
PokerStars Hand #170016519401:  Hold'em No Limit ($0.01/$0.02 USD) - 20=
17/05/06 13:28:38 CUST [2017/05/05 23:28:38 ET]
Table 'Mathilde III' 9-max Seat #2 is the button
Seat 1: Kabit510 ($2.40 in chips)=20
Seat 2: agrespan ($2.39 in chips)=20
Seat 3: howata ($2.59 in chips)=20
Seat 6: hieukta ($2 in chips)=20
Seat 7: July Van7 ($3.83 in chips)=20
Seat 8: the_wickstar ($0.96 in chips)=20
Seat 9: WadRambo ($1.33 in chips)=20
howata: posts small blind $0.01
hieukta: posts big blind $0.02
*** HOLE CARDS ***
Dealt to the_wickstar [Qc 7h]
July Van7: folds=20
the_wickstar: folds=20
WadRambo: raises $0.06 to $0.08
Kabit510: folds=20
agrespan: folds=20
howata: folds=20
hieukta: folds=20
Uncalled bet ($0.06) returned to WadRambo
WadRambo collected $0.05 from pot
WadRambo: doesn't show hand=20
*** SUMMARY ***
Total pot $0.05 | Rake $0=20
Seat 1: Kabit510 folded before Flop (didn't bet)
Seat 2: agrespan (button) folded before Flop (didn't bet)
Seat 3: howata (small blind) folded before Flop
Seat 6: hieukta (big blind) folded before Flop
Seat 7: July Van7 folded before Flop (didn't bet)
Seat 8: the_wickstar folded before Flop (didn't bet)
Seat 9: WadRambo collected ($0.05)


*********** # 13 **************
PokerStars Hand #170016512345:  Hold'em No Limit ($0.01/$0.02 USD) - 20=
17/05/06 13:28:16 CUST [2017/05/05 23:28:16 ET]
Table 'Wodan' 9-max Seat #2 is the button
Seat 1: H1JackH1gh ($2 in chips)=20
Seat 2: alonwu ($1.91 in chips)=20
Seat 3: StarsEyeDee ($2.72 in chips)=20
Seat 4: Lanesra_90 ($2.24 in chips)=20
Seat 5: Luks_Jr ($1.95 in chips)=20
Seat 6: 1Asthma1 ($2.18 in chips)=20
Seat 7: the_wickstar ($0.62 in chips)=20
Seat 8: Luigi507 ($2.12 in chips)=20
Seat 9: micksta58 ($2.04 in chips)=20
StarsEyeDee: posts small blind $0.01
Lanesra_90: posts big blind $0.02
*** HOLE CARDS ***
Dealt to the_wickstar [Kc Ks]
Luks_Jr: folds=20
1Asthma1: raises $0.04 to $0.06
the_wickstar: raises $0.06 to $0.12
Luigi507: folds=20
micksta58: calls $0.12
H1JackH1gh: folds=20
alonwu: folds=20
StarsEyeDee: folds=20
Lanesra_90: folds=20
1Asthma1: raises $2.06 to $2.18 and is all-in
the_wickstar: calls $0.50 and is all-in
micksta58: folds=20
Uncalled bet ($1.56) returned to 1Asthma1
*** FLOP *** [3h 5d Qd]
*** TURN *** [3h 5d Qd] [Td]
*** RIVER *** [3h 5d Qd Td] [7h]
*** SHOW DOWN ***
1Asthma1: shows [Ac Kd] (high card Ace)
the_wickstar: shows [Kc Ks] (a pair of Kings)
the_wickstar collected $1.34 from pot
*** SUMMARY ***
Total pot $1.39 | Rake $0.05=20
Board [3h 5d Qd Td 7h]
Seat 1: H1JackH1gh folded before Flop (didn't bet)
Seat 2: alonwu (button) folded before Flop (didn't bet)
Seat 3: StarsEyeDee (small blind) folded before Flop
Seat 4: Lanesra_90 (big blind) folded before Flop
Seat 5: Luks_Jr folded before Flop (didn't bet)
Seat 6: 1Asthma1 showed [Ac Kd] and lost with high card Ace
Seat 7: the_wickstar showed [Kc Ks] and won ($1.34) with a pair of Kings
Seat 8: Luigi507 folded before Flop (didn't bet)
Seat 9: micksta58 folded before Flop


*********** # 14 **************
PokerStars Hand #170016505964:  Hold'em No Limit ($0.01/$0.02 USD) - 20=
17/05/06 13:27:59 CUST [2017/05/05 23:27:59 ET]
Table 'Diotima' 9-max Seat #3 is the button
Seat 1: windy417 ($2 in chips)=20
Seat 2: yhchang ($2 in chips)=20
Seat 3: guga01101974 ($1.59 in chips)=20
Seat 4: H1JackH1gh ($2.82 in chips)=20
Seat 5: the_wickstar ($1.50 in chips)=20
Seat 6: vbg92 ($2.37 in chips)=20
Seat 8: pdgnqn28 ($2.01 in chips)=20
Seat 9: settecba ($2.11 in chips)=20
H1JackH1gh: posts small blind $0.01
the_wickstar: posts big blind $0.02
BRAT PIDD: sits out=20
*** HOLE CARDS ***
Dealt to the_wickstar [4c 8d]
vbg92: raises $0.04 to $0.06
pdgnqn28: folds=20
settecba: folds=20
windy417: calls $0.06
yhchang: folds=20
guga01101974: folds=20
H1JackH1gh: folds=20
the_wickstar: folds=20
*** FLOP *** [6d 3s Js]
vbg92: checks=20
windy417: checks=20
*** TURN *** [6d 3s Js] [9s]
vbg92: checks=20
windy417: bets $0.10
vbg92: calls $0.10
*** RIVER *** [6d 3s Js 9s] [2s]
vbg92: bets $0.22
windy417: folds=20
Uncalled bet ($0.22) returned to vbg92
vbg92 collected $0.34 from pot
*** SUMMARY ***
Total pot $0.35 | Rake $0.01=20
Board [6d 3s Js 9s 2s]
Seat 1: windy417 folded on the River
Seat 2: yhchang folded before Flop (didn't bet)
Seat 3: guga01101974 (button) folded before Flop (didn't bet)
Seat 4: H1JackH1gh (small blind) folded before Flop
Seat 5: the_wickstar (big blind) folded before Flop
Seat 6: vbg92 collected ($0.34)
Seat 8: pdgnqn28 folded before Flop (didn't bet)
Seat 9: settecba folded before Flop (didn't bet)


*********** # 15 **************
PokerStars Hand #170016499744:  Hold'em No Limit ($0.01/$0.02 USD) - 20=
17/05/06 13:27:40 CUST [2017/05/05 23:27:40 ET]
Table 'Mathilde III' 9-max Seat #1 is the button
Seat 1: Kabit510 ($2.40 in chips)=20
Seat 2: agrespan ($2.37 in chips)=20
Seat 3: howata ($2.61 in chips)=20
Seat 7: July Van7 ($3.83 in chips)=20
Seat 8: the_wickstar ($0.96 in chips)=20
Seat 9: WadRambo ($1.33 in chips)=20
agrespan: posts small blind $0.01
howata: posts big blind $0.02
hieukta: sits out=20
*** HOLE CARDS ***
Dealt to the_wickstar [8d Qh]
July Van7: folds=20
the_wickstar: folds=20
WadRambo: folds=20
Kabit510: folds=20
agrespan: calls $0.01
howata: checks=20
*** FLOP *** [6h Qs 7h]
agrespan: checks=20
howata: checks=20
*** TURN *** [6h Qs 7h] [4d]
agrespan: checks=20
howata: checks=20
*** RIVER *** [6h Qs 7h 4d] [7s]
agrespan: checks=20
howata: checks=20
*** SHOW DOWN ***
agrespan: shows [2c 6c] (two pair, Sevens and Sixes)
howata: mucks hand=20
agrespan collected $0.04 from pot
*** SUMMARY ***
Total pot $0.04 | Rake $0=20
Board [6h Qs 7h 4d 7s]
Seat 1: Kabit510 (button) folded before Flop (didn't bet)
Seat 2: agrespan (small blind) showed [2c 6c] and won ($0.04) with two =
pair, Sevens and Sixes
Seat 3: howata (big blind) mucked [2h 3s]
Seat 7: July Van7 folded before Flop (didn't bet)
Seat 8: the_wickstar folded before Flop (didn't bet)
Seat 9: WadRambo folded before Flop (didn't bet)


*********** # 16 **************
PokerStars Hand #170016492813:  Hold'em No Limit ($0.01/$0.02 USD) - 20=
17/05/06 13:27:19 CUST [2017/05/05 23:27:19 ET]
Table 'Diotima' 9-max Seat #2 is the button
Seat 1: windy417 ($2 in chips)=20
Seat 2: yhchang ($2 in chips)=20
Seat 3: guga01101974 ($1.60 in chips)=20
Seat 4: H1JackH1gh ($2.84 in chips)=20
Seat 5: the_wickstar ($1.45 in chips)=20
Seat 6: vbg92 ($2.37 in chips)=20
Seat 8: pdgnqn28 ($2.01 in chips)=20
Seat 9: settecba ($2.11 in chips)=20
guga01101974: posts small blind $0.01
H1JackH1gh: posts big blind $0.02
BRAT PIDD: sits out=20
*** HOLE CARDS ***
Dealt to the_wickstar [Th Kc]
the_wickstar: calls $0.02
vbg92: folds=20
pdgnqn28: folds=20
settecba: folds=20
windy417: folds=20
yhchang: calls $0.02
guga01101974: folds=20
H1JackH1gh: checks=20
*** FLOP *** [4d Kh Qh]
H1JackH1gh: checks=20
the_wickstar: bets $0.04
yhchang: folds=20
H1JackH1gh: folds=20
Uncalled bet ($0.04) returned to the_wickstar
the_wickstar collected $0.07 from pot
*** SUMMARY ***
Total pot $0.07 | Rake $0=20
Board [4d Kh Qh]
Seat 1: windy417 folded before Flop (didn't bet)
Seat 2: yhchang (button) folded on the Flop
Seat 3: guga01101974 (small blind) folded before Flop
Seat 4: H1JackH1gh (big blind) folded on the Flop
Seat 5: the_wickstar collected ($0.07)
Seat 6: vbg92 folded before Flop (didn't bet)
Seat 8: pdgnqn28 folded before Flop (didn't bet)
Seat 9: settecba folded before Flop (didn't bet)


*********** # 17 **************
PokerStars Hand #170016483070:  Hold'em No Limit ($0.01/$0.02 USD) - 20=
17/05/06 13:26:49 CUST [2017/05/05 23:26:49 ET]
Table 'Mathilde III' 9-max Seat #9 is the button
Seat 1: Kabit510 ($2.41 in chips)=20
Seat 2: agrespan ($2.39 in chips)=20
Seat 3: howata ($2.61 in chips)=20
Seat 7: July Van7 ($3.83 in chips)=20
Seat 8: the_wickstar ($0.93 in chips)=20
Seat 9: WadRambo ($1.33 in chips)=20
Kabit510: posts small blind $0.01
agrespan: posts big blind $0.02
*** HOLE CARDS ***
Dealt to the_wickstar [4d 4c]
howata: folds=20
July Van7: folds=20
the_wickstar: calls $0.02
WadRambo: folds=20
Kabit510: folds=20
hieukta joins the table at seat #6=20
agrespan: checks=20
*** FLOP *** [Jc 7d Ac]
agrespan: checks=20
the_wickstar: bets $0.03
agrespan: folds=20
Uncalled bet ($0.03) returned to the_wickstar
the_wickstar collected $0.05 from pot
*** SUMMARY ***
Total pot $0.05 | Rake $0=20
Board [Jc 7d Ac]
Seat 1: Kabit510 (small blind) folded before Flop
Seat 2: agrespan (big blind) folded on the Flop
Seat 3: howata folded before Flop (didn't bet)
Seat 7: July Van7 folded before Flop (didn't bet)
Seat 8: the_wickstar collected ($0.05)
Seat 9: WadRambo (button) folded before Flop (didn't bet)


*********** # 18 **************
PokerStars Hand #170016480173:  Hold'em No Limit ($0.01/$0.02 USD) - 20=
17/05/06 13:26:41 CUST [2017/05/05 23:26:41 ET]
Table 'Diotima' 9-max Seat #1 is the button
Seat 1: windy417 ($2 in chips)=20
Seat 2: yhchang ($2 in chips)=20
Seat 3: guga01101974 ($1.62 in chips)=20
Seat 4: H1JackH1gh ($2.94 in chips)=20
Seat 5: the_wickstar ($1.45 in chips)=20
Seat 6: vbg92 ($2.24 in chips)=20
Seat 8: pdgnqn28 ($2.01 in chips)=20
Seat 9: settecba ($2.11 in chips)=20
yhchang: posts small blind $0.01
guga01101974: posts big blind $0.02
BRAT PIDD: sits out=20
*** HOLE CARDS ***
Dealt to the_wickstar [Kd Qc]
H1JackH1gh: raises $0.08 to $0.10
the_wickstar: folds=20
vbg92: raises $0.20 to $0.30
pdgnqn28: folds=20
settecba: folds=20
windy417: folds=20
yhchang: folds=20
guga01101974: folds=20
H1JackH1gh: folds=20
Uncalled bet ($0.20) returned to vbg92
vbg92 collected $0.23 from pot
*** SUMMARY ***
Total pot $0.23 | Rake $0=20
Seat 1: windy417 (button) folded before Flop (didn't bet)
Seat 2: yhchang (small blind) folded before Flop
Seat 3: guga01101974 (big blind) folded before Flop
Seat 4: H1JackH1gh folded before Flop
Seat 5: the_wickstar folded before Flop (didn't bet)
Seat 6: vbg92 collected ($0.23)
Seat 8: pdgnqn28 folded before Flop (didn't bet)
Seat 9: settecba folded before Flop (didn't bet)


*********** # 19 **************
PokerStars Hand #170016468666:  Hold'em No Limit ($0.01/$0.02 USD) - 20=
17/05/06 13:26:08 CUST [2017/05/05 23:26:08 ET]
Table 'Wodan' 9-max Seat #9 is the button
Seat 1: H1JackH1gh ($2 in chips)=20
Seat 2: alonwu ($1.94 in chips)=20
Seat 3: StarsEyeDee ($2.74 in chips)=20
Seat 4: Lanesra_90 ($2.24 in chips)=20
Seat 5: Luks_Jr ($1.95 in chips)=20
Seat 6: 1Asthma1 ($2.18 in chips)=20
Seat 7: the_wickstar ($0.62 in chips)=20
Seat 8: Luigi507 ($2.12 in chips)=20
Seat 9: micksta58 ($1.98 in chips)=20
H1JackH1gh: posts small blind $0.01
alonwu: posts big blind $0.02
*** HOLE CARDS ***
Dealt to the_wickstar [8s Ac]
StarsEyeDee: folds=20
Lanesra_90: folds=20
Luks_Jr: folds=20
1Asthma1: folds=20
the_wickstar has timed out
the_wickstar: folds=20
Luigi507: folds=20
micksta58: raises $0.04 to $0.06
H1JackH1gh: folds=20
alonwu: folds=20
Uncalled bet ($0.04) returned to micksta58
micksta58 collected $0.05 from pot
micksta58: doesn't show hand=20
*** SUMMARY ***
Total pot $0.05 | Rake $0=20
Seat 1: H1JackH1gh (small blind) folded before Flop
Seat 2: alonwu (big blind) folded before Flop
Seat 3: StarsEyeDee folded before Flop (didn't bet)
Seat 4: Lanesra_90 folded before Flop (didn't bet)
Seat 5: Luks_Jr folded before Flop (didn't bet)
Seat 6: 1Asthma1 folded before Flop (didn't bet)
Seat 7: the_wickstar folded before Flop (didn't bet)
Seat 8: Luigi507 folded before Flop (didn't bet)
Seat 9: micksta58 (button) collected ($0.05)


*********** # 20 **************
PokerStars Hand #170016456972:  Hold'em No Limit ($0.01/$0.02 USD) - 20=
17/05/06 13:25:33 CUST [2017/05/05 23:25:33 ET]
Table 'Mathilde III' 9-max Seat #8 is the button
Seat 1: Kabit510 ($2.43 in chips)=20
Seat 2: agrespan ($1.98 in chips)=20
Seat 3: howata ($2.61 in chips)=20
Seat 4: jony jd ($2.06 in chips)=20
Seat 7: July Van7 ($3.83 in chips)=20
Seat 8: the_wickstar ($1.23 in chips)=20
Seat 9: WadRambo ($1.45 in chips)=20
WadRambo: posts small blind $0.01
Kabit510: posts big blind $0.02
Bicious81: sits out=20
*** HOLE CARDS ***
Dealt to the_wickstar [Th Td]
agrespan: raises $0.04 to $0.06
howata: folds=20
jony jd: folds=20
July Van7: folds=20
the_wickstar: raises $0.04 to $0.10
WadRambo: calls $0.09
Kabit510: folds=20
agrespan: calls $0.04
*** FLOP *** [8d Ks Jd]
WadRambo: checks=20
agrespan: checks=20
the_wickstar: checks=20
*** TURN *** [8d Ks Jd] [9c]
WadRambo: bets $0.02
agrespan: calls $0.02
the_wickstar: calls $0.02
*** RIVER *** [8d Ks Jd 9c] [5c]
Bicious81 leaves the table
WadRambo: checks=20
agrespan: bets $0.18
the_wickstar: calls $0.18
WadRambo: folds=20
*** SHOW DOWN ***
agrespan: shows [9d 9s] (three of a kind, Nines)
the_wickstar: mucks hand=20
agrespan collected $0.71 from pot
*** SUMMARY ***
Total pot $0.74 | Rake $0.03=20
Board [8d Ks Jd 9c 5c]
Seat 1: Kabit510 (big blind) folded before Flop
Seat 2: agrespan showed [9d 9s] and won ($0.71) with three of a kind, N=
ines
Seat 3: howata folded before Flop (didn't bet)
Seat 4: jony jd folded before Flop (didn't bet)
Seat 7: July Van7 folded before Flop (didn't bet)
Seat 8: the_wickstar (button) mucked [Th Td]
Seat 9: WadRambo (small blind) folded on the River


*********** # 21 **************
PokerStars Hand #170016453057:  Hold'em No Limit ($0.01/$0.02 USD) - 20=
17/05/06 13:25:20 CUST [2017/05/05 23:25:20 ET]
Table 'Wodan' 9-max Seat #8 is the button
Seat 1: H1JackH1gh ($2.01 in chips)=20
Seat 2: alonwu ($1.94 in chips)=20
Seat 3: StarsEyeDee ($2.71 in chips)=20
Seat 4: Lanesra_90 ($2.24 in chips)=20
Seat 5: Luks_Jr ($1.95 in chips)=20
Seat 6: 1Asthma1 ($2.18 in chips)=20
Seat 7: the_wickstar ($0.62 in chips)=20
Seat 8: Luigi507 ($2.12 in chips)=20
Seat 9: micksta58 ($1.99 in chips)=20
micksta58: posts small blind $0.01
H1JackH1gh: posts big blind $0.02
*** HOLE CARDS ***
Dealt to the_wickstar [Ks 6h]
alonwu: folds=20
StarsEyeDee: calls $0.02
Lanesra_90: folds=20
Luks_Jr: folds=20
1Asthma1: folds=20
the_wickstar: folds=20
Luigi507: folds=20
micksta58: folds=20
H1JackH1gh: checks=20
*** FLOP *** [6s Qh 7s]
H1JackH1gh: checks=20
StarsEyeDee: bets $0.06
H1JackH1gh: folds=20
Uncalled bet ($0.06) returned to StarsEyeDee
StarsEyeDee collected $0.05 from pot
StarsEyeDee: doesn't show hand=20
*** SUMMARY ***
Total pot $0.05 | Rake $0=20
Board [6s Qh 7s]
Seat 1: H1JackH1gh (big blind) folded on the Flop
Seat 2: alonwu folded before Flop (didn't bet)
Seat 3: StarsEyeDee collected ($0.05)
Seat 4: Lanesra_90 folded before Flop (didn't bet)
Seat 5: Luks_Jr folded before Flop (didn't bet)
Seat 6: 1Asthma1 folded before Flop (didn't bet)
Seat 7: the_wickstar folded before Flop (didn't bet)
Seat 8: Luigi507 (button) folded before Flop (didn't bet)
Seat 9: micksta58 (small blind) folded before Flop


*********** # 22 **************
PokerStars Hand #170016449619:  Hold'em No Limit ($0.01/$0.02 USD) - 20=
17/05/06 13:25:10 CUST [2017/05/05 23:25:10 ET]
Table 'Mathilde III' 9-max Seat #7 is the button
Seat 1: Kabit510 ($2.43 in chips)=20
Seat 2: agrespan ($1.98 in chips)=20
Seat 3: howata ($2.61 in chips)=20
Seat 4: jony jd ($2.06 in chips)=20
Seat 7: July Van7 ($3.83 in chips)=20
Seat 8: the_wickstar ($1.24 in chips)=20
Seat 9: WadRambo ($1.44 in chips)=20
the_wickstar: posts small blind $0.01
WadRambo: posts big blind $0.02
Bicious81: sits out=20
*** HOLE CARDS ***
Dealt to the_wickstar [3h Kc]
Kabit510: folds=20
agrespan: folds=20
howata: folds=20
jony jd: folds=20
July Van7: folds=20
the_wickstar: folds=20
Uncalled bet ($0.01) returned to WadRambo
WadRambo collected $0.02 from pot
WadRambo: doesn't show hand=20
*** SUMMARY ***
Total pot $0.02 | Rake $0=20
Seat 1: Kabit510 folded before Flop (didn't bet)
Seat 2: agrespan folded before Flop (didn't bet)
Seat 3: howata folded before Flop (didn't bet)
Seat 4: jony jd folded before Flop (didn't bet)
Seat 7: July Van7 (button) folded before Flop (didn't bet)
Seat 8: the_wickstar (small blind) folded before Flop
Seat 9: WadRambo (big blind) collected ($0.02)


*********** # 23 **************
PokerStars Hand #170016445967:  Hold'em No Limit ($0.01/$0.02 USD) - 20=
17/05/06 13:24:59 CUST [2017/05/05 23:24:59 ET]
Table 'Diotima' 9-max Seat #9 is the button
Seat 1: windy417 ($2 in chips)=20
Seat 2: yhchang ($2 in chips)=20
Seat 3: guga01101974 ($2.01 in chips)=20
Seat 4: H1JackH1gh ($2.94 in chips)=20
Seat 5: the_wickstar ($1.45 in chips)=20
Seat 6: vbg92 ($2.24 in chips)=20
Seat 8: pdgnqn28 ($1.62 in chips)=20
Seat 9: settecba ($2.11 in chips)=20
windy417: posts small blind $0.01
yhchang: posts big blind $0.02
BRAT PIDD: sits out=20
*** HOLE CARDS ***
Dealt to the_wickstar [6d 3s]
guga01101974: calls $0.02
H1JackH1gh: folds=20
the_wickstar: folds=20
vbg92: folds=20
pdgnqn28: raises $0.05 to $0.07
settecba: folds=20
windy417: folds=20
yhchang: folds=20
guga01101974: calls $0.05
*** FLOP *** [9c Js 5c]
guga01101974: checks=20
pdgnqn28: bets $0.10
guga01101974: calls $0.10
*** TURN *** [9c Js 5c] [8d]
guga01101974: checks=20
pdgnqn28: bets $0.22
guga01101974: calls $0.22
*** RIVER *** [9c Js 5c 8d] [2d]
guga01101974: checks=20
pdgnqn28: bets $0.46
guga01101974: folds=20
Uncalled bet ($0.46) returned to pdgnqn28
pdgnqn28 collected $0.78 from pot
*** SUMMARY ***
Total pot $0.81 | Rake $0.03=20
Board [9c Js 5c 8d 2d]
Seat 1: windy417 (small blind) folded before Flop
Seat 2: yhchang (big blind) folded before Flop
Seat 3: guga01101974 folded on the River
Seat 4: H1JackH1gh folded before Flop (didn't bet)
Seat 5: the_wickstar folded before Flop (didn't bet)
Seat 6: vbg92 folded before Flop (didn't bet)
Seat 8: pdgnqn28 collected ($0.78)
Seat 9: settecba (button) folded before Flop (didn't bet)


*********** # 24 **************
PokerStars Hand #170016442941:  Hold'em No Limit ($0.01/$0.02 USD) - 20=
17/05/06 13:24:50 CUST [2017/05/05 23:24:50 ET]
Table 'Mathilde III' 9-max Seat #4 is the button
Seat 1: Kabit510 ($2.43 in chips)=20
Seat 2: agrespan ($1.95 in chips)=20
Seat 3: howata ($2.61 in chips)=20
Seat 4: jony jd ($2.06 in chips)=20
Seat 7: July Van7 ($3.84 in chips)=20
Seat 8: the_wickstar ($1.26 in chips)=20
Bicious81 will be allowed to play after the button
July Van7: posts small blind $0.01
the_wickstar: posts big blind $0.02
*** HOLE CARDS ***
Dealt to the_wickstar [Jc 5s]
Kabit510: folds=20
agrespan: raises $0.02 to $0.04
howata: folds=20
jony jd: folds=20
July Van7: folds=20
the_wickstar: folds=20
Uncalled bet ($0.02) returned to agrespan
agrespan collected $0.05 from pot
*** SUMMARY ***
Total pot $0.05 | Rake $0=20
Seat 1: Kabit510 folded before Flop (didn't bet)
Seat 2: agrespan collected ($0.05)
Seat 3: howata folded before Flop (didn't bet)
Seat 4: jony jd (button) folded before Flop (didn't bet)
Seat 7: July Van7 (small blind) folded before Flop
Seat 8: the_wickstar (big blind) folded before Flop


*********** # 25 **************
PokerStars Hand #170016433438:  Hold'em No Limit ($0.01/$0.02 USD) - 20=
17/05/06 13:24:22 CUST [2017/05/05 23:24:22 ET]
Table 'Wodan' 9-max Seat #7 is the button
Seat 1: H1JackH1gh ($2.01 in chips)=20
Seat 2: alonwu ($2 in chips)=20
Seat 3: StarsEyeDee ($2.57 in chips)=20
Seat 4: Lanesra_90 ($2.24 in chips)=20
Seat 5: Luks_Jr ($1.95 in chips)=20
Seat 6: 1Asthma1 ($2.18 in chips)=20
Seat 7: the_wickstar ($0.68 in chips)=20
Seat 8: Luigi507 ($2.13 in chips)=20
Seat 9: micksta58 ($2.01 in chips)=20
Luigi507: posts small blind $0.01
micksta58: posts big blind $0.02
*** HOLE CARDS ***
Dealt to the_wickstar [Ah 3d]
H1JackH1gh: folds=20
alonwu: raises $0.04 to $0.06
StarsEyeDee: calls $0.06
Lanesra_90: folds=20
Luks_Jr: folds=20
1Asthma1: folds=20
the_wickstar: calls $0.06
Luigi507: folds=20
micksta58: folds=20
*** FLOP *** [3h 5c Th]
alonwu: checks=20
StarsEyeDee: bets $0.12
the_wickstar: folds=20
alonwu: folds=20
Uncalled bet ($0.12) returned to StarsEyeDee
StarsEyeDee collected $0.20 from pot
StarsEyeDee: doesn't show hand=20
*** SUMMARY ***
Total pot $0.21 | Rake $0.01=20
Board [3h 5c Th]
Seat 1: H1JackH1gh folded before Flop (didn't bet)
Seat 2: alonwu folded on the Flop
Seat 3: StarsEyeDee collected ($0.20)
Seat 4: Lanesra_90 folded before Flop (didn't bet)
Seat 5: Luks_Jr folded before Flop (didn't bet)
Seat 6: 1Asthma1 folded before Flop (didn't bet)
Seat 7: the_wickstar (button) folded on the Flop
Seat 8: Luigi507 (small blind) folded before Flop
Seat 9: micksta58 (big blind) folded before Flop


*********** # 26 **************
PokerStars Hand #170016431899:  Hold'em No Limit ($0.01/$0.02 USD) - 20=
17/05/06 13:24:17 CUST [2017/05/05 23:24:17 ET]
Table 'Diotima' 9-max Seat #8 is the button
Seat 1: windy417 ($2 in chips)=20
Seat 2: yhchang ($2 in chips)=20
Seat 3: guga01101974 ($2.01 in chips)=20
Seat 4: H1JackH1gh ($2.94 in chips)=20
Seat 5: the_wickstar ($1.42 in chips)=20
Seat 6: vbg92 ($2.24 in chips)=20
Seat 8: pdgnqn28 ($1.62 in chips)=20
Seat 9: settecba ($2.12 in chips)=20
settecba: posts small blind $0.01
windy417: posts big blind $0.02
BRAT PIDD: sits out=20
*** HOLE CARDS ***
Dealt to the_wickstar [Jh Jd]
yhchang: folds=20
guga01101974: folds=20
H1JackH1gh: folds=20
the_wickstar: raises $0.06 to $0.08
vbg92: folds=20
pdgnqn28: folds=20
settecba: folds=20
windy417: folds=20
Uncalled bet ($0.06) returned to the_wickstar
the_wickstar collected $0.05 from pot
*** SUMMARY ***
Total pot $0.05 | Rake $0=20
Seat 1: windy417 (big blind) folded before Flop
Seat 2: yhchang folded before Flop (didn't bet)
Seat 3: guga01101974 folded before Flop (didn't bet)
Seat 4: H1JackH1gh folded before Flop (didn't bet)
Seat 5: the_wickstar collected ($0.05)
Seat 6: vbg92 folded before Flop (didn't bet)
Seat 8: pdgnqn28 (button) folded before Flop (didn't bet)
Seat 9: settecba (small blind) folded before Flop


*********** # 27 **************
PokerStars Hand #170016416876:  Hold'em No Limit ($0.01/$0.02 USD) - 20=
17/05/06 13:23:32 CUST [2017/05/05 23:23:32 ET]
Table 'Mathilde III' 9-max Seat #3 is the button
Seat 1: Kabit510 ($2.43 in chips)=20
Seat 2: agrespan ($1.95 in chips)=20
Seat 3: howata ($2.02 in chips)=20
Seat 4: jony jd ($2.07 in chips)=20
Seat 7: July Van7 ($3.86 in chips)=20
Seat 8: the_wickstar ($1.26 in chips)=20
Seat 9: WadRambo ($0.61 in chips)=20
jony jd: posts small blind $0.01
July Van7: posts big blind $0.02
*** HOLE CARDS ***
Dealt to the_wickstar [2s Qh]
the_wickstar: folds=20
WadRambo: raises $0.02 to $0.04
Kabit510: folds=20
Bicious81 joins the table at seat #6=20
agrespan: folds=20
howata: raises $0.06 to $0.10
jony jd: folds=20
July Van7: folds=20
WadRambo: calls $0.06
*** FLOP *** [7h 7s Th]
WadRambo: bets $0.04
howata: raises $0.04 to $0.08
WadRambo: calls $0.04
*** TURN *** [7h 7s Th] [3c]
WadRambo: bets $0.02
howata: raises $0.03 to $0.05
WadRambo: calls $0.03
*** RIVER *** [7h 7s Th 3c] [3d]
WadRambo: checks=20
howata: bets $0.37
WadRambo: calls $0.37
*** SHOW DOWN ***
howata: shows [Td As] (two pair, Tens and Sevens)
WadRambo: mucks hand=20
howata collected $1.19 from pot
*** SUMMARY ***
Total pot $1.23 | Rake $0.04=20
Board [7h 7s Th 3c 3d]
Seat 1: Kabit510 folded before Flop (didn't bet)
Seat 2: agrespan folded before Flop (didn't bet)
Seat 3: howata (button) showed [Td As] and won ($1.19) with two pair, T=
ens and Sevens
Seat 4: jony jd (small blind) folded before Flop
Seat 7: July Van7 (big blind) folded before Flop
Seat 8: the_wickstar folded before Flop (didn't bet)
Seat 9: WadRambo mucked [Js Ah]


*********** # 28 **************
PokerStars Hand #170016414421:  Hold'em No Limit ($0.01/$0.02 USD) - 20=
17/05/06 13:23:24 CUST [2017/05/05 23:23:24 ET]
Table 'Diotima' 9-max Seat #6 is the button
Seat 1: windy417 ($2 in chips)=20
Seat 2: yhchang ($2 in chips)=20
Seat 3: guga01101974 ($2.03 in chips)=20
Seat 4: H1JackH1gh ($2.94 in chips)=20
Seat 5: the_wickstar ($1.37 in chips)=20
Seat 6: vbg92 ($2.24 in chips)=20
Seat 8: pdgnqn28 ($1.63 in chips)=20
Seat 9: settecba ($2.14 in chips)=20
BRAT PIDD will be allowed to play after the button
pdgnqn28: posts small blind $0.01
settecba: posts big blind $0.02
*** HOLE CARDS ***
Dealt to the_wickstar [Tc Ts]
windy417: folds=20
yhchang: folds=20
guga01101974: calls $0.02
H1JackH1gh: folds=20
the_wickstar: raises $0.06 to $0.08
vbg92: folds=20
pdgnqn28: folds=20
settecba: folds=20
guga01101974: folds=20
Uncalled bet ($0.06) returned to the_wickstar
the_wickstar collected $0.07 from pot
*** SUMMARY ***
Total pot $0.07 | Rake $0=20
Seat 1: windy417 folded before Flop (didn't bet)
Seat 2: yhchang folded before Flop (didn't bet)
Seat 3: guga01101974 folded before Flop
Seat 4: H1JackH1gh folded before Flop (didn't bet)
Seat 5: the_wickstar collected ($0.07)
Seat 6: vbg92 (button) folded before Flop (didn't bet)
Seat 8: pdgnqn28 (small blind) folded before Flop
Seat 9: settecba (big blind) folded before Flop


*********** # 29 **************
PokerStars Hand #170016402945:  Hold'em No Limit ($0.01/$0.02 USD) - 20=
17/05/06 13:22:50 CUST [2017/05/05 23:22:50 ET]
Table 'Wodan' 9-max Seat #6 is the button
Seat 1: H1JackH1gh ($2.09 in chips)=20
Seat 2: alonwu ($1.47 in chips)=20
Seat 3: StarsEyeDee ($2.57 in chips)=20
Seat 4: Lanesra_90 ($2.24 in chips)=20
Seat 5: Luks_Jr ($1.95 in chips)=20
Seat 6: 1Asthma1 ($2 in chips)=20
Seat 7: the_wickstar ($0.69 in chips)=20
Seat 8: Luigi507 ($2.15 in chips)=20
Seat 9: micksta58 ($2.01 in chips)=20
the_wickstar: posts small blind $0.01
Luigi507: posts big blind $0.02
*** HOLE CARDS ***
Dealt to the_wickstar [5s Kc]
micksta58: folds=20
H1JackH1gh: raises $0.06 to $0.08
alonwu: calls $0.08
StarsEyeDee: folds=20
Lanesra_90: folds=20
Luks_Jr: folds=20
1Asthma1: calls $0.08
the_wickstar: folds=20
Luigi507: folds=20
*** FLOP *** [Td 7s 2c]
H1JackH1gh: checks=20
alonwu: checks=20
1Asthma1: checks=20
*** TURN *** [Td 7s 2c] [7h]
H1JackH1gh: checks=20
alonwu: checks=20
1Asthma1: checks=20
*** RIVER *** [Td 7s 2c 7h] [Jd]
H1JackH1gh: checks=20
alonwu: checks=20
1Asthma1: checks=20
*** SHOW DOWN ***
H1JackH1gh: shows [Ad Qs] (a pair of Sevens)
alonwu: shows [5c 5d] (two pair, Sevens and Fives)
1Asthma1: shows [6d 6c] (two pair, Sevens and Sixes)
1Asthma1 collected $0.26 from pot
*** SUMMARY ***
Total pot $0.27 | Rake $0.01=20
Board [Td 7s 2c 7h Jd]
Seat 1: H1JackH1gh showed [Ad Qs] and lost with a pair of Sevens
Seat 2: alonwu showed [5c 5d] and lost with two pair, Sevens and Fives
Seat 3: StarsEyeDee folded before Flop (didn't bet)
Seat 4: Lanesra_90 folded before Flop (didn't bet)
Seat 5: Luks_Jr folded before Flop (didn't bet)
Seat 6: 1Asthma1 (button) showed [6d 6c] and won ($0.26) with two pair,=
 Sevens and Sixes
Seat 7: the_wickstar (small blind) folded before Flop
Seat 8: Luigi507 (big blind) folded before Flop
Seat 9: micksta58 folded before Flop (didn't bet)


*********** # 30 **************
PokerStars Hand #170016386909:  Hold'em No Limit ($0.01/$0.02 USD) - 20=
17/05/06 13:22:02 CUST [2017/05/05 23:22:02 ET]
Table 'Diotima' 9-max Seat #5 is the button
Seat 1: windy417 ($2 in chips)=20
Seat 2: yhchang ($2 in chips)=20
Seat 3: guga01101974 ($2.03 in chips)=20
Seat 4: H1JackH1gh ($2.94 in chips)=20
Seat 5: the_wickstar ($1.37 in chips)=20
Seat 6: vbg92 ($2.25 in chips)=20
Seat 8: pdgnqn28 ($1.65 in chips)=20
Seat 9: settecba ($2.04 in chips)=20
vbg92: posts small blind $0.01
pdgnqn28: posts big blind $0.02
*** HOLE CARDS ***
Dealt to the_wickstar [4s 6h]
settecba: raises $0.06 to $0.08
windy417: folds=20
yhchang: calls $0.08
guga01101974: folds=20
H1JackH1gh: folds=20
the_wickstar: folds=20
vbg92: folds=20
pdgnqn28: folds=20
*** FLOP *** [4h Kd Jc]
settecba: bets $0.12
yhchang: folds=20
Uncalled bet ($0.12) returned to settecba
settecba collected $0.18 from pot
settecba: doesn't show hand=20
*** SUMMARY ***
Total pot $0.19 | Rake $0.01=20
Board [4h Kd Jc]
Seat 1: windy417 folded before Flop (didn't bet)
Seat 2: yhchang folded on the Flop
Seat 3: guga01101974 folded before Flop (didn't bet)
Seat 4: H1JackH1gh folded before Flop (didn't bet)
Seat 5: the_wickstar (button) folded before Flop (didn't bet)
Seat 6: vbg92 (small blind) folded before Flop
Seat 8: pdgnqn28 (big blind) folded before Flop
Seat 9: settecba collected ($0.18)


*********** # 31 **************
PokerStars Hand #170016385890:  Hold'em No Limit ($0.01/$0.02 USD) - 20=
17/05/06 13:21:59 CUST [2017/05/05 23:21:59 ET]
Table 'Mathilde III' 9-max Seat #2 is the button
Seat 1: Kabit510 ($2.43 in chips)=20
Seat 2: agrespan ($1.97 in chips)=20
Seat 3: howata ($2.03 in chips)=20
Seat 4: jony jd ($2 in chips)=20
Seat 7: July Van7 ($3.86 in chips)=20
Seat 8: the_wickstar ($1.26 in chips)=20
Seat 9: WadRambo ($0.65 in chips)=20
howata: posts small blind $0.01
jony jd: posts big blind $0.02
*** HOLE CARDS ***
Dealt to the_wickstar [7c 3s]
July Van7: folds=20
the_wickstar: folds=20
WadRambo: calls $0.02
Kabit510: folds=20
agrespan: calls $0.02
howata: folds=20
jony jd: checks=20
*** FLOP *** [7d As Th]
jony jd: checks=20
WadRambo: checks=20
agrespan: checks=20
*** TURN *** [7d As Th] [5s]
jony jd: checks=20
WadRambo: checks=20
agrespan: checks=20
*** RIVER *** [7d As Th 5s] [Qd]
jony jd: checks=20
WadRambo: bets $0.02
agrespan: folds=20
jony jd: calls $0.02
*** SHOW DOWN ***
WadRambo: shows [2h Jh] (high card Ace)
jony jd: shows [7s Kh] (a pair of Sevens)
jony jd collected $0.11 from pot
*** SUMMARY ***
Total pot $0.11 | Rake $0=20
Board [7d As Th 5s Qd]
Seat 1: Kabit510 folded before Flop (didn't bet)
Seat 2: agrespan (button) folded on the River
Seat 3: howata (small blind) folded before Flop
Seat 4: jony jd (big blind) showed [7s Kh] and won ($0.11) with a pair =
of Sevens
Seat 7: July Van7 folded before Flop (didn't bet)
Seat 8: the_wickstar folded before Flop (didn't bet)
Seat 9: WadRambo showed [2h Jh] and lost with high card Ace


*********** # 32 **************
PokerStars Hand #170016377122:  Hold'em No Limit ($0.01/$0.02 USD) - 20=
17/05/06 13:21:33 CUST [2017/05/05 23:21:33 ET]
Table 'Mathilde III' 9-max Seat #1 is the button
Seat 1: Kabit510 ($2.43 in chips)=20
Seat 2: agrespan ($1.95 in chips)=20
Seat 3: howata ($2.05 in chips)=20
Seat 7: July Van7 ($3.86 in chips)=20
Seat 8: the_wickstar ($1.26 in chips)=20
Seat 9: WadRambo ($0.65 in chips)=20
agrespan: posts small blind $0.01
howata: posts big blind $0.02
jony jd: sits out=20
*** HOLE CARDS ***
Dealt to the_wickstar [9c 8c]
July Van7: folds=20
the_wickstar: folds=20
WadRambo: folds=20
Kabit510: folds=20
agrespan: calls $0.01
howata: checks=20
*** FLOP *** [Ah 8s Kh]
agrespan: bets $0.02
howata: folds=20
Uncalled bet ($0.02) returned to agrespan
agrespan collected $0.04 from pot
*** SUMMARY ***
Total pot $0.04 | Rake $0=20
Board [Ah 8s Kh]
Seat 1: Kabit510 (button) folded before Flop (didn't bet)
Seat 2: agrespan (small blind) collected ($0.04)
Seat 3: howata (big blind) folded on the Flop
Seat 7: July Van7 folded before Flop (didn't bet)
Seat 8: the_wickstar folded before Flop (didn't bet)
Seat 9: WadRambo folded before Flop (didn't bet)


*********** # 33 **************
PokerStars Hand #170016373235:  Hold'em No Limit ($0.01/$0.02 USD) - 20=
17/05/06 13:21:22 CUST [2017/05/05 23:21:22 ET]
Table 'Wodan' 9-max Seat #5 is the button
Seat 1: H1JackH1gh ($2.09 in chips)=20
Seat 2: alonwu ($1.71 in chips)=20
Seat 3: StarsEyeDee ($2.57 in chips)=20
Seat 4: Lanesra_90 ($2.24 in chips)=20
Seat 5: Luks_Jr ($1.95 in chips)=20
Seat 6: 1Asthma1 ($2.01 in chips)=20
Seat 7: the_wickstar ($0.46 in chips)=20
Seat 8: Luigi507 ($2.15 in chips)=20
Seat 9: micksta58 ($2.01 in chips)=20
1Asthma1: posts small blind $0.01
the_wickstar: posts big blind $0.02
*** HOLE CARDS ***
Dealt to the_wickstar [Kd Qh]
Luigi507: folds=20
micksta58: folds=20
H1JackH1gh: folds=20
alonwu: raises $0.04 to $0.06
StarsEyeDee: folds=20
Lanesra_90: folds=20
Luks_Jr: folds=20
1Asthma1: folds=20
the_wickstar: calls $0.04
*** FLOP *** [2c Ks Kh]
the_wickstar: checks=20
alonwu: bets $0.06
the_wickstar: calls $0.06
*** TURN *** [2c Ks Kh] [9d]
the_wickstar: checks=20
alonwu: bets $0.12
the_wickstar: calls $0.12
*** RIVER *** [2c Ks Kh 9d] [7c]
the_wickstar: bets $0.22 and is all-in
alonwu: folds=20
Uncalled bet ($0.22) returned to the_wickstar
the_wickstar collected $0.47 from pot
*** SUMMARY ***
Total pot $0.49 | Rake $0.02=20
Board [2c Ks Kh 9d 7c]
Seat 1: H1JackH1gh folded before Flop (didn't bet)
Seat 2: alonwu folded on the River
Seat 3: StarsEyeDee folded before Flop (didn't bet)
Seat 4: Lanesra_90 folded before Flop (didn't bet)
Seat 5: Luks_Jr (button) folded before Flop (didn't bet)
Seat 6: 1Asthma1 (small blind) folded before Flop
Seat 7: the_wickstar (big blind) collected ($0.47)
Seat 8: Luigi507 folded before Flop (didn't bet)
Seat 9: micksta58 folded before Flop (didn't bet)


*********** # 34 **************
PokerStars Hand #170016367325:  Hold'em No Limit ($0.01/$0.02 USD) - 20=
17/05/06 13:21:04 CUST [2017/05/05 23:21:04 ET]
Table 'Mathilde III' 9-max Seat #9 is the button
Seat 1: Kabit510 ($2.44 in chips)=20
Seat 2: agrespan ($1.97 in chips)=20
Seat 3: howata ($2.05 in chips)=20
Seat 6: Blackpoker65 ($3 in chips)=20
Seat 7: July Van7 ($3.86 in chips)=20
Seat 8: the_wickstar ($1.26 in chips)=20
Seat 9: WadRambo ($0.62 in chips)=20
Kabit510: posts small blind $0.01
agrespan: posts big blind $0.02
jony jd: sits out=20
*** HOLE CARDS ***
Dealt to the_wickstar [8h Jc]
howata: folds=20
Blackpoker65: folds=20
July Van7: folds=20
the_wickstar: folds=20
Blackpoker65 leaves the table
WadRambo: raises $0.60 to $0.62 and is all-in
Kabit510: folds=20
agrespan: folds=20
Uncalled bet ($0.60) returned to WadRambo
WadRambo collected $0.05 from pot
WadRambo: doesn't show hand=20
*** SUMMARY ***
Total pot $0.05 | Rake $0=20
Seat 1: Kabit510 (small blind) folded before Flop
Seat 2: agrespan (big blind) folded before Flop
Seat 3: howata folded before Flop (didn't bet)
Seat 6: Blackpoker65 folded before Flop (didn't bet)
Seat 7: July Van7 folded before Flop (didn't bet)
Seat 8: the_wickstar folded before Flop (didn't bet)
Seat 9: WadRambo (button) collected ($0.05)


*********** # 35 **************
PokerStars Hand #170016357656:  Hold'em No Limit ($0.01/$0.02 USD) - 20=
17/05/06 13:20:36 CUST [2017/05/05 23:20:36 ET]
Table 'Diotima' 9-max Seat #4 is the button
Seat 1: windy417 ($2 in chips)=20
Seat 2: yhchang ($2 in chips)=20
Seat 3: guga01101974 ($1.99 in chips)=20
Seat 4: H1JackH1gh ($2.94 in chips)=20
Seat 5: the_wickstar ($1.39 in chips)=20
Seat 6: vbg92 ($2.27 in chips)=20
Seat 8: pdgnqn28 ($1.65 in chips)=20
Seat 9: settecba ($2.04 in chips)=20
the_wickstar: posts small blind $0.01
vbg92: posts big blind $0.02
*** HOLE CARDS ***
Dealt to the_wickstar [9d 5d]
pdgnqn28: folds=20
settecba: folds=20
windy417: folds=20
yhchang: folds=20
guga01101974: calls $0.02
H1JackH1gh: folds=20
the_wickstar: calls $0.01
vbg92: checks=20
*** FLOP *** [As 6c Kh]
the_wickstar: checks=20
vbg92: checks=20
guga01101974: checks=20
*** TURN *** [As 6c Kh] [7h]
the_wickstar: checks=20
vbg92: checks=20
guga01101974: checks=20
*** RIVER *** [As 6c Kh 7h] [Jh]
the_wickstar: checks=20
vbg92: checks=20
guga01101974: checks=20
*** SHOW DOWN ***
the_wickstar: shows [9d 5d] (high card Ace)
vbg92: shows [Th 2d] (high card Ace - King+Jack+Ten kicker)
guga01101974: shows [8h Td] (high card Ace - King+Jack+Ten+Eight kicker)
guga01101974 collected $0.06 from pot
*** SUMMARY ***
Total pot $0.06 | Rake $0=20
Board [As 6c Kh 7h Jh]
Seat 1: windy417 folded before Flop (didn't bet)
Seat 2: yhchang folded before Flop (didn't bet)
Seat 3: guga01101974 showed [8h Td] and won ($0.06) with high card Ace
Seat 4: H1JackH1gh (button) folded before Flop (didn't bet)
Seat 5: the_wickstar (small blind) showed [9d 5d] and lost with high ca=
rd Ace
Seat 6: vbg92 (big blind) showed [Th 2d] and lost with high card Ace
Seat 8: pdgnqn28 folded before Flop (didn't bet)
Seat 9: settecba folded before Flop (didn't bet)


*********** # 36 **************
PokerStars Hand #170016355984:  Hold'em No Limit ($0.01/$0.02 USD) - 20=
17/05/06 13:20:31 CUST [2017/05/05 23:20:31 ET]
Table 'Wodan' 9-max Seat #4 is the button
Seat 1: H1JackH1gh ($2.09 in chips)=20
Seat 2: alonwu ($1.71 in chips)=20
Seat 3: StarsEyeDee ($2.57 in chips)=20
Seat 4: Lanesra_90 ($2.24 in chips)=20
Seat 5: Luks_Jr ($1.96 in chips)=20
Seat 6: 1Asthma1 ($2.03 in chips)=20
Seat 7: the_wickstar ($0.46 in chips)=20
Seat 8: Luigi507 ($2.12 in chips)=20
Seat 9: micksta58 ($2.01 in chips)=20
Luks_Jr: posts small blind $0.01
1Asthma1: posts big blind $0.02
*** HOLE CARDS ***
Dealt to the_wickstar [Qc 8s]
the_wickstar has timed out
the_wickstar: folds=20
Luigi507: raises $0.04 to $0.06
micksta58: folds=20
H1JackH1gh: folds=20
alonwu: folds=20
StarsEyeDee: folds=20
Lanesra_90: folds=20
Luks_Jr: folds=20
1Asthma1: folds=20
Uncalled bet ($0.04) returned to Luigi507
Luigi507 collected $0.05 from pot
*** SUMMARY ***
Total pot $0.05 | Rake $0=20
Seat 1: H1JackH1gh folded before Flop (didn't bet)
Seat 2: alonwu folded before Flop (didn't bet)
Seat 3: StarsEyeDee folded before Flop (didn't bet)
Seat 4: Lanesra_90 (button) folded before Flop (didn't bet)
Seat 5: Luks_Jr (small blind) folded before Flop
Seat 6: 1Asthma1 (big blind) folded before Flop
Seat 7: the_wickstar folded before Flop (didn't bet)
Seat 8: Luigi507 collected ($0.05)
Seat 9: micksta58 folded before Flop (didn't bet)


*********** # 37 **************
PokerStars Hand #170016347551:  Hold'em No Limit ($0.01/$0.02 USD) - 20=
17/05/06 13:20:06 CUST [2017/05/05 23:20:06 ET]
Table 'Wodan' 9-max Seat #3 is the button
Seat 1: H1JackH1gh ($2.09 in chips)=20
Seat 2: alonwu ($1.71 in chips)=20
Seat 3: StarsEyeDee ($2.57 in chips)=20
Seat 4: Lanesra_90 ($2.25 in chips)=20
Seat 5: Luks_Jr ($1.95 in chips)=20
Seat 6: 1Asthma1 ($2.03 in chips)=20
Seat 7: the_wickstar ($0.46 in chips)=20
Seat 8: Luigi507 ($2.12 in chips)=20
Seat 9: micksta58 ($2.01 in chips)=20
Lanesra_90: posts small blind $0.01
Luks_Jr: posts big blind $0.02
*** HOLE CARDS ***
Dealt to the_wickstar [7s 3h]
1Asthma1: folds=20
the_wickstar: folds=20
Luigi507: folds=20
micksta58: folds=20
H1JackH1gh: folds=20
alonwu: folds=20
StarsEyeDee: folds=20
Lanesra_90: folds=20
Uncalled bet ($0.01) returned to Luks_Jr
Luks_Jr collected $0.02 from pot
Luks_Jr: doesn't show hand=20
*** SUMMARY ***
Total pot $0.02 | Rake $0=20
Seat 1: H1JackH1gh folded before Flop (didn't bet)
Seat 2: alonwu folded before Flop (didn't bet)
Seat 3: StarsEyeDee (button) folded before Flop (didn't bet)
Seat 4: Lanesra_90 (small blind) folded before Flop
Seat 5: Luks_Jr (big blind) collected ($0.02)
Seat 6: 1Asthma1 folded before Flop (didn't bet)
Seat 7: the_wickstar folded before Flop (didn't bet)
Seat 8: Luigi507 folded before Flop (didn't bet)
Seat 9: micksta58 folded before Flop (didn't bet)


*********** # 38 **************
PokerStars Hand #170016334215:  Hold'em No Limit ($0.01/$0.02 USD) - 20=
17/05/06 13:19:27 CUST [2017/05/05 23:19:27 ET]
Table 'Mathilde III' 9-max Seat #8 is the button
Seat 1: Kabit510 ($2.46 in chips)=20
Seat 2: agrespan ($1.97 in chips)=20
Seat 3: howata ($2.05 in chips)=20
Seat 6: Blackpoker65 ($2.08 in chips)=20
Seat 7: July Van7 ($3.86 in chips)=20
Seat 8: the_wickstar ($2.13 in chips)=20
Seat 9: WadRambo ($0.72 in chips)=20
WadRambo: posts small blind $0.01
Kabit510: posts big blind $0.02
*** HOLE CARDS ***
Dealt to the_wickstar [Kd Tc]
agrespan: folds=20
howata: folds=20
Blackpoker65: calls $0.02
jony jd joins the table at seat #4=20
July Van7: folds=20
the_wickstar: raises $0.04 to $0.06
WadRambo: calls $0.05
Kabit510: folds=20
Blackpoker65: raises $0.04 to $0.10
the_wickstar: calls $0.04
WadRambo: calls $0.04
*** FLOP *** [9c 7h Ts]
WadRambo: checks=20
Blackpoker65: bets $0.16
the_wickstar: raises $0.16 to $0.32
WadRambo: folds=20
Blackpoker65: calls $0.16
*** TURN *** [9c 7h Ts] [Qh]
Blackpoker65: bets $0.02
the_wickstar: raises $0.43 to $0.45
Blackpoker65: calls $0.43
*** RIVER *** [9c 7h Ts Qh] [3h]
Blackpoker65: bets $1.21 and is all-in
the_wickstar: folds=20
Uncalled bet ($1.21) returned to Blackpoker65
Blackpoker65 collected $1.79 from pot
Blackpoker65: doesn't show hand=20
*** SUMMARY ***
Total pot $1.86 | Rake $0.07=20
Board [9c 7h Ts Qh 3h]
Seat 1: Kabit510 (big blind) folded before Flop
Seat 2: agrespan folded before Flop (didn't bet)
Seat 3: howata folded before Flop (didn't bet)
Seat 6: Blackpoker65 collected ($1.79)
Seat 7: July Van7 folded before Flop (didn't bet)
Seat 8: the_wickstar (button) folded on the River
Seat 9: WadRambo (small blind) folded on the Flop


*********** # 39 **************
PokerStars Hand #170016331704:  Hold'em No Limit ($0.01/$0.02 USD) - 20=
17/05/06 13:19:19 CUST [2017/05/05 23:19:19 ET]
Table 'Diotima' 9-max Seat #3 is the button
Seat 1: windy417 ($2 in chips)=20
Seat 2: yhchang ($2 in chips)=20
Seat 3: guga01101974 ($1.89 in chips)=20
Seat 4: H1JackH1gh ($2.95 in chips)=20
Seat 5: the_wickstar ($1.41 in chips)=20
Seat 6: vbg92 ($2.27 in chips)=20
Seat 8: pdgnqn28 ($1.65 in chips)=20
Seat 9: settecba ($2.04 in chips)=20
H1JackH1gh: posts small blind $0.01
the_wickstar: posts big blind $0.02
*** HOLE CARDS ***
Dealt to the_wickstar [4s Qc]
vbg92: folds=20
pdgnqn28: folds=20
settecba: folds=20
windy417: folds=20
yhchang: raises $0.04 to $0.06
guga01101974: calls $0.06
H1JackH1gh: folds=20
the_wickstar: folds=20
*** FLOP *** [8h Jd Ks]
yhchang: checks=20
guga01101974: checks=20
*** TURN *** [8h Jd Ks] [Ts]
yhchang: checks=20
guga01101974: checks=20
*** RIVER *** [8h Jd Ks Ts] [5d]
yhchang: checks=20
guga01101974: bets $0.02
yhchang: calls $0.02
*** SHOW DOWN ***
guga01101974: shows [2d 8d] (a pair of Eights)
yhchang: mucks hand=20
guga01101974 collected $0.18 from pot
*** SUMMARY ***
Total pot $0.19 | Rake $0.01=20
Board [8h Jd Ks Ts 5d]
Seat 1: windy417 folded before Flop (didn't bet)
Seat 2: yhchang mucked [3h Ad]
Seat 3: guga01101974 (button) showed [2d 8d] and won ($0.18) with a pai=
r of Eights
Seat 4: H1JackH1gh (small blind) folded before Flop
Seat 5: the_wickstar (big blind) folded before Flop
Seat 6: vbg92 folded before Flop (didn't bet)
Seat 8: pdgnqn28 folded before Flop (didn't bet)
Seat 9: settecba folded before Flop (didn't bet)


*********** # 40 **************
PokerStars Hand #170016331546:  Hold'em No Limit ($0.01/$0.02 USD) - 20=
17/05/06 13:19:19 CUST [2017/05/05 23:19:19 ET]
Table 'Wodan' 9-max Seat #2 is the button
Seat 1: H1JackH1gh ($2.09 in chips)=20
Seat 2: alonwu ($1.71 in chips)=20
Seat 3: StarsEyeDee ($2.58 in chips)=20
Seat 4: Lanesra_90 ($2.29 in chips)=20
Seat 5: Luks_Jr ($1.95 in chips)=20
Seat 6: 1Asthma1 ($2.03 in chips)=20
Seat 7: the_wickstar ($0.60 in chips)=20
Seat 8: Luigi507 ($2.12 in chips)=20
Seat 9: micksta58 ($1.83 in chips)=20
StarsEyeDee: posts small blind $0.01
Lanesra_90: posts big blind $0.02
micksta58: posts big blind $0.02
*** HOLE CARDS ***
Dealt to the_wickstar [Tc Ks]
Luks_Jr: folds=20
1Asthma1: folds=20
the_wickstar: raises $0.02 to $0.04
Luigi507: folds=20
micksta58: calls $0.02
H1JackH1gh: folds=20
alonwu: folds=20
StarsEyeDee: folds=20
Lanesra_90: calls $0.02
*** FLOP *** [3h Ac 9d]
Lanesra_90: checks=20
the_wickstar: bets $0.10
micksta58: calls $0.10
Lanesra_90: folds=20
*** TURN *** [3h Ac 9d] [Jh]
the_wickstar: checks=20
micksta58: bets $0.20
the_wickstar: folds=20
Uncalled bet ($0.20) returned to micksta58
micksta58 collected $0.32 from pot
micksta58: doesn't show hand=20
*** SUMMARY ***
Total pot $0.33 | Rake $0.01=20
Board [3h Ac 9d Jh]
Seat 1: H1JackH1gh folded before Flop (didn't bet)
Seat 2: alonwu (button) folded before Flop (didn't bet)
Seat 3: StarsEyeDee (small blind) folded before Flop
Seat 4: Lanesra_90 (big blind) folded on the Flop
Seat 5: Luks_Jr folded before Flop (didn't bet)
Seat 6: 1Asthma1 folded before Flop (didn't bet)
Seat 7: the_wickstar folded on the Turn
Seat 8: Luigi507 folded before Flop (didn't bet)
Seat 9: micksta58 collected ($0.32)


*********** # 41 **************
PokerStars Hand #170016320972:  Hold'em No Limit ($0.01/$0.02 USD) - 20=
17/05/06 13:18:48 CUST [2017/05/05 23:18:48 ET]
Table 'Wodan' 9-max Seat #1 is the button
Seat 1: H1JackH1gh ($2.09 in chips)=20
Seat 2: alonwu ($1.72 in chips)=20
Seat 3: StarsEyeDee ($2.57 in chips)=20
Seat 4: Lanesra_90 ($2.29 in chips)=20
Seat 5: Luks_Jr ($1.95 in chips)=20
Seat 6: 1Asthma1 ($2.03 in chips)=20
Seat 7: the_wickstar ($0.60 in chips)=20
Seat 8: Luigi507 ($2.12 in chips)=20
alonwu: posts small blind $0.01
StarsEyeDee: posts big blind $0.02
*** HOLE CARDS ***
Dealt to the_wickstar [6d Jc]
Lanesra_90: folds=20
micksta58 joins the table at seat #9=20
Luks_Jr: folds=20
1Asthma1: folds=20
the_wickstar: folds=20
Luigi507: folds=20
H1JackH1gh: folds=20
alonwu: folds=20
Uncalled bet ($0.01) returned to StarsEyeDee
StarsEyeDee collected $0.02 from pot
StarsEyeDee: doesn't show hand=20
*** SUMMARY ***
Total pot $0.02 | Rake $0=20
Seat 1: H1JackH1gh (button) folded before Flop (didn't bet)
Seat 2: alonwu (small blind) folded before Flop
Seat 3: StarsEyeDee (big blind) collected ($0.02)
Seat 4: Lanesra_90 folded before Flop (didn't bet)
Seat 5: Luks_Jr folded before Flop (didn't bet)
Seat 6: 1Asthma1 folded before Flop (didn't bet)
Seat 7: the_wickstar folded before Flop (didn't bet)
Seat 8: Luigi507 folded before Flop (didn't bet)


*********** # 42 **************
PokerStars Hand #170016319654:  Hold'em No Limit ($0.01/$0.02 USD) - 20=
17/05/06 13:18:44 CUST [2017/05/05 23:18:44 ET]
Table 'Diotima' 9-max Seat #2 is the button
Seat 1: windy417 ($2 in chips)=20
Seat 2: yhchang ($2 in chips)=20
Seat 3: guga01101974 ($1.90 in chips)=20
Seat 4: H1JackH1gh ($2.97 in chips)=20
Seat 5: the_wickstar ($1.41 in chips)=20
Seat 6: vbg92 ($2.24 in chips)=20
Seat 8: pdgnqn28 ($1.65 in chips)=20
Seat 9: settecba ($2.04 in chips)=20
guga01101974: posts small blind $0.01
H1JackH1gh: posts big blind $0.02
*** HOLE CARDS ***
Dealt to the_wickstar [4d Ah]
the_wickstar: folds=20
vbg92: raises $0.04 to $0.06
pdgnqn28: folds=20
settecba: folds=20
windy417: folds=20
yhchang: folds=20
guga01101974: folds=20
H1JackH1gh: folds=20
Uncalled bet ($0.04) returned to vbg92
vbg92 collected $0.05 from pot
*** SUMMARY ***
Total pot $0.05 | Rake $0=20
Seat 1: windy417 folded before Flop (didn't bet)
Seat 2: yhchang (button) folded before Flop (didn't bet)
Seat 3: guga01101974 (small blind) folded before Flop
Seat 4: H1JackH1gh (big blind) folded before Flop
Seat 5: the_wickstar folded before Flop (didn't bet)
Seat 6: vbg92 collected ($0.05)
Seat 8: pdgnqn28 folded before Flop (didn't bet)
Seat 9: settecba folded before Flop (didn't bet)


*********** # 43 **************
PokerStars Hand #170016316254:  Hold'em No Limit ($0.01/$0.02 USD) - 20=
17/05/06 13:18:34 CUST [2017/05/05 23:18:34 ET]
Table 'Mathilde III' 9-max Seat #7 is the button
Seat 1: Kabit510 ($2.46 in chips)=20
Seat 2: agrespan ($1.97 in chips)=20
Seat 3: howata ($2.05 in chips)=20
Seat 6: Blackpoker65 ($2 in chips)=20
Seat 7: July Van7 ($3.86 in chips)=20
Seat 8: the_wickstar ($2.14 in chips)=20
Seat 9: WadRambo ($0.80 in chips)=20
the_wickstar: posts small blind $0.01
WadRambo: posts big blind $0.02
Blackpoker65: posts big blind $0.02
*** HOLE CARDS ***
Dealt to the_wickstar [2c 7c]
Kabit510: folds=20
manugar91 leaves the table
agrespan: folds=20
howata: folds=20
Blackpoker65: checks=20
July Van7: folds=20
the_wickstar: folds=20
WadRambo: raises $0.02 to $0.04
Blackpoker65: calls $0.02
*** FLOP *** [8s Ts 9d]
WadRambo: bets $0.02
Blackpoker65: calls $0.02
*** TURN *** [8s Ts 9d] [6d]
WadRambo: checks=20
Blackpoker65: checks=20
*** RIVER *** [8s Ts 9d 6d] [5c]
WadRambo: bets $0.02
Blackpoker65: calls $0.02
*** SHOW DOWN ***
WadRambo: shows [2s Jc] (high card Jack)
Blackpoker65: shows [6s Kd] (a pair of Sixes)
Blackpoker65 collected $0.16 from pot
*** SUMMARY ***
Total pot $0.17 | Rake $0.01=20
Board [8s Ts 9d 6d 5c]
Seat 1: Kabit510 folded before Flop (didn't bet)
Seat 2: agrespan folded before Flop (didn't bet)
Seat 3: howata folded before Flop (didn't bet)
Seat 6: Blackpoker65 showed [6s Kd] and won ($0.16) with a pair of Sixes
Seat 7: July Van7 (button) folded before Flop (didn't bet)
Seat 8: the_wickstar (small blind) folded before Flop
Seat 9: WadRambo (big blind) showed [2s Jc] and lost with high card Jack


*********** # 44 **************
PokerStars Hand #170016312549:  Hold'em No Limit ($0.01/$0.02 USD) - 20=
17/05/06 13:18:23 CUST [2017/05/05 23:18:23 ET]
Table 'Wodan' 9-max Seat #8 is the button
Seat 1: H1JackH1gh ($2.08 in chips)=20
Seat 2: alonwu ($1.72 in chips)=20
Seat 3: StarsEyeDee ($2.57 in chips)=20
Seat 4: Lanesra_90 ($2.29 in chips)=20
Seat 5: Luks_Jr ($1.95 in chips)=20
Seat 6: 1Asthma1 ($2.03 in chips)=20
Seat 7: the_wickstar ($0.60 in chips)=20
Seat 8: Luigi507 ($2.12 in chips)=20
Seat 9: rana3792 ($1.86 in chips)=20
rana3792: posts small blind $0.01
H1JackH1gh: posts big blind $0.02
*** HOLE CARDS ***
Dealt to the_wickstar [Ts 3c]
alonwu: folds=20
StarsEyeDee: folds=20
Lanesra_90: folds=20
Luks_Jr: folds=20
1Asthma1: folds=20
the_wickstar: folds=20
Luigi507: folds=20
rana3792: folds=20
Uncalled bet ($0.01) returned to H1JackH1gh
rana3792 leaves the table
H1JackH1gh collected $0.02 from pot
H1JackH1gh: doesn't show hand=20
*** SUMMARY ***
Total pot $0.02 | Rake $0=20
Seat 1: H1JackH1gh (big blind) collected ($0.02)
Seat 2: alonwu folded before Flop (didn't bet)
Seat 3: StarsEyeDee folded before Flop (didn't bet)
Seat 4: Lanesra_90 folded before Flop (didn't bet)
Seat 5: Luks_Jr folded before Flop (didn't bet)
Seat 6: 1Asthma1 folded before Flop (didn't bet)
Seat 7: the_wickstar folded before Flop (didn't bet)
Seat 8: Luigi507 (button) folded before Flop (didn't bet)
Seat 9: rana3792 (small blind) folded before Flop


*********** # 45 **************
PokerStars Hand #170016312004:  Hold'em No Limit ($0.01/$0.02 USD) - 20=
17/05/06 13:18:21 CUST [2017/05/05 23:18:21 ET]
Table 'Diotima' 9-max Seat #1 is the button
Seat 1: windy417 ($2 in chips)=20
Seat 2: yhchang ($2 in chips)=20
Seat 3: guga01101974 ($1.92 in chips)=20
Seat 4: H1JackH1gh ($3.05 in chips)=20
Seat 5: the_wickstar ($1.41 in chips)=20
Seat 6: vbg92 ($2.13 in chips)=20
Seat 8: pdgnqn28 ($1.65 in chips)=20
Seat 9: settecba ($2.04 in chips)=20
yhchang: posts small blind $0.01
guga01101974: posts big blind $0.02
*** HOLE CARDS ***
Dealt to the_wickstar [Th 2c]
H1JackH1gh: raises $0.06 to $0.08
the_wickstar: folds=20
vbg92: raises $0.14 to $0.22
pdgnqn28: folds=20
settecba: folds=20
windy417: folds=20
yhchang: folds=20
guga01101974: folds=20
H1JackH1gh: folds=20
Uncalled bet ($0.14) returned to vbg92
vbg92 collected $0.19 from pot
*** SUMMARY ***
Total pot $0.19 | Rake $0=20
Seat 1: windy417 (button) folded before Flop (didn't bet)
Seat 2: yhchang (small blind) folded before Flop
Seat 3: guga01101974 (big blind) folded before Flop
Seat 4: H1JackH1gh folded before Flop
Seat 5: the_wickstar folded before Flop (didn't bet)
Seat 6: vbg92 collected ($0.19)
Seat 8: pdgnqn28 folded before Flop (didn't bet)
Seat 9: settecba folded before Flop (didn't bet)


*********** # 46 **************
PokerStars Hand #170016302557:  Hold'em No Limit ($0.01/$0.02 USD) - 20=
17/05/06 13:17:53 CUST [2017/05/05 23:17:53 ET]
Table 'Mathilde III' 9-max Seat #3 is the button
Seat 1: Kabit510 ($2.46 in chips)=20
Seat 2: agrespan ($1.97 in chips)=20
Seat 3: howata ($2.05 in chips)=20
Seat 4: manugar91 ($2 in chips)=20
Seat 7: July Van7 ($3.88 in chips)=20
Seat 8: the_wickstar ($2.14 in chips)=20
Seat 9: WadRambo ($0.80 in chips)=20
manugar91: posts small blind $0.01
drinkedfish: is sitting out=20
July Van7: posts big blind $0.02
drinkedfish leaves the table
*** HOLE CARDS ***
Dealt to the_wickstar [9h Kd]
Blackpoker65 joins the table at seat #6=20
the_wickstar: folds=20
WadRambo: folds=20
Kabit510: folds=20
agrespan: folds=20
howata: folds=20
manugar91: raises $0.03 to $0.05
July Van7: folds=20
Uncalled bet ($0.03) returned to manugar91
manugar91 collected $0.04 from pot
manugar91: doesn't show hand=20
*** SUMMARY ***
Total pot $0.04 | Rake $0=20
Seat 1: Kabit510 folded before Flop (didn't bet)
Seat 2: agrespan folded before Flop (didn't bet)
Seat 3: howata (button) folded before Flop (didn't bet)
Seat 4: manugar91 (small blind) collected ($0.04)
Seat 7: July Van7 (big blind) folded before Flop
Seat 8: the_wickstar folded before Flop (didn't bet)
Seat 9: WadRambo folded before Flop (didn't bet)


*********** # 47 **************
PokerStars Hand #170016291665:  Hold'em No Limit ($0.01/$0.02 USD) - 20=
17/05/06 13:17:21 CUST [2017/05/05 23:17:21 ET]
Table 'Wodan' 9-max Seat #7 is the button
Seat 1: H1JackH1gh ($2.08 in chips)=20
Seat 2: alonwu ($1.72 in chips)=20
Seat 3: StarsEyeDee ($2.57 in chips)=20
Seat 4: Lanesra_90 ($2.29 in chips)=20
Seat 5: Luks_Jr ($1.95 in chips)=20
Seat 6: 1Asthma1 ($2 in chips)=20
Seat 7: the_wickstar ($0.60 in chips)=20
Seat 8: Luigi507 ($2.13 in chips)=20
Seat 9: rana3792 ($1.88 in chips)=20
Luigi507: posts small blind $0.01
rana3792: posts big blind $0.02
*** HOLE CARDS ***
Dealt to the_wickstar [Qs 7d]
H1JackH1gh: folds=20
alonwu: folds=20
StarsEyeDee: folds=20
Lanesra_90: folds=20
Luks_Jr: folds=20
1Asthma1: raises $0.03 to $0.05
the_wickstar: folds=20
Luigi507: folds=20
rana3792: folds=20
Uncalled bet ($0.03) returned to 1Asthma1
1Asthma1 collected $0.05 from pot
*** SUMMARY ***
Total pot $0.05 | Rake $0=20
Seat 1: H1JackH1gh folded before Flop (didn't bet)
Seat 2: alonwu folded before Flop (didn't bet)
Seat 3: StarsEyeDee folded before Flop (didn't bet)
Seat 4: Lanesra_90 folded before Flop (didn't bet)
Seat 5: Luks_Jr folded before Flop (didn't bet)
Seat 6: 1Asthma1 collected ($0.05)
Seat 7: the_wickstar (button) folded before Flop (didn't bet)
Seat 8: Luigi507 (small blind) folded before Flop
Seat 9: rana3792 (big blind) folded before Flop


*********** # 48 **************
PokerStars Hand #170016291358:  Hold'em No Limit ($0.01/$0.02 USD) - 20=
17/05/06 13:17:20 CUST [2017/05/05 23:17:20 ET]
Table 'Mathilde III' 9-max Seat #2 is the button
Seat 1: Kabit510 ($2.46 in chips)=20
Seat 2: agrespan ($1.97 in chips)=20
Seat 3: howata ($2.06 in chips)=20
Seat 4: manugar91 ($2 in chips)=20
Seat 6: drinkedfish ($2.04 in chips)=20
Seat 7: July Van7 ($3.88 in chips)=20
Seat 8: the_wickstar ($2.11 in chips)=20
Seat 9: WadRambo ($0.80 in chips)=20
howata: posts small blind $0.01
manugar91: posts big blind $0.02
*** HOLE CARDS ***
Dealt to the_wickstar [Js Ac]
drinkedfish: folds=20
July Van7: folds=20
the_wickstar: raises $0.04 to $0.06
WadRambo: folds=20
Kabit510: folds=20
agrespan: folds=20
howata: folds=20
manugar91: folds=20
Uncalled bet ($0.04) returned to the_wickstar
the_wickstar collected $0.05 from pot
*** SUMMARY ***
Total pot $0.05 | Rake $0=20
Seat 1: Kabit510 folded before Flop (didn't bet)
Seat 2: agrespan (button) folded before Flop (didn't bet)
Seat 3: howata (small blind) folded before Flop
Seat 4: manugar91 (big blind) folded before Flop
Seat 6: drinkedfish folded before Flop (didn't bet)
Seat 7: July Van7 folded before Flop (didn't bet)
Seat 8: the_wickstar collected ($0.05)
Seat 9: WadRambo folded before Flop (didn't bet)


*********** # 49 **************
PokerStars Hand #170016289385:  Hold'em No Limit ($0.01/$0.02 USD) - 20=
17/05/06 13:17:14 CUST [2017/05/05 23:17:14 ET]
Table 'Diotima' 9-max Seat #9 is the button
Seat 1: windy417 ($2.01 in chips)=20
Seat 2: yhchang ($2 in chips)=20
Seat 3: guga01101974 ($1.92 in chips)=20
Seat 4: H1JackH1gh ($3.05 in chips)=20
Seat 5: the_wickstar ($1.10 in chips)=20
Seat 6: vbg92 ($2.13 in chips)=20
Seat 8: pdgnqn28 ($1.65 in chips)=20
Seat 9: settecba ($2.04 in chips)=20
windy417: posts small blind $0.01
yhchang: posts big blind $0.02
*** HOLE CARDS ***
Dealt to the_wickstar [Ad Qd]
guga01101974: folds=20
H1JackH1gh: folds=20
the_wickstar: raises $0.02 to $0.04
vbg92: folds=20
pdgnqn28: folds=20
settecba: folds=20
windy417: folds=20
yhchang: calls $0.02
*** FLOP *** [8d Qc Qs]
yhchang: checks=20
the_wickstar: bets $0.04
yhchang: calls $0.04
*** TURN *** [8d Qc Qs] [Ks]
yhchang: checks=20
the_wickstar: bets $0.08
yhchang: calls $0.08
*** RIVER *** [8d Qc Qs Ks] [Ah]
yhchang: bets $0.16
the_wickstar: calls $0.16
*** SHOW DOWN ***
yhchang: shows [7c Ac] (two pair, Aces and Queens)
the_wickstar: shows [Ad Qd] (a full house, Queens full of Aces)
the_wickstar collected $0.63 from pot
*** SUMMARY ***
Total pot $0.65 | Rake $0.02=20
Board [8d Qc Qs Ks Ah]
Seat 1: windy417 (small blind) folded before Flop
Seat 2: yhchang (big blind) showed [7c Ac] and lost with two pair, Aces=
 and Queens
Seat 3: guga01101974 folded before Flop (didn't bet)
Seat 4: H1JackH1gh folded before Flop (didn't bet)
Seat 5: the_wickstar showed [Ad Qd] and won ($0.63) with a full house, =
Queens full of Aces
Seat 6: vbg92 folded before Flop (didn't bet)
Seat 8: pdgnqn28 folded before Flop (didn't bet)
Seat 9: settecba (button) folded before Flop (didn't bet)


*********** # 50 **************
PokerStars Hand #170016272301:  Hold'em No Limit ($0.01/$0.02 USD) - 20=
17/05/06 13:16:24 CUST [2017/05/05 23:16:24 ET]
Table 'Wodan' 9-max Seat #6 is the button
Seat 1: H1JackH1gh ($2.08 in chips)=20
Seat 2: alonwu ($1.85 in chips)=20
Seat 3: StarsEyeDee ($2.57 in chips)=20
Seat 4: Lanesra_90 ($2.29 in chips)=20
Seat 5: Luks_Jr ($1.95 in chips)=20
Seat 6: 1Asthma1 ($2 in chips)=20
Seat 7: the_wickstar ($0.61 in chips)=20
Seat 8: Luigi507 ($2 in chips)=20
Seat 9: rana3792 ($1.88 in chips)=20
the_wickstar: posts small blind $0.01
Luigi507: posts big blind $0.02
*** HOLE CARDS ***
Dealt to the_wickstar [2s Js]
rana3792: folds=20
H1JackH1gh: folds=20
alonwu: raises $0.02 to $0.04
StarsEyeDee: folds=20
Lanesra_90: folds=20
Luks_Jr: folds=20
1Asthma1: folds=20
the_wickstar: folds=20
Luigi507: calls $0.02
*** FLOP *** [3s 5s 5h]
Luigi507: checks=20
alonwu: bets $0.09
Luigi507: calls $0.09
*** TURN *** [3s 5s 5h] [Kh]
Luigi507: checks=20
alonwu: checks=20
*** RIVER *** [3s 5s 5h Kh] [7d]
Luigi507: bets $0.22
alonwu: folds=20
Uncalled bet ($0.22) returned to Luigi507
Luigi507 collected $0.26 from pot
Luigi507: doesn't show hand=20
*** SUMMARY ***
Total pot $0.27 | Rake $0.01=20
Board [3s 5s 5h Kh 7d]
Seat 1: H1JackH1gh folded before Flop (didn't bet)
Seat 2: alonwu folded on the River
Seat 3: StarsEyeDee folded before Flop (didn't bet)
Seat 4: Lanesra_90 folded before Flop (didn't bet)
Seat 5: Luks_Jr folded before Flop (didn't bet)
Seat 6: 1Asthma1 (button) folded before Flop (didn't bet)
Seat 7: the_wickstar (small blind) folded before Flop
Seat 8: Luigi507 (big blind) collected ($0.26)
Seat 9: rana3792 folded before Flop (didn't bet)


*********** # 51 **************
PokerStars Hand #170016269506:  Hold'em No Limit ($0.01/$0.02 USD) - 20=
17/05/06 13:16:15 CUST [2017/05/05 23:16:15 ET]
Table 'Diotima' 9-max Seat #8 is the button
Seat 1: windy417 ($2.03 in chips)=20
Seat 3: guga01101974 ($1.80 in chips)=20
Seat 4: H1JackH1gh ($3.15 in chips)=20
Seat 5: the_wickstar ($1.10 in chips)=20
Seat 6: vbg92 ($2.13 in chips)=20
Seat 7: BRAT PIDD ($2 in chips)=20
Seat 8: pdgnqn28 ($1.65 in chips)=20
Seat 9: settecba ($2.05 in chips)=20
settecba: posts small blind $0.01
windy417: posts big blind $0.02
yhchang: sits out=20
*** HOLE CARDS ***
Dealt to the_wickstar [2s 5s]
guga01101974: calls $0.02
H1JackH1gh: raises $0.08 to $0.10
the_wickstar: folds=20
vbg92: folds=20
BRAT PIDD: folds=20
pdgnqn28: folds=20
settecba: folds=20
windy417: folds=20
guga01101974: calls $0.08
*** FLOP *** [Qs 9d 2h]
guga01101974: checks=20
H1JackH1gh: checks=20
*** TURN *** [Qs 9d 2h] [2d]
guga01101974: bets $0.04
H1JackH1gh: folds=20
Uncalled bet ($0.04) returned to guga01101974
guga01101974 collected $0.22 from pot
guga01101974: doesn't show hand=20
*** SUMMARY ***
Total pot $0.23 | Rake $0.01=20
Board [Qs 9d 2h 2d]
Seat 1: windy417 (big blind) folded before Flop
Seat 3: guga01101974 collected ($0.22)
Seat 4: H1JackH1gh folded on the Turn
Seat 5: the_wickstar folded before Flop (didn't bet)
Seat 6: vbg92 folded before Flop (didn't bet)
Seat 7: BRAT PIDD folded before Flop (didn't bet)
Seat 8: pdgnqn28 (button) folded before Flop (didn't bet)
Seat 9: settecba (small blind) folded before Flop


*********** # 52 **************
PokerStars Hand #170016266220:  Hold'em No Limit ($0.01/$0.02 USD) - 20=
17/05/06 13:16:06 CUST [2017/05/05 23:16:06 ET]
Table 'Mathilde III' 9-max Seat #1 is the button
Seat 1: Kabit510 ($2.46 in chips)=20
Seat 2: agrespan ($1.98 in chips)=20
Seat 3: howata ($2.08 in chips)=20
Seat 4: manugar91 ($2 in chips)=20
Seat 6: drinkedfish ($2.04 in chips)=20
Seat 7: July Van7 ($3.88 in chips)=20
Seat 8: the_wickstar ($2.51 in chips)=20
Seat 9: WadRambo ($0.40 in chips)=20
agrespan: posts small blind $0.01
howata: posts big blind $0.02
*** HOLE CARDS ***
Dealt to the_wickstar [Ad 8s]
manugar91: folds=20
drinkedfish: folds=20
July Van7: folds=20
the_wickstar: calls $0.02
WadRambo: raises $0.02 to $0.04
Kabit510: folds=20
agrespan: folds=20
howata: folds=20
the_wickstar: calls $0.02
*** FLOP *** [As 3c 5h]
the_wickstar: checks=20
WadRambo: bets $0.36 and is all-in
the_wickstar: calls $0.36
*** TURN *** [As 3c 5h] [Ks]
*** RIVER *** [As 3c 5h Ks] [Td]
*** SHOW DOWN ***
the_wickstar: shows [Ad 8s] (a pair of Aces)
WadRambo: shows [Js Ac] (a pair of Aces - King+Jack kicker)
WadRambo collected $0.80 from pot
*** SUMMARY ***
Total pot $0.83 | Rake $0.03=20
Board [As 3c 5h Ks Td]
Seat 1: Kabit510 (button) folded before Flop (didn't bet)
Seat 2: agrespan (small blind) folded before Flop
Seat 3: howata (big blind) folded before Flop
Seat 4: manugar91 folded before Flop (didn't bet)
Seat 6: drinkedfish folded before Flop (didn't bet)
Seat 7: July Van7 folded before Flop (didn't bet)
Seat 8: the_wickstar showed [Ad 8s] and lost with a pair of Aces
Seat 9: WadRambo showed [Js Ac] and won ($0.80) with a pair of Aces


*********** # 53 **************
PokerStars Hand #170016246929:  Hold'em No Limit ($0.01/$0.02 USD) - 20=
17/05/06 13:15:09 CUST [2017/05/05 23:15:09 ET]
Table 'Mathilde III' 9-max Seat #9 is the button
Seat 1: Kabit510 ($2.47 in chips)=20
Seat 2: agrespan ($2 in chips)=20
Seat 3: howata ($2.27 in chips)=20
Seat 4: manugar91 ($2 in chips)=20
Seat 6: drinkedfish ($2.04 in chips)=20
Seat 7: July Van7 ($3.88 in chips)=20
Seat 8: the_wickstar ($2.51 in chips)=20
Seat 9: WadRambo ($0.19 in chips)=20
Kabit510: posts small blind $0.01
agrespan: posts big blind $0.02
*** HOLE CARDS ***
Dealt to the_wickstar [Ts 8c]
howata: raises $0.04 to $0.06
manugar91: folds=20
drinkedfish: folds=20
July Van7: folds=20
the_wickstar: folds=20
WadRambo: raises $0.13 to $0.19 and is all-in
Kabit510: folds=20
agrespan: folds=20
howata: calls $0.13
*** FLOP *** [Qh 7h 2h]
*** TURN *** [Qh 7h 2h] [Ah]
*** RIVER *** [Qh 7h 2h Ah] [Th]
*** SHOW DOWN ***
howata: shows [Ad Qs] (a flush, Ace high)
WadRambo: shows [9h Ks] (a flush, Ace high - Nine higher)
WadRambo collected $0.40 from pot
*** SUMMARY ***
Total pot $0.41 | Rake $0.01=20
Board [Qh 7h 2h Ah Th]
Seat 1: Kabit510 (small blind) folded before Flop
Seat 2: agrespan (big blind) folded before Flop
Seat 3: howata showed [Ad Qs] and lost with a flush, Ace high
Seat 4: manugar91 folded before Flop (didn't bet)
Seat 6: drinkedfish folded before Flop (didn't bet)
Seat 7: July Van7 folded before Flop (didn't bet)
Seat 8: the_wickstar folded before Flop (didn't bet)
Seat 9: WadRambo (button) showed [9h Ks] and won ($0.40) with a flush, =
Ace high


*********** # 54 **************
PokerStars Hand #170016237718:  Hold'em No Limit ($0.01/$0.02 USD) - 20=
17/05/06 13:14:42 CUST [2017/05/05 23:14:42 ET]
Table 'Diotima' 9-max Seat #7 is the button
Seat 1: windy417 ($2.03 in chips)=20
Seat 3: guga01101974 ($1.88 in chips)=20
Seat 4: H1JackH1gh ($3.15 in chips)=20
Seat 5: the_wickstar ($1.10 in chips)=20
Seat 6: vbg92 ($2.02 in chips)=20
Seat 7: BRAT PIDD ($2 in chips)=20
Seat 8: pdgnqn28 ($1.67 in chips)=20
Seat 9: settecba ($2.07 in chips)=20
pdgnqn28: posts small blind $0.01
settecba: posts big blind $0.02
*** HOLE CARDS ***
Dealt to the_wickstar [8d 5d]
windy417: folds=20
guga01101974: calls $0.02
H1JackH1gh: folds=20
the_wickstar: folds=20
yhchang joins the table at seat #2=20
vbg92: calls $0.02
BRAT PIDD: folds=20
pdgnqn28: calls $0.01
settecba: checks=20
*** FLOP *** [Qh 7c 4h]
pdgnqn28: checks=20
settecba: checks=20
guga01101974: checks=20
vbg92: bets $0.06
pdgnqn28: folds=20
settecba: folds=20
guga01101974: calls $0.06
*** TURN *** [Qh 7c 4h] [Jc]
guga01101974: checks=20
vbg92: checks=20
*** RIVER *** [Qh 7c 4h Jc] [8s]
guga01101974: checks=20
vbg92: bets $0.10
guga01101974: folds=20
Uncalled bet ($0.10) returned to vbg92
vbg92 collected $0.19 from pot
*** SUMMARY ***
Total pot $0.20 | Rake $0.01=20
Board [Qh 7c 4h Jc 8s]
Seat 1: windy417 folded before Flop (didn't bet)
Seat 3: guga01101974 folded on the River
Seat 4: H1JackH1gh folded before Flop (didn't bet)
Seat 5: the_wickstar folded before Flop (didn't bet)
Seat 6: vbg92 collected ($0.19)
Seat 7: BRAT PIDD (button) folded before Flop (didn't bet)
Seat 8: pdgnqn28 (small blind) folded on the Flop
Seat 9: settecba (big blind) folded on the Flop


*********** # 55 **************
PokerStars Hand #170016234191:  Hold'em No Limit ($0.01/$0.02 USD) - 20=
17/05/06 13:14:32 CUST [2017/05/05 23:14:32 ET]
Table 'Wodan' 9-max Seat #5 is the button
Seat 1: H1JackH1gh ($2.08 in chips)=20
Seat 2: alonwu ($1.91 in chips)=20
Seat 3: StarsEyeDee ($2.28 in chips)=20
Seat 4: Lanesra_90 ($2.51 in chips)=20
Seat 5: Luks_Jr ($1.95 in chips)=20
Seat 6: 1Asthma1 ($2 in chips)=20
Seat 7: the_wickstar ($0.63 in chips)=20
Seat 9: rana3792 ($1.88 in chips)=20
1Asthma1: posts small blind $0.01
the_wickstar: posts big blind $0.02
Luigi507: sits out=20
*** HOLE CARDS ***
Dealt to the_wickstar [6d Ts]
rana3792: folds=20
H1JackH1gh: folds=20
alonwu: raises $0.04 to $0.06
StarsEyeDee: calls $0.06
Lanesra_90: calls $0.06
Luks_Jr: folds=20
1Asthma1: folds=20
the_wickstar: folds=20
*** FLOP *** [2c 3d 7c]
alonwu: checks=20
StarsEyeDee: bets $0.08
Lanesra_90: calls $0.08
alonwu: folds=20
*** TURN *** [2c 3d 7c] [7s]
StarsEyeDee: bets $0.08
Lanesra_90: calls $0.08
*** RIVER *** [2c 3d 7c 7s] [2s]
StarsEyeDee: bets $0.31
Lanesra_90: folds=20
Uncalled bet ($0.31) returned to StarsEyeDee
StarsEyeDee collected $0.51 from pot
StarsEyeDee: doesn't show hand=20
*** SUMMARY ***
Total pot $0.53 | Rake $0.02=20
Board [2c 3d 7c 7s 2s]
Seat 1: H1JackH1gh folded before Flop (didn't bet)
Seat 2: alonwu folded on the Flop
Seat 3: StarsEyeDee collected ($0.51)
Seat 4: Lanesra_90 folded on the River
Seat 5: Luks_Jr (button) folded before Flop (didn't bet)
Seat 6: 1Asthma1 (small blind) folded before Flop
Seat 7: the_wickstar (big blind) folded before Flop
Seat 9: rana3792 folded before Flop (didn't bet)


*********** # 56 **************
PokerStars Hand #170016224888:  Hold'em No Limit ($0.01/$0.02 USD) - 20=
17/05/06 13:14:04 CUST [2017/05/05 23:14:04 ET]
Table 'Mathilde III' 9-max Seat #8 is the button
Seat 1: Kabit510 ($2.49 in chips)=20
Seat 3: howata ($2.27 in chips)=20
Seat 4: manugar91 ($2 in chips)=20
Seat 6: drinkedfish ($2.04 in chips)=20
Seat 7: July Van7 ($2 in chips)=20
Seat 8: the_wickstar ($2.51 in chips)=20
Seat 9: WadRambo ($2.19 in chips)=20
WadRambo: posts small blind $0.01
Kabit510: posts big blind $0.02
agrespan: sits out=20
*** HOLE CARDS ***
Dealt to the_wickstar [Qc 8c]
howata: folds=20
manugar91: folds=20
drinkedfish: folds=20
July Van7: raises $0.04 to $0.06
the_wickstar: folds=20
WadRambo: raises $0.18 to $0.24
Kabit510: folds=20
July Van7: raises $0.48 to $0.72
WadRambo: calls $0.48
*** FLOP *** [6d 2h Tc]
WadRambo: bets $0.16
July Van7: raises $1.12 to $1.28 and is all-in
WadRambo: calls $1.12
*** TURN *** [6d 2h Tc] [2c]
*** RIVER *** [6d 2h Tc 2c] [Js]
*** SHOW DOWN ***
WadRambo: shows [Ah Qd] (a pair of Deuces)
July Van7: shows [Kc Ks] (two pair, Kings and Deuces)
July Van7 collected $3.88 from pot
*** SUMMARY ***
Total pot $4.02 | Rake $0.14=20
Board [6d 2h Tc 2c Js]
Seat 1: Kabit510 (big blind) folded before Flop
Seat 3: howata folded before Flop (didn't bet)
Seat 4: manugar91 folded before Flop (didn't bet)
Seat 6: drinkedfish folded before Flop (didn't bet)
Seat 7: July Van7 showed [Kc Ks] and won ($3.88) with two pair, Kings a=
nd Deuces
Seat 8: the_wickstar (button) folded before Flop (didn't bet)
Seat 9: WadRambo (small blind) showed [Ah Qd] and lost with a pair of D=
euces


*********** # 57 **************
PokerStars Hand #170016206963:  Hold'em No Limit ($0.01/$0.02 USD) - 20=
17/05/06 13:13:12 CUST [2017/05/05 23:13:12 ET]
Table 'Wodan' 9-max Seat #4 is the button
Seat 1: H1JackH1gh ($2.08 in chips)=20
Seat 2: alonwu ($1.97 in chips)=20
Seat 3: StarsEyeDee ($2.28 in chips)=20
Seat 4: Lanesra_90 ($2.57 in chips)=20
Seat 5: Luks_Jr ($1.96 in chips)=20
Seat 6: 1Asthma1 ($2 in chips)=20
Seat 7: the_wickstar ($0.49 in chips)=20
Seat 9: rana3792 ($1.88 in chips)=20
Luks_Jr: posts small blind $0.01
1Asthma1: posts big blind $0.02
Luigi507: sits out=20
*** HOLE CARDS ***
Dealt to the_wickstar [6c 5c]
the_wickstar: calls $0.02
rana3792: folds=20
H1JackH1gh: folds=20
alonwu: raises $0.04 to $0.06
StarsEyeDee: folds=20
Lanesra_90: calls $0.06
Luks_Jr: folds=20
1Asthma1: folds=20
the_wickstar: calls $0.04
*** FLOP *** [Kh 4h 5d]
the_wickstar: checks=20
alonwu: checks=20
Lanesra_90: checks=20
*** TURN *** [Kh 4h 5d] [8s]
the_wickstar: bets $0.13
alonwu: folds=20
Lanesra_90: folds=20
Uncalled bet ($0.13) returned to the_wickstar
the_wickstar collected $0.20 from pot
*** SUMMARY ***
Total pot $0.21 | Rake $0.01=20
Board [Kh 4h 5d 8s]
Seat 1: H1JackH1gh folded before Flop (didn't bet)
Seat 2: alonwu folded on the Turn
Seat 3: StarsEyeDee folded before Flop (didn't bet)
Seat 4: Lanesra_90 (button) folded on the Turn
Seat 5: Luks_Jr (small blind) folded before Flop
Seat 6: 1Asthma1 (big blind) folded before Flop
Seat 7: the_wickstar collected ($0.20)
Seat 9: rana3792 folded before Flop (didn't bet)


*********** # 58 **************
PokerStars Hand #170016204834:  Hold'em No Limit ($0.01/$0.02 USD) - 20=
17/05/06 13:13:06 CUST [2017/05/05 23:13:06 ET]
Table 'Mathilde III' 9-max Seat #7 is the button
Seat 1: Kabit510 ($2.25 in chips)=20
Seat 3: howata ($2.27 in chips)=20
Seat 4: manugar91 ($2 in chips)=20
Seat 6: drinkedfish ($2.04 in chips)=20
Seat 7: July Van7 ($2 in chips)=20
Seat 8: the_wickstar ($2.57 in chips)=20
Seat 9: WadRambo ($2.21 in chips)=20
the_wickstar: posts small blind $0.01
WadRambo: posts big blind $0.02
*** HOLE CARDS ***
Dealt to the_wickstar [6d 6s]
Kabit510: raises $0.04 to $0.06
howata: folds=20
manugar91: folds=20
drinkedfish: folds=20
July Van7: calls $0.06
agrespan joins the table at seat #2=20
the_wickstar: calls $0.05
WadRambo: folds=20
*** FLOP *** [8s Qd Jd]
the_wickstar: checks=20
Kabit510: bets $0.12
July Van7: calls $0.12
the_wickstar: folds=20
*** TURN *** [8s Qd Jd] [2s]
Kabit510: bets $0.20
July Van7: folds=20
Uncalled bet ($0.20) returned to Kabit510
Kabit510 collected $0.42 from pot
Kabit510: doesn't show hand=20
*** SUMMARY ***
Total pot $0.44 | Rake $0.02=20
Board [8s Qd Jd 2s]
Seat 1: Kabit510 collected ($0.42)
Seat 3: howata folded before Flop (didn't bet)
Seat 4: manugar91 folded before Flop (didn't bet)
Seat 6: drinkedfish folded before Flop (didn't bet)
Seat 7: July Van7 (button) folded on the Turn
Seat 8: the_wickstar (small blind) folded on the Flop
Seat 9: WadRambo (big blind) folded before Flop


*********** # 59 **************
PokerStars Hand #170016200824:  Hold'em No Limit ($0.01/$0.02 USD) - 20=
17/05/06 13:12:54 CUST [2017/05/05 23:12:54 ET]
Table 'Diotima' 9-max Seat #6 is the button
Seat 1: windy417 ($2.03 in chips)=20
Seat 2: uilcm ($2.56 in chips)=20
Seat 3: guga01101974 ($1.91 in chips)=20
Seat 4: H1JackH1gh ($3.15 in chips)=20
Seat 5: the_wickstar ($1.04 in chips)=20
Seat 6: vbg92 ($2.02 in chips)=20
Seat 7: BRAT PIDD ($2 in chips)=20
Seat 8: pdgnqn28 ($1.69 in chips)=20
Seat 9: settecba ($2.07 in chips)=20
BRAT PIDD: posts small blind $0.01
pdgnqn28: posts big blind $0.02
guga01101974: posts small & big blinds $0.03
*** HOLE CARDS ***
Dealt to the_wickstar [Qh 2h]
settecba: folds=20
windy417: folds=20
uilcm: folds=20
guga01101974: checks=20
H1JackH1gh: folds=20
the_wickstar: calls $0.02
vbg92: folds=20
BRAT PIDD: folds=20
pdgnqn28: checks=20
*** FLOP *** [3c 8h Td]
pdgnqn28: checks=20
uilcm leaves the table
guga01101974: checks=20
the_wickstar: checks=20
*** TURN *** [3c 8h Td] [8c]
pdgnqn28: checks=20
guga01101974: checks=20
the_wickstar: bets $0.06
pdgnqn28: folds=20
guga01101974: folds=20
Uncalled bet ($0.06) returned to the_wickstar
the_wickstar collected $0.08 from pot
*** SUMMARY ***
Total pot $0.08 | Rake $0=20
Board [3c 8h Td 8c]
Seat 1: windy417 folded before Flop (didn't bet)
Seat 2: uilcm folded before Flop (didn't bet)
Seat 3: guga01101974 folded on the Turn
Seat 4: H1JackH1gh folded before Flop (didn't bet)
Seat 5: the_wickstar collected ($0.08)
Seat 6: vbg92 (button) folded before Flop (didn't bet)
Seat 7: BRAT PIDD (small blind) folded before Flop
Seat 8: pdgnqn28 (big blind) folded on the Turn
Seat 9: settecba folded before Flop (didn't bet)


*********** # 60 **************
PokerStars Hand #170016198247:  Hold'em No Limit ($0.01/$0.02 USD) - 20=
17/05/06 13:12:47 CUST [2017/05/05 23:12:47 ET]
Table 'Wodan' 9-max Seat #3 is the button
Seat 1: H1JackH1gh ($2.08 in chips)=20
Seat 2: alonwu ($1.97 in chips)=20
Seat 3: StarsEyeDee ($2.28 in chips)=20
Seat 4: Lanesra_90 ($2.55 in chips)=20
Seat 5: Luks_Jr ($1.98 in chips)=20
Seat 6: 1Asthma1 ($2 in chips)=20
Seat 7: the_wickstar ($0.49 in chips)=20
Seat 9: rana3792 ($1.88 in chips)=20
Lanesra_90: posts small blind $0.01
Luks_Jr: posts big blind $0.02
Luigi507: sits out=20
*** HOLE CARDS ***
Dealt to the_wickstar [Ac 9h]
1Asthma1: folds=20
the_wickstar: folds=20
rana3792: folds=20
H1JackH1gh: folds=20
alonwu: folds=20
StarsEyeDee: folds=20
Lanesra_90: raises $0.04 to $0.06
Luks_Jr: folds=20
Uncalled bet ($0.04) returned to Lanesra_90
Lanesra_90 collected $0.04 from pot
*** SUMMARY ***
Total pot $0.04 | Rake $0=20
Seat 1: H1JackH1gh folded before Flop (didn't bet)
Seat 2: alonwu folded before Flop (didn't bet)
Seat 3: StarsEyeDee (button) folded before Flop (didn't bet)
Seat 4: Lanesra_90 (small blind) collected ($0.04)
Seat 5: Luks_Jr (big blind) folded before Flop
Seat 6: 1Asthma1 folded before Flop (didn't bet)
Seat 7: the_wickstar folded before Flop (didn't bet)
Seat 9: rana3792 folded before Flop (didn't bet)


*********** # 61 **************
PokerStars Hand #170016194354:  Hold'em No Limit ($0.01/$0.02 USD) - 20=
17/05/06 13:12:36 CUST [2017/05/05 23:12:36 ET]
Table 'Mathilde III' 9-max Seat #6 is the button
Seat 1: Kabit510 ($2.25 in chips)=20
Seat 3: howata ($2.27 in chips)=20
Seat 4: manugar91 ($2 in chips)=20
Seat 6: drinkedfish ($2.04 in chips)=20
Seat 7: July Van7 ($2 in chips)=20
Seat 8: the_wickstar ($2.59 in chips)=20
Seat 9: WadRambo ($2.18 in chips)=20
July Van7: posts small blind $0.01
the_wickstar: posts big blind $0.02
*** HOLE CARDS ***
Dealt to the_wickstar [5s 3s]
WadRambo: raises $0.06 to $0.08
Kabit510: folds=20
howata: folds=20
manugar91: folds=20
drinkedfish: folds=20
July Van7: folds=20
zecateto leaves the table
the_wickstar: folds=20
Uncalled bet ($0.06) returned to WadRambo
WadRambo collected $0.05 from pot
WadRambo: doesn't show hand=20
*** SUMMARY ***
Total pot $0.05 | Rake $0=20
Seat 1: Kabit510 folded before Flop (didn't bet)
Seat 3: howata folded before Flop (didn't bet)
Seat 4: manugar91 folded before Flop (didn't bet)
Seat 6: drinkedfish (button) folded before Flop (didn't bet)
Seat 7: July Van7 (small blind) folded before Flop
Seat 8: the_wickstar (big blind) folded before Flop
Seat 9: WadRambo collected ($0.05)


*********** # 62 **************
PokerStars Hand #170016189624:  Hold'em No Limit ($0.01/$0.02 USD) - 20=
17/05/06 13:12:22 CUST [2017/05/05 23:12:22 ET]
Table 'Wodan' 9-max Seat #2 is the button
Seat 1: H1JackH1gh ($2.08 in chips)=20
Seat 2: alonwu ($1.97 in chips)=20
Seat 3: StarsEyeDee ($2.29 in chips)=20
Seat 4: Lanesra_90 ($2.54 in chips)=20
Seat 5: Luks_Jr ($1.98 in chips)=20
Seat 6: 1Asthma1 ($2 in chips)=20
Seat 7: the_wickstar ($0.49 in chips)=20
Seat 9: rana3792 ($1.88 in chips)=20
StarsEyeDee: posts small blind $0.01
Lanesra_90: posts big blind $0.02
Luigi507: sits out=20
*** HOLE CARDS ***
Dealt to the_wickstar [Ts 5c]
Luks_Jr: folds=20
1Asthma1: folds=20
the_wickstar: folds=20
rana3792: folds=20
H1JackH1gh: folds=20
alonwu: folds=20
StarsEyeDee: folds=20
Uncalled bet ($0.01) returned to Lanesra_90
Lanesra_90 collected $0.02 from pot
*** SUMMARY ***
Total pot $0.02 | Rake $0=20
Seat 1: H1JackH1gh folded before Flop (didn't bet)
Seat 2: alonwu (button) folded before Flop (didn't bet)
Seat 3: StarsEyeDee (small blind) folded before Flop
Seat 4: Lanesra_90 (big blind) collected ($0.02)
Seat 5: Luks_Jr folded before Flop (didn't bet)
Seat 6: 1Asthma1 folded before Flop (didn't bet)
Seat 7: the_wickstar folded before Flop (didn't bet)
Seat 9: rana3792 folded before Flop (didn't bet)


*********** # 63 **************
PokerStars Hand #170016179335:  Hold'em No Limit ($0.01/$0.02 USD) - 20=
17/05/06 13:11:52 CUST [2017/05/05 23:11:52 ET]
Table 'Mathilde III' 9-max Seat #4 is the button
Seat 1: Kabit510 ($2.25 in chips)=20
Seat 3: howata ($2.19 in chips)=20
Seat 4: manugar91 ($2 in chips)=20
Seat 6: drinkedfish ($2.10 in chips)=20
Seat 7: July Van7 ($2 in chips)=20
Seat 8: the_wickstar ($2.59 in chips)=20
Seat 9: WadRambo ($2.18 in chips)=20
drinkedfish: posts small blind $0.01
July Van7: posts big blind $0.02
*** HOLE CARDS ***
Dealt to the_wickstar [Qs 9s]
the_wickstar: folds=20
WadRambo: folds=20
Kabit510: folds=20
howata: raises $0.04 to $0.06
manugar91: folds=20
drinkedfish: calls $0.05
July Van7: folds=20
*** FLOP *** [Qh Jh Jc]
drinkedfish: checks=20
howata: bets $0.07
drinkedfish: folds=20
Uncalled bet ($0.07) returned to howata
howata collected $0.14 from pot
howata: doesn't show hand=20
*** SUMMARY ***
Total pot $0.14 | Rake $0=20
Board [Qh Jh Jc]
Seat 1: Kabit510 folded before Flop (didn't bet)
Seat 3: howata collected ($0.14)
Seat 4: manugar91 (button) folded before Flop (didn't bet)
Seat 6: drinkedfish (small blind) folded on the Flop
Seat 7: July Van7 (big blind) folded before Flop
Seat 8: the_wickstar folded before Flop (didn't bet)
Seat 9: WadRambo folded before Flop (didn't bet)


*********** # 64 **************
PokerStars Hand #170016178567:  Hold'em No Limit ($0.01/$0.02 USD) - 20=
17/05/06 13:11:50 CUST [2017/05/05 23:11:50 ET]
Table 'Diotima' 9-max Seat #5 is the button
Seat 1: windy417 ($2.03 in chips)=20
Seat 2: uilcm ($2.56 in chips)=20
Seat 4: H1JackH1gh ($3.15 in chips)=20
Seat 5: the_wickstar ($1.24 in chips)=20
Seat 6: vbg92 ($1.81 in chips)=20
Seat 7: BRAT PIDD ($2 in chips)=20
Seat 8: pdgnqn28 ($1.69 in chips)=20
Seat 9: settecba ($2.07 in chips)=20
vbg92: posts small blind $0.01
BRAT PIDD: posts big blind $0.02
*** HOLE CARDS ***
Dealt to the_wickstar [As 4c]
pdgnqn28: folds=20
settecba: folds=20
windy417: folds=20
uilcm: folds=20
H1JackH1gh: folds=20
the_wickstar: calls $0.02
vbg92: raises $0.04 to $0.06
BRAT PIDD: folds=20
the_wickstar: calls $0.04
*** FLOP *** [8d 2c 3d]
vbg92: checks=20
the_wickstar: bets $0.14
vbg92: raises $0.18 to $0.32
the_wickstar: folds=20
Uncalled bet ($0.18) returned to vbg92
vbg92 collected $0.41 from pot
*** SUMMARY ***
Total pot $0.42 | Rake $0.01=20
Board [8d 2c 3d]
Seat 1: windy417 folded before Flop (didn't bet)
Seat 2: uilcm folded before Flop (didn't bet)
Seat 4: H1JackH1gh folded before Flop (didn't bet)
Seat 5: the_wickstar (button) folded on the Flop
Seat 6: vbg92 (small blind) collected ($0.41)
Seat 7: BRAT PIDD (big blind) folded before Flop
Seat 8: pdgnqn28 folded before Flop (didn't bet)
Seat 9: settecba folded before Flop (didn't bet)


*********** # 65 **************
PokerStars Hand #170016170278:  Hold'em No Limit ($0.01/$0.02 USD) - 20=
17/05/06 13:11:26 CUST [2017/05/05 23:11:26 ET]
Table 'Wodan' 9-max Seat #1 is the button
Seat 1: H1JackH1gh ($2.08 in chips)=20
Seat 2: alonwu ($1.98 in chips)=20
Seat 3: StarsEyeDee ($2.33 in chips)=20
Seat 5: Luks_Jr ($1.98 in chips)=20
Seat 6: 1Asthma1 ($2 in chips)=20
Seat 7: the_wickstar ($0.49 in chips)=20
Seat 9: rana3792 ($1.83 in chips)=20
alonwu: posts small blind $0.01
StarsEyeDee: posts big blind $0.02
Lanesra_90: sits out=20
Luigi507: sits out=20
*** HOLE CARDS ***
Dealt to the_wickstar [7c Qh]
Luks_Jr: folds=20
1Asthma1: folds=20
the_wickstar: folds=20
rana3792: calls $0.02
H1JackH1gh: folds=20
alonwu: folds=20
StarsEyeDee: checks=20
*** FLOP *** [5h Jc Kh]
StarsEyeDee: checks=20
rana3792: checks=20
*** TURN *** [5h Jc Kh] [3d]
StarsEyeDee: checks=20
rana3792: bets $0.02
StarsEyeDee: calls $0.02
*** RIVER *** [5h Jc Kh 3d] [Kc]
StarsEyeDee: checks=20
rana3792: bets $0.09
StarsEyeDee: folds=20
Uncalled bet ($0.09) returned to rana3792
rana3792 collected $0.09 from pot
rana3792: doesn't show hand=20
*** SUMMARY ***
Total pot $0.09 | Rake $0=20
Board [5h Jc Kh 3d Kc]
Seat 1: H1JackH1gh (button) folded before Flop (didn't bet)
Seat 2: alonwu (small blind) folded before Flop
Seat 3: StarsEyeDee (big blind) folded on the River
Seat 5: Luks_Jr folded before Flop (didn't bet)
Seat 6: 1Asthma1 folded before Flop (didn't bet)
Seat 7: the_wickstar folded before Flop (didn't bet)
Seat 9: rana3792 collected ($0.09)


*********** # 66 **************
PokerStars Hand #170016168601:  Hold'em No Limit ($0.01/$0.02 USD) - 20=
17/05/06 13:11:21 CUST [2017/05/05 23:11:21 ET]
Table 'Mathilde III' 9-max Seat #3 is the button
Seat 1: Kabit510 ($2.25 in chips)=20
Seat 3: howata ($2.19 in chips)=20
Seat 4: manugar91 ($2 in chips)=20
Seat 6: drinkedfish ($2.12 in chips)=20
Seat 7: July Van7 ($2 in chips)=20
Seat 8: the_wickstar ($2.59 in chips)=20
Seat 9: WadRambo ($2.15 in chips)=20
manugar91: posts small blind $0.01
drinkedfish: posts big blind $0.02
zecateto: sits out=20
*** HOLE CARDS ***
Dealt to the_wickstar [Ks 6d]
July Van7: folds=20
the_wickstar: folds=20
WadRambo: raises $0.16 to $0.18
Kabit510: folds=20
howata: folds=20
manugar91: folds=20
drinkedfish: folds=20
Uncalled bet ($0.16) returned to WadRambo
WadRambo collected $0.05 from pot
WadRambo: doesn't show hand=20
*** SUMMARY ***
Total pot $0.05 | Rake $0=20
Seat 1: Kabit510 folded before Flop (didn't bet)
Seat 3: howata (button) folded before Flop (didn't bet)
Seat 4: manugar91 (small blind) folded before Flop
Seat 6: drinkedfish (big blind) folded before Flop
Seat 7: July Van7 folded before Flop (didn't bet)
Seat 8: the_wickstar folded before Flop (didn't bet)
Seat 9: WadRambo collected ($0.05)


*********** # 67 **************
PokerStars Hand #170016168330:  Hold'em No Limit ($0.01/$0.02 USD) - 20=
17/05/06 13:11:20 CUST [2017/05/05 23:11:20 ET]
Table 'Diotima' 9-max Seat #4 is the button
Seat 1: windy417 ($2.03 in chips)=20
Seat 2: uilcm ($2.56 in chips)=20
Seat 4: H1JackH1gh ($3.15 in chips)=20
Seat 5: the_wickstar ($1.25 in chips)=20
Seat 6: vbg92 ($1.80 in chips)=20
Seat 7: BRAT PIDD ($2 in chips)=20
Seat 8: pdgnqn28 ($1.69 in chips)=20
Seat 9: settecba ($2.07 in chips)=20
the_wickstar: posts small blind $0.01
vbg92: posts big blind $0.02
*** HOLE CARDS ***
Dealt to the_wickstar [Ts 5h]
BRAT PIDD: folds=20
pdgnqn28: folds=20
settecba: folds=20
windy417: folds=20
uilcm: folds=20
H1JackH1gh: folds=20
the_wickstar: folds=20
Uncalled bet ($0.01) returned to vbg92
vbg92 collected $0.02 from pot
*** SUMMARY ***
Total pot $0.02 | Rake $0=20
Seat 1: windy417 folded before Flop (didn't bet)
Seat 2: uilcm folded before Flop (didn't bet)
Seat 4: H1JackH1gh (button) folded before Flop (didn't bet)
Seat 5: the_wickstar (small blind) folded before Flop
Seat 6: vbg92 (big blind) collected ($0.02)
Seat 7: BRAT PIDD folded before Flop (didn't bet)
Seat 8: pdgnqn28 folded before Flop (didn't bet)
Seat 9: settecba folded before Flop (didn't bet)


*********** # 68 **************
PokerStars Hand #170016158043:  Hold'em No Limit ($0.01/$0.02 USD) - 20=
17/05/06 13:10:50 CUST [2017/05/05 23:10:50 ET]
Table 'Diotima' 9-max Seat #2 is the button
Seat 1: windy417 ($2 in chips)=20
Seat 2: uilcm ($2.56 in chips)=20
Seat 4: H1JackH1gh ($3.16 in chips)=20
Seat 5: the_wickstar ($1.27 in chips)=20
Seat 6: vbg92 ($1.80 in chips)=20
Seat 7: BRAT PIDD ($2 in chips)=20
Seat 8: pdgnqn28 ($1.69 in chips)=20
Seat 9: settecba ($2.07 in chips)=20
H1JackH1gh: posts small blind $0.01
the_wickstar: posts big blind $0.02
*** HOLE CARDS ***
Dealt to the_wickstar [Jd 4s]
vbg92: folds=20
BRAT PIDD: folds=20
pdgnqn28: folds=20
settecba: folds=20
windy417: raises $0.04 to $0.06
uilcm: folds=20
H1JackH1gh: folds=20
the_wickstar: folds=20
Uncalled bet ($0.04) returned to windy417
windy417 collected $0.05 from pot
*** SUMMARY ***
Total pot $0.05 | Rake $0=20
Seat 1: windy417 collected ($0.05)
Seat 2: uilcm (button) folded before Flop (didn't bet)
Seat 4: H1JackH1gh (small blind) folded before Flop
Seat 5: the_wickstar (big blind) folded before Flop
Seat 6: vbg92 folded before Flop (didn't bet)
Seat 7: BRAT PIDD folded before Flop (didn't bet)
Seat 8: pdgnqn28 folded before Flop (didn't bet)
Seat 9: settecba folded before Flop (didn't bet)


*********** # 69 **************
PokerStars Hand #170016150308:  Hold'em No Limit ($0.01/$0.02 USD) - 20=
17/05/06 13:10:28 CUST [2017/05/05 23:10:28 ET]
Table 'Wodan' 9-max Seat #9 is the button
Seat 1: H1JackH1gh ($2.09 in chips)=20
Seat 2: alonwu ($2 in chips)=20
Seat 3: StarsEyeDee ($2.33 in chips)=20
Seat 5: Luks_Jr ($2 in chips)=20
Seat 6: 1Asthma1 ($2 in chips)=20
Seat 7: the_wickstar ($0.44 in chips)=20
Seat 9: rana3792 ($1.83 in chips)=20
H1JackH1gh: posts small blind $0.01
alonwu: posts big blind $0.02
Lanesra_90: sits out=20
Luks_Jr: posts big blind $0.02
Luigi507: sits out=20
*** HOLE CARDS ***
Dealt to the_wickstar [6h Ah]
StarsEyeDee: folds=20
Luks_Jr: checks=20
1Asthma1: folds=20
the_wickstar: calls $0.02
rana3792: folds=20
H1JackH1gh: folds=20
alonwu: checks=20
*** FLOP *** [2c Td Ac]
alonwu: checks=20
Luks_Jr: checks=20
the_wickstar: bets $0.03
alonwu: folds=20
Luks_Jr: folds=20
Uncalled bet ($0.03) returned to the_wickstar
the_wickstar collected $0.07 from pot
*** SUMMARY ***
Total pot $0.07 | Rake $0=20
Board [2c Td Ac]
Seat 1: H1JackH1gh (small blind) folded before Flop
Seat 2: alonwu (big blind) folded on the Flop
Seat 3: StarsEyeDee folded before Flop (didn't bet)
Seat 5: Luks_Jr folded on the Flop
Seat 6: 1Asthma1 folded before Flop (didn't bet)
Seat 7: the_wickstar collected ($0.07)
Seat 9: rana3792 (button) folded before Flop (didn't bet)


*********** # 70 **************
PokerStars Hand #170016147133:  Hold'em No Limit ($0.01/$0.02 USD) - 20=
17/05/06 13:10:19 CUST [2017/05/05 23:10:19 ET]
Table 'Mathilde III' 9-max Seat #1 is the button
Seat 1: Kabit510 ($2.25 in chips)=20
Seat 3: howata ($2.20 in chips)=20
Seat 4: manugar91 ($2 in chips)=20
Seat 6: drinkedfish ($2.12 in chips)=20
Seat 7: July Van7 ($2 in chips)=20
Seat 8: the_wickstar ($2.59 in chips)=20
Seat 9: WadRambo ($1.97 in chips)=20
zecateto will be allowed to play after the button
howata: posts small blind $0.01
manugar91: posts big blind $0.02
*** HOLE CARDS ***
Dealt to the_wickstar [8c 4d]
drinkedfish: folds=20
July Van7: folds=20
the_wickstar: folds=20
WadRambo: calls $0.02
Kabit510: folds=20
howata: folds=20
manugar91: checks=20
*** FLOP *** [5d Qd Ts]
manugar91: checks=20
WadRambo: bets $0.16
manugar91: calls $0.16
*** TURN *** [5d Qd Ts] [4c]
manugar91: checks=20
WadRambo: bets $0.36
manugar91: folds=20
Uncalled bet ($0.36) returned to WadRambo
WadRambo collected $0.36 from pot
WadRambo: doesn't show hand=20
*** SUMMARY ***
Total pot $0.37 | Rake $0.01=20
Board [5d Qd Ts 4c]
Seat 1: Kabit510 (button) folded before Flop (didn't bet)
Seat 3: howata (small blind) folded before Flop
Seat 4: manugar91 (big blind) folded on the Turn
Seat 6: drinkedfish folded before Flop (didn't bet)
Seat 7: July Van7 folded before Flop (didn't bet)
Seat 8: the_wickstar folded before Flop (didn't bet)
Seat 9: WadRambo collected ($0.36)


*********** # 71 **************
PokerStars Hand #170016144519:  Hold'em No Limit ($0.01/$0.02 USD) - 20=
17/05/06 13:10:12 CUST [2017/05/05 23:10:12 ET]
Table 'Diotima' 9-max Seat #1 is the button
Seat 1: windy417 ($2.03 in chips)=20
Seat 2: uilcm ($2.57 in chips)=20
Seat 4: H1JackH1gh ($2.98 in chips)=20
Seat 5: the_wickstar ($1.27 in chips)=20
Seat 6: vbg92 ($1.80 in chips)=20
Seat 7: BRAT PIDD ($2 in chips)=20
Seat 8: pdgnqn28 ($1.69 in chips)=20
Seat 9: settecba ($2.07 in chips)=20
uilcm: posts small blind $0.01
H1JackH1gh: posts big blind $0.02
*** HOLE CARDS ***
Dealt to the_wickstar [7s Td]
the_wickstar: folds=20
vbg92: folds=20
BRAT PIDD: folds=20
pdgnqn28: folds=20
settecba: folds=20
windy417: raises $0.04 to $0.06
uilcm: folds=20
H1JackH1gh: raises $0.12 to $0.18
windy417: calls $0.12
*** FLOP *** [2c Qs 8s]
H1JackH1gh: bets $0.18
windy417: folds=20
Uncalled bet ($0.18) returned to H1JackH1gh
H1JackH1gh collected $0.36 from pot
H1JackH1gh: doesn't show hand=20
*** SUMMARY ***
Total pot $0.37 | Rake $0.01=20
Board [2c Qs 8s]
Seat 1: windy417 (button) folded on the Flop
Seat 2: uilcm (small blind) folded before Flop
Seat 4: H1JackH1gh (big blind) collected ($0.36)
Seat 5: the_wickstar folded before Flop (didn't bet)
Seat 6: vbg92 folded before Flop (didn't bet)
Seat 7: BRAT PIDD folded before Flop (didn't bet)
Seat 8: pdgnqn28 folded before Flop (didn't bet)
Seat 9: settecba folded before Flop (didn't bet)


*********** # 72 **************
PokerStars Hand #170016137731:  Hold'em No Limit ($0.01/$0.02 USD) - 20=
17/05/06 13:09:52 CUST [2017/05/05 23:09:52 ET]
Table 'Wodan' 9-max Seat #7 is the button
Seat 1: H1JackH1gh ($2.11 in chips)=20
Seat 3: StarsEyeDee ($2.33 in chips)=20
Seat 6: 1Asthma1 ($2 in chips)=20
Seat 7: the_wickstar ($0.41 in chips)=20
Seat 9: rana3792 ($1.84 in chips)=20
rana3792: posts small blind $0.01
H1JackH1gh: posts big blind $0.02
alonwu: sits out=20
Lanesra_90: sits out=20
Luks_Jr: sits out=20
*** HOLE CARDS ***
Dealt to the_wickstar [Jh Qd]
Luigi507 joins the table at seat #8=20
StarsEyeDee: folds=20
1Asthma1: folds=20
the_wickstar: calls $0.02
rana3792: folds=20
H1JackH1gh: checks=20
*** FLOP *** [Ah Ad Qs]
H1JackH1gh: checks=20
the_wickstar: bets $0.03
H1JackH1gh: folds=20
Uncalled bet ($0.03) returned to the_wickstar
the_wickstar collected $0.05 from pot
*** SUMMARY ***
Total pot $0.05 | Rake $0=20
Board [Ah Ad Qs]
Seat 1: H1JackH1gh (big blind) folded on the Flop
Seat 3: StarsEyeDee folded before Flop (didn't bet)
Seat 6: 1Asthma1 folded before Flop (didn't bet)
Seat 7: the_wickstar (button) collected ($0.05)
Seat 9: rana3792 (small blind) folded before Flop


*********** # 73 **************
PokerStars Hand #170016133486:  Hold'em No Limit ($0.01/$0.02 USD) - 20=
17/05/06 13:09:40 CUST [2017/05/05 23:09:40 ET]
Table 'Mathilde III' 9-max Seat #9 is the button
Seat 1: Kabit510 ($2.26 in chips)=20
Seat 3: howata ($2.19 in chips)=20
Seat 4: manugar91 ($2 in chips)=20
Seat 6: drinkedfish ($2.12 in chips)=20
Seat 7: July Van7 ($2 in chips)=20
Seat 8: the_wickstar ($2.59 in chips)=20
Seat 9: WadRambo ($1.97 in chips)=20
Kabit510: posts small blind $0.01
howata: posts big blind $0.02
*** HOLE CARDS ***
Dealt to the_wickstar [5s 8d]
manugar91: folds=20
drinkedfish: folds=20
July Van7: folds=20
the_wickstar: folds=20
WadRambo: folds=20
Kabit510: folds=20
Uncalled bet ($0.01) returned to howata
howata collected $0.02 from pot
howata: doesn't show hand=20
*** SUMMARY ***
Total pot $0.02 | Rake $0=20
Seat 1: Kabit510 (small blind) folded before Flop
Seat 3: howata (big blind) collected ($0.02)
Seat 4: manugar91 folded before Flop (didn't bet)
Seat 6: drinkedfish folded before Flop (didn't bet)
Seat 7: July Van7 folded before Flop (didn't bet)
Seat 8: the_wickstar folded before Flop (didn't bet)
Seat 9: WadRambo (button) folded before Flop (didn't bet)


*********** # 74 **************
PokerStars Hand #170016126879:  Hold'em No Limit ($0.01/$0.02 USD) - 20=
17/05/06 13:09:21 CUST [2017/05/05 23:09:21 ET]
Table 'Wodan' 9-max Seat #6 is the button
Seat 3: StarsEyeDee ($2.33 in chips)=20
Seat 5: diment76 ($1.89 in chips)=20
Seat 6: 1Asthma1 ($2 in chips)=20
Seat 7: the_wickstar ($0.42 in chips)=20
Seat 9: rana3792 ($1.83 in chips)=20
JOSSEPH K leaves the table
the_wickstar: posts small blind $0.01
rana3792: posts big blind $0.02
H1JackH1gh: sits out=20
alonwu: sits out=20
Lanesra_90: sits out=20
*** HOLE CARDS ***
Dealt to the_wickstar [Ah 5h]
StarsEyeDee: folds=20
diment76: folds=20
diment76 leaves the table
1Asthma1: folds=20
the_wickstar: folds=20
Uncalled bet ($0.01) returned to rana3792
Luks_Jr joins the table at seat #5=20
rana3792 collected $0.02 from pot
rana3792: doesn't show hand=20
*** SUMMARY ***
Total pot $0.02 | Rake $0=20
Seat 3: StarsEyeDee folded before Flop (didn't bet)
Seat 5: diment76 folded before Flop (didn't bet)
Seat 6: 1Asthma1 (button) folded before Flop (didn't bet)
Seat 7: the_wickstar (small blind) folded before Flop
Seat 9: rana3792 (big blind) collected ($0.02)


*********** # 75 **************
PokerStars Hand #170016124127:  Hold'em No Limit ($0.01/$0.02 USD) - 20=
17/05/06 13:09:13 CUST [2017/05/05 23:09:13 ET]
Table 'Diotima' 9-max Seat #9 is the button
Seat 1: windy417 ($2.02 in chips)=20
Seat 2: uilcm ($2.59 in chips)=20
Seat 5: the_wickstar ($1.26 in chips)=20
Seat 6: vbg92 ($1.80 in chips)=20
Seat 7: BRAT PIDD ($2 in chips)=20
Seat 8: pdgnqn28 ($1.69 in chips)=20
Seat 9: settecba ($2.07 in chips)=20
windy417: posts small blind $0.01
uilcm: posts big blind $0.02
H1JackH1gh: sits out=20
*** HOLE CARDS ***
Dealt to the_wickstar [Th Jc]
the_wickstar: raises $0.02 to $0.04
vbg92: folds=20
BRAT PIDD: folds=20
pdgnqn28: folds=20
settecba: folds=20
windy417: calls $0.03
uilcm: folds=20
*** FLOP *** [7d 7c Qs]
windy417: checks=20
the_wickstar: checks=20
*** TURN *** [7d 7c Qs] [2c]
windy417: checks=20
the_wickstar: checks=20
*** RIVER *** [7d 7c Qs 2c] [3d]
windy417: checks=20
the_wickstar: checks=20
*** SHOW DOWN ***
windy417: shows [Js Ts] (a pair of Sevens)
the_wickstar: shows [Th Jc] (a pair of Sevens)
windy417 collected $0.05 from pot
the_wickstar collected $0.05 from pot
*** SUMMARY ***
Total pot $0.10 | Rake $0=20
Board [7d 7c Qs 2c 3d]
Seat 1: windy417 (small blind) showed [Js Ts] and won ($0.05) with a pa=
ir of Sevens
Seat 2: uilcm (big blind) folded before Flop
Seat 5: the_wickstar showed [Th Jc] and won ($0.05) with a pair of Seve=
ns
Seat 6: vbg92 folded before Flop (didn't bet)
Seat 7: BRAT PIDD folded before Flop (didn't bet)
Seat 8: pdgnqn28 folded before Flop (didn't bet)
Seat 9: settecba (button) folded before Flop (didn't bet)


*********** # 76 **************
PokerStars Hand #170016103994:  Hold'em No Limit ($0.01/$0.02 USD) - 20=
17/05/06 13:08:28 CUST [2017/05/05 23:08:28 ET]
Table 'Diotima' 9-max Seat #8 is the button
Seat 1: windy417 ($2.04 in chips)=20
Seat 2: uilcm ($2.59 in chips)=20
Seat 3: guga01101974 ($1.91 in chips)=20
Seat 5: the_wickstar ($1.26 in chips)=20
Seat 6: vbg92 ($1.77 in chips)=20
Seat 7: BRAT PIDD ($2 in chips)=20
Seat 8: pdgnqn28 ($1.69 in chips)=20
Seat 9: settecba ($2.08 in chips)=20
settecba: posts small blind $0.01
windy417: posts big blind $0.02
H1JackH1gh: sits out=20
*** HOLE CARDS ***
Dealt to the_wickstar [2d Ah]
uilcm: folds=20
guga01101974 has timed out
guga01101974: folds=20
the_wickstar: folds=20
vbg92: raises $0.04 to $0.06
BRAT PIDD: folds=20
pdgnqn28: folds=20
settecba: folds=20
windy417: folds=20
Uncalled bet ($0.04) returned to vbg92
vbg92 collected $0.05 from pot
*** SUMMARY ***
Total pot $0.05 | Rake $0=20
Seat 1: windy417 (big blind) folded before Flop
Seat 2: uilcm folded before Flop (didn't bet)
Seat 3: guga01101974 folded before Flop (didn't bet)
Seat 5: the_wickstar folded before Flop (didn't bet)
Seat 6: vbg92 collected ($0.05)
Seat 7: BRAT PIDD folded before Flop (didn't bet)
Seat 8: pdgnqn28 (button) folded before Flop (didn't bet)
Seat 9: settecba (small blind) folded before Flop


*********** # 77 **************
PokerStars Hand #170016103889:  Hold'em No Limit ($0.01/$0.02 USD) - 20=
17/05/06 13:08:28 CUST [2017/05/05 23:08:28 ET]
Table 'Wodan' 9-max Seat #5 is the button
Seat 3: StarsEyeDee ($2.33 in chips)=20
Seat 5: diment76 ($1.81 in chips)=20
Seat 6: 1Asthma1 ($2 in chips)=20
Seat 7: the_wickstar ($0.44 in chips)=20
Seat 8: JOSSEPH K ($2.03 in chips)=20
Seat 9: rana3792 ($1.83 in chips)=20
1Asthma1: posts small blind $0.01
the_wickstar: posts big blind $0.02
H1JackH1gh: sits out=20
alonwu is connected=20
alonwu: sits out=20
Lanesra_90: sits out=20
*** HOLE CARDS ***
Dealt to the_wickstar [Qc 2c]
JOSSEPH K: calls $0.02
rana3792: folds=20
StarsEyeDee: folds=20
diment76: raises $0.04 to $0.06
1Asthma1: folds=20
the_wickstar: folds=20
JOSSEPH K: calls $0.04
*** FLOP *** [8d As Qs]
JOSSEPH K: checks=20
diment76: bets $0.07
JOSSEPH K: folds=20
Uncalled bet ($0.07) returned to diment76
diment76 collected $0.14 from pot
*** SUMMARY ***
Total pot $0.15 | Rake $0.01=20
Board [8d As Qs]
Seat 3: StarsEyeDee folded before Flop (didn't bet)
Seat 5: diment76 (button) collected ($0.14)
Seat 6: 1Asthma1 (small blind) folded before Flop
Seat 7: the_wickstar (big blind) folded before Flop
Seat 8: JOSSEPH K folded on the Flop
Seat 9: rana3792 folded before Flop (didn't bet)


*********** # 78 **************
PokerStars Hand #170016102814:  Hold'em No Limit ($0.01/$0.02 USD) - 20=
17/05/06 13:08:25 CUST [2017/05/05 23:08:25 ET]
Table 'Mathilde III' 9-max Seat #8 is the button
Seat 1: Kabit510 ($2.28 in chips)=20
Seat 3: howata ($2.19 in chips)=20
Seat 4: manugar91 ($2 in chips)=20
Seat 6: drinkedfish ($2.12 in chips)=20
Seat 7: July Van7 ($2 in chips)=20
Seat 8: the_wickstar ($2.59 in chips)=20
Seat 9: WadRambo ($1.95 in chips)=20
WadRambo: posts small blind $0.01
Kabit510: posts big blind $0.02
*** HOLE CARDS ***
Dealt to the_wickstar [6d 5c]
howata: folds=20
manugar91: folds=20
drinkedfish: folds=20
July Van7: folds=20
the_wickstar: folds=20
WadRambo: calls $0.01
Kabit510: checks=20
*** FLOP *** [Td 8h 2c]
WadRambo: bets $0.04
Kabit510: folds=20
Uncalled bet ($0.04) returned to WadRambo
WadRambo collected $0.04 from pot
WadRambo: doesn't show hand=20
*** SUMMARY ***
Total pot $0.04 | Rake $0=20
Board [Td 8h 2c]
Seat 1: Kabit510 (big blind) folded on the Flop
Seat 3: howata folded before Flop (didn't bet)
Seat 4: manugar91 folded before Flop (didn't bet)
Seat 6: drinkedfish folded before Flop (didn't bet)
Seat 7: July Van7 folded before Flop (didn't bet)
Seat 8: the_wickstar (button) folded before Flop (didn't bet)
Seat 9: WadRambo (small blind) collected ($0.04)


*********** # 79 **************
PokerStars Hand #170016094483:  Hold'em No Limit ($0.01/$0.02 USD) - 20=
17/05/06 13:08:01 CUST [2017/05/05 23:08:01 ET]
Table 'Diotima' 9-max Seat #7 is the button
Seat 2: uilcm ($2.59 in chips)=20
Seat 3: guga01101974 ($1.91 in chips)=20
Seat 5: the_wickstar ($1.26 in chips)=20
Seat 6: vbg92 ($1.74 in chips)=20
Seat 7: BRAT PIDD ($2 in chips)=20
Seat 8: pdgnqn28 ($1.70 in chips)=20
Seat 9: settecba ($2.10 in chips)=20
pdgnqn28: posts small blind $0.01
settecba: posts big blind $0.02
windy417: sits out=20
H1JackH1gh: sits out=20
*** HOLE CARDS ***
Dealt to the_wickstar [9d 6s]
uilcm: folds=20
guga01101974: folds=20
the_wickstar: folds=20
vbg92: raises $0.04 to $0.06
BRAT PIDD: folds=20
pdgnqn28: folds=20
settecba: folds=20
Uncalled bet ($0.04) returned to vbg92
vbg92 collected $0.05 from pot
*** SUMMARY ***
Total pot $0.05 | Rake $0=20
Seat 2: uilcm folded before Flop (didn't bet)
Seat 3: guga01101974 folded before Flop (didn't bet)
Seat 5: the_wickstar folded before Flop (didn't bet)
Seat 6: vbg92 collected ($0.05)
Seat 7: BRAT PIDD (button) folded before Flop (didn't bet)
Seat 8: pdgnqn28 (small blind) folded before Flop
Seat 9: settecba (big blind) folded before Flop


*********** # 80 **************
PokerStars Hand #170016080078:  Hold'em No Limit ($0.01/$0.02 USD) - 20=
17/05/06 13:07:19 CUST [2017/05/05 23:07:19 ET]
Table 'Wodan' 9-max Seat #3 is the button
Seat 3: StarsEyeDee ($2.27 in chips)=20
Seat 5: diment76 ($1.83 in chips)=20
Seat 6: 1Asthma1 ($2 in chips)=20
Seat 7: the_wickstar ($0.44 in chips)=20
Seat 8: JOSSEPH K ($2.03 in chips)=20
Seat 9: rana3792 ($1.85 in chips)=20
Lanesra_90 will be allowed to play after the button
diment76: posts small blind $0.01
1Asthma1: posts big blind $0.02
H1JackH1gh: sits out=20
alonwu: sits out=20
*** HOLE CARDS ***
Dealt to the_wickstar [8d Qs]
the_wickstar: folds=20
JOSSEPH K: folds=20
rana3792: calls $0.02
StarsEyeDee: calls $0.02
diment76: calls $0.01
1Asthma1: checks=20
*** FLOP *** [6h Th Jd]
diment76: checks=20
1Asthma1: checks=20
rana3792: checks=20
StarsEyeDee: bets $0.06
diment76: folds=20
alonwu is disconnected=20
1Asthma1: folds=20
rana3792: folds=20
Uncalled bet ($0.06) returned to StarsEyeDee
StarsEyeDee collected $0.08 from pot
StarsEyeDee: doesn't show hand=20
*** SUMMARY ***
Total pot $0.08 | Rake $0=20
Board [6h Th Jd]
Seat 3: StarsEyeDee (button) collected ($0.08)
Seat 5: diment76 (small blind) folded on the Flop
Seat 6: 1Asthma1 (big blind) folded on the Flop
Seat 7: the_wickstar folded before Flop (didn't bet)
Seat 8: JOSSEPH K folded before Flop (didn't bet)
Seat 9: rana3792 folded on the Flop


*********** # 81 **************
PokerStars Hand #170016074561:  Hold'em No Limit ($0.01/$0.02 USD) - 20=
17/05/06 13:07:04 CUST [2017/05/05 23:07:04 ET]
Table 'Mathilde III' 9-max Seat #7 is the button
Seat 1: Kabit510 ($2.28 in chips)=20
Seat 3: howata ($2.19 in chips)=20
Seat 4: manugar91 ($2 in chips)=20
Seat 6: drinkedfish ($2.28 in chips)=20
Seat 7: July Van7 ($2.07 in chips)=20
Seat 8: the_wickstar ($2.60 in chips)=20
Seat 9: WadRambo ($1.60 in chips)=20
the_wickstar: posts small blind $0.01
WadRambo: posts big blind $0.02
*** HOLE CARDS ***
Dealt to the_wickstar [3c 2s]
Kabit510: folds=20
howata: folds=20
manugar91: folds=20
drinkedfish: raises $0.03 to $0.05
July Van7: raises $0.11 to $0.16
the_wickstar: folds=20
WadRambo: calls $0.14
drinkedfish: calls $0.11
*** FLOP *** [7d Kc 3d]
WadRambo: bets $0.04
drinkedfish: folds=20
July Van7: calls $0.04
*** TURN *** [7d Kc 3d] [3s]
WadRambo: bets $0.32
July Van7: folds=20
Uncalled bet ($0.32) returned to WadRambo
WadRambo collected $0.55 from pot
WadRambo: doesn't show hand=20
*** SUMMARY ***
Total pot $0.57 | Rake $0.02=20
Board [7d Kc 3d 3s]
Seat 1: Kabit510 folded before Flop (didn't bet)
Seat 3: howata folded before Flop (didn't bet)
Seat 4: manugar91 folded before Flop (didn't bet)
Seat 6: drinkedfish folded on the Flop
Seat 7: July Van7 (button) folded on the Turn
Seat 8: the_wickstar (small blind) folded before Flop
Seat 9: WadRambo (big blind) collected ($0.55)


*********** # 82 **************
PokerStars Hand #170016056430:  Hold'em No Limit ($0.01/$0.02 USD) - 20=
17/05/06 13:06:12 CUST [2017/05/05 23:06:12 ET]
Table 'Mathilde III' 9-max Seat #6 is the button
Seat 1: Kabit510 ($2.28 in chips)=20
Seat 3: howata ($2.19 in chips)=20
Seat 4: manugar91 ($2 in chips)=20
Seat 6: drinkedfish ($2.28 in chips)=20
Seat 7: July Van7 ($2.08 in chips)=20
Seat 8: the_wickstar ($2.59 in chips)=20
Seat 9: Luks_Jr ($2.10 in chips)=20
July Van7: posts small blind $0.01
the_wickstar: posts big blind $0.02
*** HOLE CARDS ***
Dealt to the_wickstar [6c Th]
Luks_Jr: folds=20
Kabit510: folds=20
howata: folds=20
manugar91: folds=20
Luks_Jr leaves the table
drinkedfish: folds=20
WadRambo joins the table at seat #9=20
July Van7: folds=20
Uncalled bet ($0.01) returned to the_wickstar
the_wickstar collected $0.02 from pot
*** SUMMARY ***
Total pot $0.02 | Rake $0=20
Seat 1: Kabit510 folded before Flop (didn't bet)
Seat 3: howata folded before Flop (didn't bet)
Seat 4: manugar91 folded before Flop (didn't bet)
Seat 6: drinkedfish (button) folded before Flop (didn't bet)
Seat 7: July Van7 (small blind) folded before Flop
Seat 8: the_wickstar (big blind) collected ($0.02)
Seat 9: Luks_Jr folded before Flop (didn't bet)


*********** # 83 **************
PokerStars Hand #170016053303:  Hold'em No Limit ($0.01/$0.02 USD) - 20=
17/05/06 13:06:03 CUST [2017/05/05 23:06:03 ET]
Table 'Wodan' 9-max Seat #9 is the button
Seat 3: StarsEyeDee ($2.28 in chips)=20
Seat 5: diment76 ($1.94 in chips)=20
Seat 7: the_wickstar ($0.22 in chips)=20
Seat 8: JOSSEPH K ($2.03 in chips)=20
Seat 9: rana3792 ($1.96 in chips)=20
H1JackH1gh will be allowed to play after the button
alonwu will be allowed to play after the button
StarsEyeDee: posts small blind $0.01
diment76: posts big blind $0.02
1Asthma1: sits out=20
*** HOLE CARDS ***
Dealt to the_wickstar [Kd Ah]
the_wickstar: raises $0.02 to $0.04
JOSSEPH K: folds=20
rana3792: calls $0.04
StarsEyeDee: folds=20
diment76: calls $0.02
*** FLOP *** [Qd 9d Ts]
diment76: bets $0.07
the_wickstar: calls $0.07
rana3792: calls $0.07
*** TURN *** [Qd 9d Ts] [Ad]
diment76: checks=20
the_wickstar: bets $0.11 and is all-in
rana3792: folds=20
diment76: folds=20
Uncalled bet ($0.11) returned to the_wickstar
the_wickstar collected $0.33 from pot
*** SUMMARY ***
Total pot $0.34 | Rake $0.01=20
Board [Qd 9d Ts Ad]
Seat 3: StarsEyeDee (small blind) folded before Flop
Seat 5: diment76 (big blind) folded on the Turn
Seat 7: the_wickstar collected ($0.33)
Seat 8: JOSSEPH K folded before Flop (didn't bet)
Seat 9: rana3792 (button) folded on the Turn


*********** # 84 **************
PokerStars Hand #170016048973:  Hold'em No Limit ($0.01/$0.02 USD) - 20=
17/05/06 13:05:52 CUST [2017/05/05 23:05:52 ET]
Table 'Diotima' 9-max Seat #6 is the button
Seat 2: uilcm ($2.15 in chips)=20
Seat 3: guga01101974 ($1.91 in chips)=20
Seat 5: the_wickstar ($1.64 in chips)=20
Seat 6: vbg92 ($1.80 in chips)=20
Seat 7: BRAT PIDD ($2 in chips)=20
Seat 8: pdgnqn28 ($1.72 in chips)=20
Seat 9: settecba ($2.10 in chips)=20
BRAT PIDD: posts small blind $0.01
pdgnqn28: posts big blind $0.02
windy417: sits out=20
*** HOLE CARDS ***
Dealt to the_wickstar [Th Qs]
settecba: folds=20
uilcm: raises $0.04 to $0.06
guga01101974: folds=20
the_wickstar: calls $0.06
vbg92: calls $0.06
BRAT PIDD: folds=20
pdgnqn28: folds=20
*** FLOP *** [Tc Ad 7d]
uilcm: bets $0.11
the_wickstar: calls $0.11
vbg92: folds=20
*** TURN *** [Tc Ad 7d] [2d]
uilcm: checks=20
the_wickstar: bets $0.21
uilcm: calls $0.21
*** RIVER *** [Tc Ad 7d 2d] [Kc]
uilcm: checks=20
the_wickstar: checks=20
*** SHOW DOWN ***
uilcm: shows [Qh Ah] (a pair of Aces)
the_wickstar: mucks hand=20
uilcm collected $0.82 from pot
*** SUMMARY ***
Total pot $0.85 | Rake $0.03=20
Board [Tc Ad 7d 2d Kc]
Seat 2: uilcm showed [Qh Ah] and won ($0.82) with a pair of Aces
Seat 3: guga01101974 folded before Flop (didn't bet)
Seat 5: the_wickstar mucked [Th Qs]
Seat 6: vbg92 (button) folded on the Flop
Seat 7: BRAT PIDD (small blind) folded before Flop
Seat 8: pdgnqn28 (big blind) folded before Flop
Seat 9: settecba folded before Flop (didn't bet)


*********** # 85 **************
PokerStars Hand #170016047716:  Hold'em No Limit ($0.01/$0.02 USD) - 20=
17/05/06 13:05:48 CUST [2017/05/05 23:05:48 ET]
Table 'Wodan' 9-max Seat #8 is the button
Seat 3: StarsEyeDee ($2.27 in chips)=20
Seat 4: Lanesra_90 ($2.54 in chips)=20
Seat 5: diment76 ($1.94 in chips)=20
Seat 7: the_wickstar ($0.22 in chips)=20
Seat 8: JOSSEPH K ($2.03 in chips)=20
Seat 9: rana3792 ($1.97 in chips)=20
rana3792: posts small blind $0.01
VishegasM: is sitting out=20
StarsEyeDee: posts big blind $0.02
1Asthma1: sits out=20
*** HOLE CARDS ***
Dealt to the_wickstar [Td 2s]
VishegasM leaves the table
Lanesra_90: folds=20
diment76: folds=20
the_wickstar: folds=20
alonwu joins the table at seat #2=20
JOSSEPH K: folds=20
rana3792: folds=20
Uncalled bet ($0.01) returned to StarsEyeDee
StarsEyeDee collected $0.02 from pot
StarsEyeDee: doesn't show hand=20
*** SUMMARY ***
Total pot $0.02 | Rake $0=20
Seat 3: StarsEyeDee (big blind) collected ($0.02)
Seat 4: Lanesra_90 folded before Flop (didn't bet)
Seat 5: diment76 folded before Flop (didn't bet)
Seat 7: the_wickstar folded before Flop (didn't bet)
Seat 8: JOSSEPH K (button) folded before Flop (didn't bet)
Seat 9: rana3792 (small blind) folded before Flop


*********** # 86 **************
PokerStars Hand #170016036409:  Hold'em No Limit ($0.01/$0.02 USD) - 20=
17/05/06 13:05:16 CUST [2017/05/05 23:05:16 ET]
Table 'Mathilde III' 9-max Seat #4 is the button
Seat 1: Kabit510 ($2.25 in chips)=20
Seat 3: howata ($2.19 in chips)=20
Seat 4: manugar91 ($2 in chips)=20
Seat 6: drinkedfish ($2.29 in chips)=20
Seat 7: July Van7 ($2.10 in chips)=20
Seat 8: the_wickstar ($2.59 in chips)=20
Seat 9: Luks_Jr ($2.10 in chips)=20
drinkedfish: posts small blind $0.01
July Van7: posts big blind $0.02
*** HOLE CARDS ***
Dealt to the_wickstar [Kh 9d]
the_wickstar: folds=20
Luks_Jr: folds=20
Kabit510: raises $0.04 to $0.06
howata: folds=20
manugar91: folds=20
drinkedfish: folds=20
July Van7: folds=20
Uncalled bet ($0.04) returned to Kabit510
Kabit510 collected $0.05 from pot
Kabit510: doesn't show hand=20
*** SUMMARY ***
Total pot $0.05 | Rake $0=20
Seat 1: Kabit510 collected ($0.05)
Seat 3: howata folded before Flop (didn't bet)
Seat 4: manugar91 (button) folded before Flop (didn't bet)
Seat 6: drinkedfish (small blind) folded before Flop
Seat 7: July Van7 (big blind) folded before Flop
Seat 8: the_wickstar folded before Flop (didn't bet)
Seat 9: Luks_Jr folded before Flop (didn't bet)


*********** # 87 **************
PokerStars Hand #170016035031:  Hold'em No Limit ($0.01/$0.02 USD) - 20=
17/05/06 13:05:13 CUST [2017/05/05 23:05:13 ET]
Table 'Wodan' 9-max Seat #7 is the button
Seat 2: VishegasM ($2.71 in chips)=20
Seat 3: StarsEyeDee ($2.27 in chips)=20
Seat 4: Lanesra_90 ($2.54 in chips)=20
Seat 5: diment76 ($1.94 in chips)=20
Seat 6: Souljacker87 ($8.54 in chips)=20
Seat 7: the_wickstar ($0.22 in chips)=20
Seat 8: JOSSEPH K ($2.01 in chips)=20
Seat 9: rana3792 ($1.99 in chips)=20
JOSSEPH K: posts small blind $0.01
rana3792: posts big blind $0.02
*** HOLE CARDS ***
Dealt to the_wickstar [3d Jh]
VishegasM: folds=20
StarsEyeDee: folds=20
Lanesra_90: folds=20
diment76: folds=20
Souljacker87: folds=20
the_wickstar: folds=20
Souljacker87 leaves the table
1Asthma1 joins the table at seat #6=20
JOSSEPH K: raises $0.06 to $0.08
rana3792: folds=20
Uncalled bet ($0.06) returned to JOSSEPH K
JOSSEPH K collected $0.04 from pot
JOSSEPH K: doesn't show hand=20
*** SUMMARY ***
Total pot $0.04 | Rake $0=20
Seat 2: VishegasM folded before Flop (didn't bet)
Seat 3: StarsEyeDee folded before Flop (didn't bet)
Seat 4: Lanesra_90 folded before Flop (didn't bet)
Seat 5: diment76 folded before Flop (didn't bet)
Seat 6: Souljacker87 folded before Flop (didn't bet)
Seat 7: the_wickstar (button) folded before Flop (didn't bet)
Seat 8: JOSSEPH K (small blind) collected ($0.04)
Seat 9: rana3792 (big blind) folded before Flop


*********** # 88 **************
PokerStars Hand #170016021642:  Hold'em No Limit ($0.01/$0.02 USD) - 20=
17/05/06 13:04:35 CUST [2017/05/05 23:04:35 ET]
Table 'Diotima' 9-max Seat #5 is the button
Seat 2: uilcm ($2.15 in chips)=20
Seat 3: guga01101974 ($1.99 in chips)=20
Seat 5: the_wickstar ($1.64 in chips)=20
Seat 6: vbg92 ($1.81 in chips)=20
Seat 7: BRAT PIDD ($2 in chips)=20
Seat 8: pdgnqn28 ($1.72 in chips)=20
Seat 9: settecba ($2 in chips)=20
vbg92: posts small blind $0.01
BRAT PIDD: posts big blind $0.02
windy417: sits out=20
*** HOLE CARDS ***
Dealt to the_wickstar [5s Kc]
pdgnqn28: folds=20
settecba: raises $0.06 to $0.08
uilcm: folds=20
guga01101974: calls $0.08
the_wickstar: folds=20
vbg92: folds=20
BRAT PIDD: folds=20
*** FLOP *** [3s As Qd]
settecba: checks=20
guga01101974: checks=20
*** TURN *** [3s As Qd] [8h]
settecba: bets $0.12
guga01101974: folds=20
Uncalled bet ($0.12) returned to settecba
settecba collected $0.18 from pot
settecba: doesn't show hand=20
*** SUMMARY ***
Total pot $0.19 | Rake $0.01=20
Board [3s As Qd 8h]
Seat 2: uilcm folded before Flop (didn't bet)
Seat 3: guga01101974 folded on the Turn
Seat 5: the_wickstar (button) folded before Flop (didn't bet)
Seat 6: vbg92 (small blind) folded before Flop
Seat 7: BRAT PIDD (big blind) folded before Flop
Seat 8: pdgnqn28 folded before Flop (didn't bet)
Seat 9: settecba collected ($0.18)


*********** # 89 **************
PokerStars Hand #170016013680:  Hold'em No Limit ($0.01/$0.02 USD) - 20=
17/05/06 13:04:12 CUST [2017/05/05 23:04:12 ET]
Table 'Wodan' 9-max Seat #6 is the button
Seat 2: VishegasM ($2.71 in chips)=20
Seat 3: StarsEyeDee ($2.27 in chips)=20
Seat 4: Lanesra_90 ($2.54 in chips)=20
Seat 5: diment76 ($1.94 in chips)=20
Seat 6: Souljacker87 ($8.46 in chips)=20
Seat 7: the_wickstar ($0.28 in chips)=20
Seat 8: JOSSEPH K ($2.03 in chips)=20
Seat 9: rana3792 ($1.99 in chips)=20
the_wickstar: posts small blind $0.01
JOSSEPH K: posts big blind $0.02
*** HOLE CARDS ***
Dealt to the_wickstar [Ac Jd]
rana3792: folds=20
VishegasM: folds=20
StarsEyeDee: folds=20
Lanesra_90: folds=20
diment76: folds=20
Souljacker87: raises $0.04 to $0.06
the_wickstar: calls $0.05
JOSSEPH K: folds=20
*** FLOP *** [3d 3h 6d]
the_wickstar: checks=20
Souljacker87: bets $8.40 and is all-in
the_wickstar: folds=20
Uncalled bet ($8.40) returned to Souljacker87
Souljacker87 collected $0.14 from pot
Souljacker87: doesn't show hand=20
*** SUMMARY ***
Total pot $0.14 | Rake $0=20
Board [3d 3h 6d]
Seat 2: VishegasM folded before Flop (didn't bet)
Seat 3: StarsEyeDee folded before Flop (didn't bet)
Seat 4: Lanesra_90 folded before Flop (didn't bet)
Seat 5: diment76 folded before Flop (didn't bet)
Seat 6: Souljacker87 (button) collected ($0.14)
Seat 7: the_wickstar (small blind) folded on the Flop
Seat 8: JOSSEPH K (big blind) folded before Flop
Seat 9: rana3792 folded before Flop (didn't bet)


*********** # 90 **************
PokerStars Hand #170016012231:  Hold'em No Limit ($0.01/$0.02 USD) - 20=
17/05/06 13:04:08 CUST [2017/05/05 23:04:08 ET]
Table 'Mathilde III' 9-max Seat #3 is the button
Seat 1: Kabit510 ($2.25 in chips)=20
Seat 3: howata ($2.02 in chips)=20
Seat 4: manugar91 ($2 in chips)=20
Seat 6: drinkedfish ($2.31 in chips)=20
Seat 7: July Van7 ($2.10 in chips)=20
Seat 8: the_wickstar ($2.74 in chips)=20
Seat 9: Luks_Jr ($2.10 in chips)=20
manugar91: posts small blind $0.01
drinkedfish: posts big blind $0.02
*** HOLE CARDS ***
Dealt to the_wickstar [Qc Qh]
July Van7: folds=20
the_wickstar: raises $0.04 to $0.06
Luks_Jr: folds=20
Kabit510: folds=20
howata: raises $0.09 to $0.15
manugar91: folds=20
drinkedfish: folds=20
the_wickstar: calls $0.09
*** FLOP *** [7d Tc Ah]
the_wickstar: checks=20
howata: bets $0.16
the_wickstar: folds=20
Uncalled bet ($0.16) returned to howata
howata collected $0.32 from pot
howata: doesn't show hand=20
*** SUMMARY ***
Total pot $0.33 | Rake $0.01=20
Board [7d Tc Ah]
Seat 1: Kabit510 folded before Flop (didn't bet)
Seat 3: howata (button) collected ($0.32)
Seat 4: manugar91 (small blind) folded before Flop
Seat 6: drinkedfish (big blind) folded before Flop
Seat 7: July Van7 folded before Flop (didn't bet)
Seat 8: the_wickstar folded on the Flop
Seat 9: Luks_Jr folded before Flop (didn't bet)


*********** # 91 **************
PokerStars Hand #170016004500:  Hold'em No Limit ($0.01/$0.02 USD) - 20=
17/05/06 13:03:46 CUST [2017/05/05 23:03:46 ET]
Table 'Diotima' 9-max Seat #3 is the button
Seat 2: uilcm ($2.15 in chips)=20
Seat 3: guga01101974 ($1.96 in chips)=20
Seat 5: the_wickstar ($1.65 in chips)=20
Seat 6: vbg92 ($1.83 in chips)=20
Seat 7: BRAT PIDD ($2 in chips)=20
Seat 8: pdgnqn28 ($1.72 in chips)=20
Seat 9: settecba ($2 in chips)=20
the_wickstar: posts small blind $0.01
vbg92: posts big blind $0.02
windy417: sits out=20
*** HOLE CARDS ***
Dealt to the_wickstar [3h Tc]
BRAT PIDD: folds=20
pdgnqn28: folds=20
settecba: folds=20
uilcm: folds=20
guga01101974: calls $0.02
the_wickstar: folds=20
vbg92: checks=20
*** FLOP *** [Kc 9h 4h]
vbg92: checks=20
guga01101974: checks=20
*** TURN *** [Kc 9h 4h] [Kd]
vbg92: checks=20
guga01101974: bets $0.02
vbg92: folds=20
Uncalled bet ($0.02) returned to guga01101974
guga01101974 collected $0.05 from pot
guga01101974: doesn't show hand=20
*** SUMMARY ***
Total pot $0.05 | Rake $0=20
Board [Kc 9h 4h Kd]
Seat 2: uilcm folded before Flop (didn't bet)
Seat 3: guga01101974 (button) collected ($0.05)
Seat 5: the_wickstar (small blind) folded before Flop
Seat 6: vbg92 (big blind) folded on the Turn
Seat 7: BRAT PIDD folded before Flop (didn't bet)
Seat 8: pdgnqn28 folded before Flop (didn't bet)
Seat 9: settecba folded before Flop (didn't bet)


*********** # 92 **************
PokerStars Hand #170016003935:  Hold'em No Limit ($0.01/$0.02 USD) - 20=
17/05/06 13:03:44 CUST [2017/05/05 23:03:44 ET]
Table 'Wodan' 9-max Seat #5 is the button
Seat 2: VishegasM ($2.71 in chips)=20
Seat 3: StarsEyeDee ($2.27 in chips)=20
Seat 4: Lanesra_90 ($2.54 in chips)=20
Seat 5: diment76 ($1.91 in chips)=20
Seat 6: Souljacker87 ($8.47 in chips)=20
Seat 7: the_wickstar ($0.30 in chips)=20
Seat 8: JOSSEPH K ($2.03 in chips)=20
Seat 9: rana3792 ($1.99 in chips)=20
Souljacker87: posts small blind $0.01
the_wickstar: posts big blind $0.02
*** HOLE CARDS ***
Dealt to the_wickstar [5c Qh]
JOSSEPH K: folds=20
rana3792: folds=20
VishegasM: folds=20
StarsEyeDee: folds=20
Lanesra_90: folds=20
diment76: raises $0.04 to $0.06
Souljacker87: folds=20
the_wickstar: folds=20
Uncalled bet ($0.04) returned to diment76
diment76 collected $0.05 from pot
*** SUMMARY ***
Total pot $0.05 | Rake $0=20
Seat 2: VishegasM folded before Flop (didn't bet)
Seat 3: StarsEyeDee folded before Flop (didn't bet)
Seat 4: Lanesra_90 folded before Flop (didn't bet)
Seat 5: diment76 (button) collected ($0.05)
Seat 6: Souljacker87 (small blind) folded before Flop
Seat 7: the_wickstar (big blind) folded before Flop
Seat 8: JOSSEPH K folded before Flop (didn't bet)
Seat 9: rana3792 folded before Flop (didn't bet)


*********** # 93 **************
PokerStars Hand #170015995146:  Hold'em No Limit ($0.01/$0.02 USD) - 20=
17/05/06 13:03:20 CUST [2017/05/05 23:03:20 ET]
Table 'Diotima' 9-max Seat #2 is the button
Seat 2: uilcm ($2.15 in chips)=20
Seat 3: guga01101974 ($1.94 in chips)=20
Seat 5: the_wickstar ($1.67 in chips)=20
Seat 6: vbg92 ($1.83 in chips)=20
Seat 7: BRAT PIDD ($2 in chips)=20
Seat 8: pdgnqn28 ($1.72 in chips)=20
Seat 9: settecba ($2 in chips)=20
guga01101974: posts small blind $0.01
the_wickstar: posts big blind $0.02
windy417: sits out=20
*** HOLE CARDS ***
Dealt to the_wickstar [6h 7d]
vbg92: folds=20
BRAT PIDD: folds=20
pdgnqn28: folds=20
settecba: folds=20
uilcm: folds=20
guga01101974: raises $0.02 to $0.04
the_wickstar: folds=20
Uncalled bet ($0.02) returned to guga01101974
guga01101974 collected $0.04 from pot
*** SUMMARY ***
Total pot $0.04 | Rake $0=20
Seat 2: uilcm (button) folded before Flop (didn't bet)
Seat 3: guga01101974 (small blind) collected ($0.04)
Seat 5: the_wickstar (big blind) folded before Flop
Seat 6: vbg92 folded before Flop (didn't bet)
Seat 7: BRAT PIDD folded before Flop (didn't bet)
Seat 8: pdgnqn28 folded before Flop (didn't bet)
Seat 9: settecba folded before Flop (didn't bet)


*********** # 94 **************
PokerStars Hand #170015987140:  Hold'em No Limit ($0.01/$0.02 USD) - 20=
17/05/06 13:02:57 CUST [2017/05/05 23:02:57 ET]
Table 'Wodan' 9-max Seat #4 is the button
Seat 2: VishegasM ($2.71 in chips)=20
Seat 3: StarsEyeDee ($2.27 in chips)=20
Seat 4: Lanesra_90 ($2.54 in chips)=20
Seat 5: diment76 ($1.84 in chips)=20
Seat 6: Souljacker87 ($8.53 in chips)=20
Seat 7: the_wickstar ($0.30 in chips)=20
Seat 8: JOSSEPH K ($2.03 in chips)=20
Seat 9: rana3792 ($2 in chips)=20
diment76: posts small blind $0.01
Souljacker87: posts big blind $0.02
rana3792: posts small blind $0.01
*** HOLE CARDS ***
Dealt to the_wickstar [9h Td]
the_wickstar: folds=20
JOSSEPH K: folds=20
rana3792: folds=20
VishegasM: folds=20
StarsEyeDee: folds=20
Lanesra_90: folds=20
diment76: raises $0.04 to $0.06
Souljacker87: calls $0.04
*** FLOP *** [6d 3h 5d]
diment76: checks=20
Souljacker87: checks=20
*** TURN *** [6d 3h 5d] [3c]
diment76: checks=20
Souljacker87: checks=20
*** RIVER *** [6d 3h 5d 3c] [9c]
diment76: checks=20
Souljacker87: checks=20
*** SHOW DOWN ***
diment76: shows [Kc Js] (a pair of Threes)
Souljacker87: mucks hand=20
diment76 collected $0.13 from pot
*** SUMMARY ***
Total pot $0.13 | Rake $0=20
Board [6d 3h 5d 3c 9c]
Seat 2: VishegasM folded before Flop (didn't bet)
Seat 3: StarsEyeDee folded before Flop (didn't bet)
Seat 4: Lanesra_90 (button) folded before Flop (didn't bet)
Seat 5: diment76 (small blind) showed [Kc Js] and won ($0.13) with a pa=
ir of Threes
Seat 6: Souljacker87 (big blind) mucked [4s Ts]
Seat 7: the_wickstar folded before Flop (didn't bet)
Seat 8: JOSSEPH K folded before Flop (didn't bet)
Seat 9: rana3792 folded before Flop


*********** # 95 **************
PokerStars Hand #170015986281:  Hold'em No Limit ($0.01/$0.02 USD) - 20=
17/05/06 13:02:55 CUST [2017/05/05 23:02:55 ET]
Table 'Mathilde III' 9-max Seat #1 is the button
Seat 1: Kabit510 ($2.25 in chips)=20
Seat 3: howata ($2.03 in chips)=20
Seat 4: manugar91 ($2 in chips)=20
Seat 5: rssollero ($2 in chips)=20
Seat 6: drinkedfish ($2.23 in chips)=20
Seat 7: July Van7 ($2.10 in chips)=20
Seat 8: the_wickstar ($2.74 in chips)=20
Seat 9: Luks_Jr ($2.16 in chips)=20
howata: posts small blind $0.01
manugar91: posts big blind $0.02
*** HOLE CARDS ***
Dealt to the_wickstar [Ad 3c]
rssollero has timed out
rssollero: folds=20
drinkedfish: raises $0.04 to $0.06
July Van7: folds=20
the_wickstar: folds=20
Luks_Jr: calls $0.06
Kabit510: folds=20
howata: folds=20
manugar91: folds=20
*** FLOP *** [3s Ks 8h]
drinkedfish: bets $0.06
Luks_Jr: folds=20
Uncalled bet ($0.06) returned to drinkedfish
drinkedfish collected $0.14 from pot
drinkedfish: doesn't show hand=20
*** SUMMARY ***
Total pot $0.15 | Rake $0.01=20
Board [3s Ks 8h]
Seat 1: Kabit510 (button) folded before Flop (didn't bet)
Seat 3: howata (small blind) folded before Flop
Seat 4: manugar91 (big blind) folded before Flop
Seat 5: rssollero folded before Flop (didn't bet)
Seat 6: drinkedfish collected ($0.14)
Seat 7: July Van7 folded before Flop (didn't bet)
Seat 8: the_wickstar folded before Flop (didn't bet)
Seat 9: Luks_Jr folded on the Flop


*********** # 96 **************
PokerStars Hand #170015972934:  Hold'em No Limit ($0.01/$0.02 USD) - 20=
17/05/06 13:02:17 CUST [2017/05/05 23:02:17 ET]
Table 'Diotima' 9-max Seat #9 is the button
Seat 2: uilcm ($2 in chips)=20
Seat 3: guga01101974 ($1.96 in chips)=20
Seat 5: the_wickstar ($1.67 in chips)=20
Seat 6: vbg92 ($1.83 in chips)=20
Seat 7: BRAT PIDD ($2 in chips)=20
Seat 8: pdgnqn28 ($1.72 in chips)=20
Seat 9: settecba ($2 in chips)=20
windy417 will be allowed to play after the button
uilcm: posts small blind $0.01
guga01101974: posts big blind $0.02
*** HOLE CARDS ***
Dealt to the_wickstar [8h 4c]
the_wickstar: folds=20
vbg92: folds=20
BRAT PIDD: raises $0.04 to $0.06
pdgnqn28: folds=20
settecba: folds=20
uilcm: calls $0.05
guga01101974: folds=20
*** FLOP *** [Kc 6s 6h]
uilcm: checks=20
BRAT PIDD: bets $0.08
uilcm: calls $0.08
*** TURN *** [Kc 6s 6h] [Kh]
uilcm: checks=20
BRAT PIDD: checks=20
*** RIVER *** [Kc 6s 6h Kh] [4h]
uilcm: checks=20
BRAT PIDD: checks=20
*** SHOW DOWN ***
uilcm: shows [Tc Td] (two pair, Kings and Tens)
BRAT PIDD: mucks hand=20
uilcm collected $0.29 from pot
*** SUMMARY ***
Total pot $0.30 | Rake $0.01=20
Board [Kc 6s 6h Kh 4h]
Seat 2: uilcm (small blind) showed [Tc Td] and won ($0.29) with two pai=
r, Kings and Tens
Seat 3: guga01101974 (big blind) folded before Flop
Seat 5: the_wickstar folded before Flop (didn't bet)
Seat 6: vbg92 folded before Flop (didn't bet)
Seat 7: BRAT PIDD mucked [7h 7s]
Seat 8: pdgnqn28 folded before Flop (didn't bet)
Seat 9: settecba (button) folded before Flop (didn't bet)


*********** # 97 **************
PokerStars Hand #170015969318:  Hold'em No Limit ($0.01/$0.02 USD) - 20=
17/05/06 13:02:06 CUST [2017/05/05 23:02:06 ET]
Table 'Mathilde III' 9-max Seat #9 is the button
Seat 1: Kabit510 ($2.26 in chips)=20
Seat 3: howata ($2.05 in chips)=20
Seat 4: manugar91 ($2 in chips)=20
Seat 5: rssollero ($2 in chips)=20
Seat 6: drinkedfish ($2.20 in chips)=20
Seat 7: July Van7 ($2.10 in chips)=20
Seat 8: the_wickstar ($2.74 in chips)=20
Seat 9: Luks_Jr ($2.16 in chips)=20
Kabit510: posts small blind $0.01
zecateto: is sitting out=20
howata: posts big blind $0.02
*** HOLE CARDS ***
Dealt to the_wickstar [Kc 6d]
manugar91: folds=20
rssollero: folds=20
drinkedfish: raises $0.04 to $0.06
July Van7: folds=20
the_wickstar: folds=20
Luks_Jr: folds=20
Kabit510: folds=20
howata: folds=20
Uncalled bet ($0.04) returned to drinkedfish
drinkedfish collected $0.05 from pot
drinkedfish: doesn't show hand=20
*** SUMMARY ***
Total pot $0.05 | Rake $0=20
Seat 1: Kabit510 (small blind) folded before Flop
Seat 3: howata (big blind) folded before Flop
Seat 4: manugar91 folded before Flop (didn't bet)
Seat 5: rssollero folded before Flop (didn't bet)
Seat 6: drinkedfish collected ($0.05)
Seat 7: July Van7 folded before Flop (didn't bet)
Seat 8: the_wickstar folded before Flop (didn't bet)
Seat 9: Luks_Jr (button) folded before Flop (didn't bet)


*********** # 98 **************
PokerStars Hand #170015966602:  Hold'em No Limit ($0.01/$0.02 USD) - 20=
17/05/06 13:01:59 CUST [2017/05/05 23:01:59 ET]
Table 'Wodan' 9-max Seat #3 is the button
Seat 1: H1JackH1gh ($2.21 in chips)=20
Seat 2: VishegasM ($2.47 in chips)=20
Seat 3: StarsEyeDee ($2.27 in chips)=20
Seat 4: Lanesra_90 ($2.55 in chips)=20
Seat 5: diment76 ($1.86 in chips)=20
Seat 6: Souljacker87 ($8.63 in chips)=20
Seat 7: the_wickstar ($0.32 in chips)=20
Seat 8: JOSSEPH K ($2.03 in chips)=20
Lanesra_90: posts small blind $0.01
diment76: posts big blind $0.02
rana3792: sits out=20
*** HOLE CARDS ***
Dealt to the_wickstar [5s 5h]
Souljacker87: calls $0.02
the_wickstar: calls $0.02
JOSSEPH K: folds=20
H1JackH1gh: calls $0.02
VishegasM: raises $0.08 to $0.10
StarsEyeDee: folds=20
Lanesra_90: folds=20
diment76: folds=20
Souljacker87: calls $0.08
the_wickstar: folds=20
H1JackH1gh: calls $0.08
*** FLOP *** [7s Jh Jd]
Souljacker87: checks=20
H1JackH1gh: checks=20
VishegasM: bets $0.21
Souljacker87: folds=20
H1JackH1gh: folds=20
Uncalled bet ($0.21) returned to VishegasM
VishegasM collected $0.34 from pot
VishegasM: doesn't show hand=20
*** SUMMARY ***
Total pot $0.35 | Rake $0.01=20
Board [7s Jh Jd]
Seat 1: H1JackH1gh folded on the Flop
Seat 2: VishegasM collected ($0.34)
Seat 3: StarsEyeDee (button) folded before Flop (didn't bet)
Seat 4: Lanesra_90 (small blind) folded before Flop
Seat 5: diment76 (big blind) folded before Flop
Seat 6: Souljacker87 folded on the Flop
Seat 7: the_wickstar folded before Flop
Seat 8: JOSSEPH K folded before Flop (didn't bet)


*********** # 99 **************
PokerStars Hand #170015951501:  Hold'em No Limit ($0.01/$0.02 USD) - 20=
17/05/06 13:01:16 CUST [2017/05/05 23:01:16 ET]
Table 'Diotima' 9-max Seat #8 is the button
Seat 2: uilcm ($2 in chips)=20
Seat 3: guga01101974 ($1.96 in chips)=20
Seat 4: H1JackH1gh ($3.22 in chips)=20
Seat 5: the_wickstar ($1.67 in chips)=20
Seat 6: vbg92 ($1.58 in chips)=20
Seat 7: BRAT PIDD ($2 in chips)=20
Seat 8: pdgnqn28 ($1.72 in chips)=20
Seat 9: settecba ($2 in chips)=20
settecba: posts small blind $0.01
windy417: is sitting out=20
uilcm: posts big blind $0.02
*** HOLE CARDS ***
Dealt to the_wickstar [Ad 2s]
guga01101974: folds=20
H1JackH1gh: raises $0.06 to $0.08
the_wickstar: folds=20
vbg92: raises $0.16 to $0.24
BRAT PIDD: folds=20
pdgnqn28: folds=20
settecba: folds=20
uilcm: folds=20
H1JackH1gh: calls $0.16
*** FLOP *** [5s Kc 8c]
H1JackH1gh: checks=20
vbg92: bets $0.22
H1JackH1gh: folds=20
Uncalled bet ($0.22) returned to vbg92
vbg92 collected $0.49 from pot
*** SUMMARY ***
Total pot $0.51 | Rake $0.02=20
Board [5s Kc 8c]
Seat 2: uilcm (big blind) folded before Flop
Seat 3: guga01101974 folded before Flop (didn't bet)
Seat 4: H1JackH1gh folded on the Flop
Seat 5: the_wickstar folded before Flop (didn't bet)
Seat 6: vbg92 collected ($0.49)
Seat 7: BRAT PIDD folded before Flop (didn't bet)
Seat 8: pdgnqn28 (button) folded before Flop (didn't bet)
Seat 9: settecba (small blind) folded before Flop


*********** # 100 **************
PokerStars Hand #170015947356:  Hold'em No Limit ($0.01/$0.02 USD) - 20=
17/05/06 13:01:04 CUST [2017/05/05 23:01:04 ET]
Table 'Mathilde III' 9-max Seat #8 is the button
Seat 1: Kabit510 ($2.10 in chips)=20
Seat 2: zecateto ($4.97 in chips)=20
Seat 3: howata ($2.05 in chips)=20
Seat 4: manugar91 ($2.03 in chips)=20
Seat 5: rssollero ($2 in chips)=20
Seat 6: drinkedfish ($2.20 in chips)=20
Seat 7: July Van7 ($2.10 in chips)=20
Seat 8: the_wickstar ($2.74 in chips)=20
Seat 9: Luks_Jr ($2.17 in chips)=20
Luks_Jr: posts small blind $0.01
Kabit510: posts big blind $0.02
*** HOLE CARDS ***
Dealt to the_wickstar [9c 6h]
zecateto: folds=20
howata: folds=20
manugar91: raises $0.04 to $0.06
rssollero: folds=20
drinkedfish: folds=20
July Van7: folds=20
the_wickstar: folds=20
Luks_Jr: folds=20
Kabit510: calls $0.04
*** FLOP *** [Tc 2s 2c]
Kabit510: checks=20
manugar91: bets $0.10
Kabit510: calls $0.10
*** TURN *** [Tc 2s 2c] [7h]
Kabit510: checks=20
manugar91: checks=20
*** RIVER *** [Tc 2s 2c 7h] [Ks]
Kabit510: bets $0.12
manugar91: folds=20
Uncalled bet ($0.12) returned to Kabit510
Kabit510 collected $0.32 from pot
Kabit510: doesn't show hand=20
*** SUMMARY ***
Total pot $0.33 | Rake $0.01=20
Board [Tc 2s 2c 7h Ks]
Seat 1: Kabit510 (big blind) collected ($0.32)
Seat 2: zecateto folded before Flop (didn't bet)
Seat 3: howata folded before Flop (didn't bet)
Seat 4: manugar91 folded on the River
Seat 5: rssollero folded before Flop (didn't bet)
Seat 6: drinkedfish folded before Flop (didn't bet)
Seat 7: July Van7 folded before Flop (didn't bet)
Seat 8: the_wickstar (button) folded before Flop (didn't bet)
Seat 9: Luks_Jr (small blind) folded before Flop


*********** # 101 **************
PokerStars Hand #170015942958:  Hold'em No Limit ($0.01/$0.02 USD) - 20=
17/05/06 13:00:51 CUST [2017/05/05 23:00:51 ET]
Table 'Wodan' 9-max Seat #2 is the button
Seat 1: H1JackH1gh ($2.21 in chips)=20
Seat 2: VishegasM ($2 in chips)=20
Seat 3: StarsEyeDee ($2.75 in chips)=20
Seat 4: Lanesra_90 ($2.57 in chips)=20
Seat 5: diment76 ($1.86 in chips)=20
Seat 6: Souljacker87 ($8.63 in chips)=20
Seat 7: the_wickstar ($0.32 in chips)=20
Seat 8: JOSSEPH K ($2.03 in chips)=20
StarsEyeDee: posts small blind $0.01
Lanesra_90: posts big blind $0.02
rana3792: sits out=20
*** HOLE CARDS ***
Dealt to the_wickstar [9s 5h]
diment76: folds=20
Souljacker87: folds=20
the_wickstar: folds=20
JOSSEPH K: folds=20
H1JackH1gh: folds=20
VishegasM: raises $0.02 to $0.04
StarsEyeDee: calls $0.03
Lanesra_90: folds=20
*** FLOP *** [Jc 2h 4h]
StarsEyeDee: bets $0.20
VishegasM: calls $0.20
*** TURN *** [Jc 2h 4h] [Qh]
StarsEyeDee: checks=20
VishegasM: checks=20
*** RIVER *** [Jc 2h 4h Qh] [Ad]
StarsEyeDee: checks=20
VishegasM: bets $0.24
StarsEyeDee: calls $0.24
*** SHOW DOWN ***
VishegasM: shows [4c Ac] (two pair, Aces and Fours)
StarsEyeDee: mucks hand=20
VishegasM collected $0.95 from pot
*** SUMMARY ***
Total pot $0.98 | Rake $0.03=20
Board [Jc 2h 4h Qh Ad]
Seat 1: H1JackH1gh folded before Flop (didn't bet)
Seat 2: VishegasM (button) showed [4c Ac] and won ($0.95) with two pair=
, Aces and Fours
Seat 3: StarsEyeDee (small blind) mucked [Js 7s]
Seat 4: Lanesra_90 (big blind) folded before Flop
Seat 5: diment76 folded before Flop (didn't bet)
Seat 6: Souljacker87 folded before Flop (didn't bet)
Seat 7: the_wickstar folded before Flop (didn't bet)
Seat 8: JOSSEPH K folded before Flop (didn't bet)


*********** # 102 **************
PokerStars Hand #170015937076:  Hold'em No Limit ($0.01/$0.02 USD) - 20=
17/05/06 13:00:33 CUST [2017/05/05 23:00:33 ET]
Table 'Diotima' 9-max Seat #7 is the button
Seat 1: windy417 ($2.04 in chips)=20
Seat 3: guga01101974 ($1.96 in chips)=20
Seat 4: H1JackH1gh ($3.22 in chips)=20
Seat 5: the_wickstar ($1.67 in chips)=20
Seat 6: vbg92 ($1.64 in chips)=20
Seat 7: BRAT PIDD ($2.08 in chips)=20
Seat 8: pdgnqn28 ($1.46 in chips)=20
Seat 9: settecba ($2 in chips)=20
pdgnqn28: posts small blind $0.01
settecba: posts big blind $0.02
uilcm: sits out=20
*** HOLE CARDS ***
Dealt to the_wickstar [3s 8c]
windy417: folds=20
guga01101974: folds=20
H1JackH1gh: folds=20
the_wickstar: folds=20
vbg92: raises $0.04 to $0.06
BRAT PIDD: raises $0.12 to $0.18
pdgnqn28: raises $0.22 to $0.40
settecba: folds=20
vbg92: folds=20
BRAT PIDD: folds=20
Uncalled bet ($0.22) returned to pdgnqn28
pdgnqn28 collected $0.44 from pot
*** SUMMARY ***
Total pot $0.44 | Rake $0=20
Seat 1: windy417 folded before Flop (didn't bet)
Seat 3: guga01101974 folded before Flop (didn't bet)
Seat 4: H1JackH1gh folded before Flop (didn't bet)
Seat 5: the_wickstar folded before Flop (didn't bet)
Seat 6: vbg92 folded before Flop
Seat 7: BRAT PIDD (button) folded before Flop
Seat 8: pdgnqn28 (small blind) collected ($0.44)
Seat 9: settecba (big blind) folded before Flop


*********** # 103 **************
PokerStars Hand #170015931820:  Hold'em No Limit ($0.01/$0.02 USD) - 20=
17/05/06 13:00:17 CUST [2017/05/05 23:00:17 ET]
Table 'Mathilde III' 9-max Seat #7 is the button
Seat 1: Kabit510 ($2.07 in chips)=20
Seat 2: zecateto ($4.97 in chips)=20
Seat 3: howata ($2.05 in chips)=20
Seat 4: manugar91 ($2.03 in chips)=20
Seat 5: rssollero ($2 in chips)=20
Seat 6: drinkedfish ($2.20 in chips)=20
Seat 7: July Van7 ($2.10 in chips)=20
Seat 8: the_wickstar ($2.75 in chips)=20
Seat 9: Luks_Jr ($2.19 in chips)=20
the_wickstar: posts small blind $0.01
Luks_Jr: posts big blind $0.02
*** HOLE CARDS ***
Dealt to the_wickstar [Kd Jd]
Kabit510: raises $0.04 to $0.06
zecateto: folds=20
howata: folds=20
manugar91: folds=20
rssollero: folds=20
drinkedfish: folds=20
July Van7: folds=20
the_wickstar: folds=20
Luks_Jr: folds=20
Uncalled bet ($0.04) returned to Kabit510
Kabit510 collected $0.05 from pot
Kabit510: doesn't show hand=20
*** SUMMARY ***
Total pot $0.05 | Rake $0=20
Seat 1: Kabit510 collected ($0.05)
Seat 2: zecateto folded before Flop (didn't bet)
Seat 3: howata folded before Flop (didn't bet)
Seat 4: manugar91 folded before Flop (didn't bet)
Seat 5: rssollero folded before Flop (didn't bet)
Seat 6: drinkedfish folded before Flop (didn't bet)
Seat 7: July Van7 (button) folded before Flop (didn't bet)
Seat 8: the_wickstar (small blind) folded before Flop
Seat 9: Luks_Jr (big blind) folded before Flop


*********** # 104 **************
PokerStars Hand #170015924855:  Hold'em No Limit ($0.01/$0.02 USD) - 20=
17/05/06 12:59:55 CUST [2017/05/05 22:59:55 ET]
Table 'Wodan' 9-max Seat #1 is the button
Seat 1: H1JackH1gh ($2.41 in chips)=20
Seat 2: VishegasM ($2 in chips)=20
Seat 3: StarsEyeDee ($2.55 in chips)=20
Seat 4: Lanesra_90 ($2.57 in chips)=20
Seat 5: diment76 ($1.86 in chips)=20
Seat 6: Souljacker87 ($8.63 in chips)=20
Seat 7: the_wickstar ($0.32 in chips)=20
Seat 8: JOSSEPH K ($2.03 in chips)=20
VishegasM: posts small blind $0.01
StarsEyeDee: posts big blind $0.02
rana3792: sits out=20
*** HOLE CARDS ***
Dealt to the_wickstar [Tc 7s]
Lanesra_90: folds=20
diment76: folds=20
Souljacker87: folds=20
the_wickstar: folds=20
JOSSEPH K: folds=20
H1JackH1gh: raises $0.04 to $0.06
VishegasM: folds=20
StarsEyeDee: raises $0.14 to $0.20
H1JackH1gh: calls $0.14
*** FLOP *** [Kd 4c 5h]
StarsEyeDee: bets $0.40
H1JackH1gh: folds=20
Uncalled bet ($0.40) returned to StarsEyeDee
StarsEyeDee collected $0.40 from pot
StarsEyeDee: doesn't show hand=20
*** SUMMARY ***
Total pot $0.41 | Rake $0.01=20
Board [Kd 4c 5h]
Seat 1: H1JackH1gh (button) folded on the Flop
Seat 2: VishegasM (small blind) folded before Flop
Seat 3: StarsEyeDee (big blind) collected ($0.40)
Seat 4: Lanesra_90 folded before Flop (didn't bet)
Seat 5: diment76 folded before Flop (didn't bet)
Seat 6: Souljacker87 folded before Flop (didn't bet)
Seat 7: the_wickstar folded before Flop (didn't bet)
Seat 8: JOSSEPH K folded before Flop (didn't bet)


*********** # 105 **************
PokerStars Hand #170015916646:  Hold'em No Limit ($0.01/$0.02 USD) - 20=
17/05/06 12:59:29 CUST [2017/05/05 22:59:29 ET]
Table 'Mathilde III' 9-max Seat #6 is the button
Seat 1: Kabit510 ($2.07 in chips)=20
Seat 2: zecateto ($4.97 in chips)=20
Seat 3: howata ($2.05 in chips)=20
Seat 4: manugar91 ($2 in chips)=20
Seat 5: rssollero ($2 in chips)=20
Seat 6: drinkedfish ($2.20 in chips)=20
Seat 7: July Van7 ($2.11 in chips)=20
Seat 8: the_wickstar ($2.77 in chips)=20
Seat 9: Luks_Jr ($2.19 in chips)=20
July Van7: posts small blind $0.01
the_wickstar: posts big blind $0.02
*** HOLE CARDS ***
Dealt to the_wickstar [6s 9c]
Luks_Jr: folds=20
Kabit510: folds=20
zecateto: folds=20
howata: folds=20
manugar91: raises $0.03 to $0.05
rssollero: folds=20
drinkedfish: folds=20
July Van7: folds=20
the_wickstar: folds=20
Uncalled bet ($0.03) returned to manugar91
manugar91 collected $0.05 from pot
manugar91: doesn't show hand=20
*** SUMMARY ***
Total pot $0.05 | Rake $0=20
Seat 1: Kabit510 folded before Flop (didn't bet)
Seat 2: zecateto folded before Flop (didn't bet)
Seat 3: howata folded before Flop (didn't bet)
Seat 4: manugar91 collected ($0.05)
Seat 5: rssollero folded before Flop (didn't bet)
Seat 6: drinkedfish (button) folded before Flop (didn't bet)
Seat 7: July Van7 (small blind) folded before Flop
Seat 8: the_wickstar (big blind) folded before Flop
Seat 9: Luks_Jr folded before Flop (didn't bet)


*********** # 106 **************
PokerStars Hand #170015914811:  Hold'em No Limit ($0.01/$0.02 USD) - 20=
17/05/06 12:59:24 CUST [2017/05/05 22:59:24 ET]
Table 'Wodan' 9-max Seat #8 is the button
Seat 1: H1JackH1gh ($2.42 in chips)=20
Seat 2: VishegasM ($2 in chips)=20
Seat 3: StarsEyeDee ($2.55 in chips)=20
Seat 4: Lanesra_90 ($2.57 in chips)=20
Seat 5: diment76 ($1.86 in chips)=20
Seat 6: Souljacker87 ($8.63 in chips)=20
Seat 7: the_wickstar ($0.32 in chips)=20
Seat 8: JOSSEPH K ($2 in chips)=20
H1JackH1gh: posts small blind $0.01
VishegasM: posts big blind $0.02
*** HOLE CARDS ***
Dealt to the_wickstar [4d 3d]
StarsEyeDee: folds=20
Lanesra_90: folds=20
diment76: folds=20
Souljacker87: folds=20
the_wickstar: folds=20
JOSSEPH K: raises $0.04 to $0.06
H1JackH1gh: folds=20
VishegasM: folds=20
Uncalled bet ($0.04) returned to JOSSEPH K
JOSSEPH K collected $0.05 from pot
JOSSEPH K: doesn't show hand=20
*** SUMMARY ***
Total pot $0.05 | Rake $0=20
Seat 1: H1JackH1gh (small blind) folded before Flop
Seat 2: VishegasM (big blind) folded before Flop
Seat 3: StarsEyeDee folded before Flop (didn't bet)
Seat 4: Lanesra_90 folded before Flop (didn't bet)
Seat 5: diment76 folded before Flop (didn't bet)
Seat 6: Souljacker87 folded before Flop (didn't bet)
Seat 7: the_wickstar folded before Flop (didn't bet)
Seat 8: JOSSEPH K (button) collected ($0.05)


*********** # 107 **************
PokerStars Hand #170015909232:  Hold'em No Limit ($0.01/$0.02 USD) - 20=
17/05/06 12:59:06 CUST [2017/05/05 22:59:06 ET]
Table 'Diotima' 9-max Seat #5 is the button
Seat 1: windy417 ($2.01 in chips)=20
Seat 3: guga01101974 ($1.96 in chips)=20
Seat 4: H1JackH1gh ($3.22 in chips)=20
Seat 5: the_wickstar ($1.67 in chips)=20
Seat 6: vbg92 ($1.62 in chips)=20
Seat 7: BRAT PIDD ($2.11 in chips)=20
Seat 8: pdgnqn28 ($1.48 in chips)=20
Seat 9: settecba ($2 in chips)=20
vbg92: posts small blind $0.01
BRAT PIDD: posts big blind $0.02
uilcm: sits out=20
*** HOLE CARDS ***
Dealt to the_wickstar [8s 3s]
pdgnqn28: folds=20
settecba: folds=20
windy417: folds=20
guga01101974: folds=20
H1JackH1gh: folds=20
the_wickstar has timed out
the_wickstar: folds=20
vbg92: raises $0.04 to $0.06
BRAT PIDD: folds=20
Uncalled bet ($0.04) returned to vbg92
vbg92 collected $0.04 from pot
*** SUMMARY ***
Total pot $0.04 | Rake $0=20
Seat 1: windy417 folded before Flop (didn't bet)
Seat 3: guga01101974 folded before Flop (didn't bet)
Seat 4: H1JackH1gh folded before Flop (didn't bet)
Seat 5: the_wickstar (button) folded before Flop (didn't bet)
Seat 6: vbg92 (small blind) collected ($0.04)
Seat 7: BRAT PIDD (big blind) folded before Flop
Seat 8: pdgnqn28 folded before Flop (didn't bet)
Seat 9: settecba folded before Flop (didn't bet)


*********** # 108 **************
PokerStars Hand #170015905535:  Hold'em No Limit ($0.01/$0.02 USD) - 20=
17/05/06 12:58:55 CUST [2017/05/05 22:58:55 ET]
Table 'Mathilde III' 9-max Seat #5 is the button
Seat 1: Kabit510 ($2.07 in chips)=20
Seat 2: zecateto ($4.94 in chips)=20
Seat 3: howata ($2.05 in chips)=20
Seat 4: manugar91 ($2 in chips)=20
Seat 5: rssollero ($2 in chips)=20
Seat 6: drinkedfish ($2.21 in chips)=20
Seat 7: July Van7 ($2.13 in chips)=20
Seat 8: the_wickstar ($2.77 in chips)=20
Seat 9: Luks_Jr ($2.19 in chips)=20
drinkedfish: posts small blind $0.01
July Van7: posts big blind $0.02
*** HOLE CARDS ***
Dealt to the_wickstar [7d 9s]
the_wickstar: folds=20
Luks_Jr: folds=20
Kabit510: folds=20
zecateto: raises $0.04 to $0.06
howata: folds=20
manugar91: folds=20
rssollero: folds=20
drinkedfish: folds=20
July Van7: folds=20
Uncalled bet ($0.04) returned to zecateto
zecateto collected $0.05 from pot
zecateto: doesn't show hand=20
*** SUMMARY ***
Total pot $0.05 | Rake $0=20
Seat 1: Kabit510 folded before Flop (didn't bet)
Seat 2: zecateto collected ($0.05)
Seat 3: howata folded before Flop (didn't bet)
Seat 4: manugar91 folded before Flop (didn't bet)
Seat 5: rssollero (button) folded before Flop (didn't bet)
Seat 6: drinkedfish (small blind) folded before Flop
Seat 7: July Van7 (big blind) folded before Flop
Seat 8: the_wickstar folded before Flop (didn't bet)
Seat 9: Luks_Jr folded before Flop (didn't bet)


*********** # 109 **************
PokerStars Hand #170015892425:  Hold'em No Limit ($0.01/$0.02 USD) - 20=
17/05/06 12:58:13 CUST [2017/05/05 22:58:13 ET]
Table 'Diotima' 9-max Seat #4 is the button
Seat 1: windy417 ($2.01 in chips)=20
Seat 3: guga01101974 ($2 in chips)=20
Seat 4: H1JackH1gh ($3.22 in chips)=20
Seat 5: the_wickstar ($1.68 in chips)=20
Seat 6: vbg92 ($1.57 in chips)=20
Seat 7: BRAT PIDD ($2.11 in chips)=20
Seat 8: pdgnqn28 ($1.48 in chips)=20
Seat 9: settecba ($2 in chips)=20
the_wickstar: posts small blind $0.01
vbg92: posts big blind $0.02
guga01101974: posts big blind $0.02
*** HOLE CARDS ***
Dealt to the_wickstar [4h 6d]
BRAT PIDD: folds=20
pdgnqn28: folds=20
uilcm joins the table at seat #2=20
settecba: folds=20
windy417: folds=20
guga01101974: checks=20
H1JackH1gh: folds=20
the_wickstar: folds=20
vbg92: checks=20
*** FLOP *** [7c 3s 3h]
vbg92: checks=20
guga01101974: bets $0.02
vbg92: calls $0.02
*** TURN *** [7c 3s 3h] [6s]
vbg92: checks=20
guga01101974: checks=20
*** RIVER *** [7c 3s 3h 6s] [Tc]
vbg92: bets $0.08
guga01101974: folds=20
Uncalled bet ($0.08) returned to vbg92
vbg92 collected $0.09 from pot
*** SUMMARY ***
Total pot $0.09 | Rake $0=20
Board [7c 3s 3h 6s Tc]
Seat 1: windy417 folded before Flop (didn't bet)
Seat 3: guga01101974 folded on the River
Seat 4: H1JackH1gh (button) folded before Flop (didn't bet)
Seat 5: the_wickstar (small blind) folded before Flop
Seat 6: vbg92 (big blind) collected ($0.09)
Seat 7: BRAT PIDD folded before Flop (didn't bet)
Seat 8: pdgnqn28 folded before Flop (didn't bet)
Seat 9: settecba folded before Flop (didn't bet)


*********** # 110 **************
PokerStars Hand #170015891255:  Hold'em No Limit ($0.01/$0.02 USD) - 20=
17/05/06 12:58:10 CUST [2017/05/05 22:58:10 ET]
Table 'Mathilde III' 9-max Seat #4 is the button
Seat 1: Kabit510 ($2.07 in chips)=20
Seat 2: zecateto ($4.94 in chips)=20
Seat 3: howata ($2.05 in chips)=20
Seat 4: manugar91 ($2 in chips)=20
Seat 5: rssollero ($2 in chips)=20
Seat 6: drinkedfish ($2.23 in chips)=20
Seat 7: July Van7 ($2.10 in chips)=20
Seat 8: the_wickstar ($2.77 in chips)=20
Seat 9: Luks_Jr ($2.19 in chips)=20
rssollero: posts small blind $0.01
drinkedfish: posts big blind $0.02
*** HOLE CARDS ***
Dealt to the_wickstar [Ks 2c]
July Van7: raises $0.04 to $0.06
the_wickstar: folds=20
Luks_Jr: folds=20
Kabit510: folds=20
zecateto: folds=20
howata: folds=20
manugar91: folds=20
rssollero: folds=20
drinkedfish: folds=20
Uncalled bet ($0.04) returned to July Van7
July Van7 collected $0.05 from pot
July Van7: doesn't show hand=20
*** SUMMARY ***
Total pot $0.05 | Rake $0=20
Seat 1: Kabit510 folded before Flop (didn't bet)
Seat 2: zecateto folded before Flop (didn't bet)
Seat 3: howata folded before Flop (didn't bet)
Seat 4: manugar91 (button) folded before Flop (didn't bet)
Seat 5: rssollero (small blind) folded before Flop
Seat 6: drinkedfish (big blind) folded before Flop
Seat 7: July Van7 collected ($0.05)
Seat 8: the_wickstar folded before Flop (didn't bet)
Seat 9: Luks_Jr folded before Flop (didn't bet)


*********** # 111 **************
PokerStars Hand #170015890992:  Hold'em No Limit ($0.01/$0.02 USD) - 20=
17/05/06 12:58:09 CUST [2017/05/05 22:58:09 ET]
Table 'Wodan' 9-max Seat #7 is the button
Seat 1: H1JackH1gh ($2.42 in chips)=20
Seat 2: VishegasM ($2 in chips)=20
Seat 3: StarsEyeDee ($2.55 in chips)=20
Seat 4: Lanesra_90 ($2.57 in chips)=20
Seat 5: diment76 ($1.86 in chips)=20
Seat 6: Souljacker87 ($6.81 in chips)=20
Seat 7: the_wickstar ($0.32 in chips)=20
Seat 8: JOSSEPH K ($2 in chips)=20
Seat 9: rana3792 ($1.95 in chips)=20
JOSSEPH K: posts small blind $0.01
rana3792: posts big blind $0.02
*** HOLE CARDS ***
Dealt to the_wickstar [3d 3s]
H1JackH1gh: folds=20
VishegasM: folds=20
StarsEyeDee: folds=20
Lanesra_90: folds=20
diment76: folds=20
Souljacker87: raises $0.04 to $0.06
the_wickstar: folds=20
JOSSEPH K: folds=20
rana3792: calls $0.04
*** FLOP *** [7s 5s 6c]
rana3792: bets $0.13
Souljacker87: raises $0.19 to $0.32
rana3792: calls $0.19
*** TURN *** [7s 5s 6c] [3h]
rana3792: checks=20
Souljacker87: bets $0.42
rana3792: calls $0.42
*** RIVER *** [7s 5s 6c 3h] [Jc]
rana3792: bets $1.15 and is all-in
Souljacker87: calls $1.15
*** SHOW DOWN ***
rana3792: shows [9h 7h] (a pair of Sevens)
Souljacker87: shows [Th Tc] (a pair of Tens)
Souljacker87 collected $3.77 from pot
*** SUMMARY ***
Total pot $3.91 | Rake $0.14=20
Board [7s 5s 6c 3h Jc]
Seat 1: H1JackH1gh folded before Flop (didn't bet)
Seat 2: VishegasM folded before Flop (didn't bet)
Seat 3: StarsEyeDee folded before Flop (didn't bet)
Seat 4: Lanesra_90 folded before Flop (didn't bet)
Seat 5: diment76 folded before Flop (didn't bet)
Seat 6: Souljacker87 showed [Th Tc] and won ($3.77) with a pair of Tens
Seat 7: the_wickstar (button) folded before Flop (didn't bet)
Seat 8: JOSSEPH K (small blind) folded before Flop
Seat 9: rana3792 (big blind) showed [9h 7h] and lost with a pair of Sev=
ens


*********** # 112 **************
PokerStars Hand #170015885233:  Hold'em No Limit ($0.01/$0.02 USD) - 20=
17/05/06 12:57:51 CUST [2017/05/05 22:57:51 ET]
Table 'Diotima' 9-max Seat #1 is the button
Seat 1: windy417 ($2.01 in chips)=20
Seat 4: H1JackH1gh ($3.23 in chips)=20
Seat 5: the_wickstar ($1.67 in chips)=20
Seat 6: vbg92 ($1.57 in chips)=20
Seat 7: BRAT PIDD ($2.11 in chips)=20
Seat 8: pdgnqn28 ($1.48 in chips)=20
Seat 9: settecba ($2 in chips)=20
H1JackH1gh: posts small blind $0.01
the_wickstar: posts big blind $0.02
*** HOLE CARDS ***
Dealt to the_wickstar [8s Td]
vbg92: folds=20
BRAT PIDD: folds=20
pdgnqn28: folds=20
settecba: folds=20
windy417: folds=20
guga01101974 joins the table at seat #3=20
H1JackH1gh: folds=20
Uncalled bet ($0.01) returned to the_wickstar
the_wickstar collected $0.02 from pot
*** SUMMARY ***
Total pot $0.02 | Rake $0=20
Seat 1: windy417 (button) folded before Flop (didn't bet)
Seat 4: H1JackH1gh (small blind) folded before Flop
Seat 5: the_wickstar (big blind) collected ($0.02)
Seat 6: vbg92 folded before Flop (didn't bet)
Seat 7: BRAT PIDD folded before Flop (didn't bet)
Seat 8: pdgnqn28 folded before Flop (didn't bet)
Seat 9: settecba folded before Flop (didn't bet)


*********** # 113 **************
PokerStars Hand #170015880377:  Hold'em No Limit ($0.01/$0.02 USD) - 20=
17/05/06 12:57:36 CUST [2017/05/05 22:57:36 ET]
Table 'Wodan' 9-max Seat #6 is the button
Seat 1: H1JackH1gh ($2.42 in chips)=20
Seat 2: VishegasM ($2 in chips)=20
Seat 3: StarsEyeDee ($2.55 in chips)=20
Seat 4: Lanesra_90 ($2.57 in chips)=20
Seat 5: diment76 ($1.86 in chips)=20
Seat 6: Souljacker87 ($6.78 in chips)=20
Seat 7: the_wickstar ($0.33 in chips)=20
Seat 8: JOSSEPH K ($2.01 in chips)=20
Seat 9: rana3792 ($1.95 in chips)=20
the_wickstar: posts small blind $0.01
JOSSEPH K: posts big blind $0.02
*** HOLE CARDS ***
Dealt to the_wickstar [Ts 6h]
rana3792: folds=20
H1JackH1gh: folds=20
VishegasM: folds=20
StarsEyeDee: folds=20
Lanesra_90: folds=20
diment76: folds=20
Souljacker87: raises $0.04 to $0.06
the_wickstar: folds=20
JOSSEPH K: folds=20
Uncalled bet ($0.04) returned to Souljacker87
Souljacker87 collected $0.05 from pot
Souljacker87: doesn't show hand=20
*** SUMMARY ***
Total pot $0.05 | Rake $0=20
Seat 1: H1JackH1gh folded before Flop (didn't bet)
Seat 2: VishegasM folded before Flop (didn't bet)
Seat 3: StarsEyeDee folded before Flop (didn't bet)
Seat 4: Lanesra_90 folded before Flop (didn't bet)
Seat 5: diment76 folded before Flop (didn't bet)
Seat 6: Souljacker87 (button) collected ($0.05)
Seat 7: the_wickstar (small blind) folded before Flop
Seat 8: JOSSEPH K (big blind) folded before Flop
Seat 9: rana3792 folded before Flop (didn't bet)


*********** # 114 **************
PokerStars Hand #170015877184:  Hold'em No Limit ($0.01/$0.02 USD) - 20=
17/05/06 12:57:26 CUST [2017/05/05 22:57:26 ET]
Table 'Diotima' 9-max Seat #9 is the button
Seat 1: windy417 ($2.02 in chips)=20
Seat 4: H1JackH1gh ($3.25 in chips)=20
Seat 5: the_wickstar ($1.67 in chips)=20
Seat 6: vbg92 ($1.57 in chips)=20
Seat 7: BRAT PIDD ($2.08 in chips)=20
Seat 8: pdgnqn28 ($1.48 in chips)=20
Seat 9: settecba ($2 in chips)=20
windy417: posts small blind $0.01
H1JackH1gh: posts big blind $0.02
*** HOLE CARDS ***
Dealt to the_wickstar [Td Jc]
the_wickstar: folds=20
vbg92: folds=20
BRAT PIDD: raises $0.04 to $0.06
pdgnqn28: folds=20
settecba: folds=20
windy417: folds=20
H1JackH1gh: folds=20
Uncalled bet ($0.04) returned to BRAT PIDD
BRAT PIDD collected $0.05 from pot
BRAT PIDD: doesn't show hand=20
*** SUMMARY ***
Total pot $0.05 | Rake $0=20
Seat 1: windy417 (small blind) folded before Flop
Seat 4: H1JackH1gh (big blind) folded before Flop
Seat 5: the_wickstar folded before Flop (didn't bet)
Seat 6: vbg92 folded before Flop (didn't bet)
Seat 7: BRAT PIDD collected ($0.05)
Seat 8: pdgnqn28 folded before Flop (didn't bet)
Seat 9: settecba (button) folded before Flop (didn't bet)


*********** # 115 **************
PokerStars Hand #170015870611:  Hold'em No Limit ($0.01/$0.02 USD) - 20=
17/05/06 12:57:05 CUST [2017/05/05 22:57:05 ET]
Table 'Diotima' 9-max Seat #8 is the button
Seat 1: windy417 ($2.04 in chips)=20
Seat 4: H1JackH1gh ($3.22 in chips)=20
Seat 5: the_wickstar ($1.67 in chips)=20
Seat 6: vbg92 ($1.57 in chips)=20
Seat 7: BRAT PIDD ($2.08 in chips)=20
Seat 8: pdgnqn28 ($1.48 in chips)=20
Seat 9: settecba ($2 in chips)=20
settecba: posts small blind $0.01
windy417: posts big blind $0.02
*** HOLE CARDS ***
Dealt to the_wickstar [2s Jc]
H1JackH1gh: raises $0.06 to $0.08
the_wickstar: folds=20
vbg92: folds=20
BRAT PIDD: folds=20
pdgnqn28: folds=20
settecba: folds=20
windy417: folds=20
Uncalled bet ($0.06) returned to H1JackH1gh
H1JackH1gh collected $0.05 from pot
H1JackH1gh: doesn't show hand=20
*** SUMMARY ***
Total pot $0.05 | Rake $0=20
Seat 1: windy417 (big blind) folded before Flop
Seat 4: H1JackH1gh collected ($0.05)
Seat 5: the_wickstar folded before Flop (didn't bet)
Seat 6: vbg92 folded before Flop (didn't bet)
Seat 7: BRAT PIDD folded before Flop (didn't bet)
Seat 8: pdgnqn28 (button) folded before Flop (didn't bet)
Seat 9: settecba (small blind) folded before Flop


*********** # 116 **************
PokerStars Hand #170015863619:  Hold'em No Limit ($0.01/$0.02 USD) - 20=
17/05/06 12:56:43 CUST [2017/05/05 22:56:43 ET]
Table 'Mathilde III' 9-max Seat #3 is the button
Seat 1: Kabit510 ($2.07 in chips)=20
Seat 2: zecateto ($4.82 in chips)=20
Seat 3: howata ($2.11 in chips)=20
Seat 4: manugar91 ($2 in chips)=20
Seat 5: rssollero ($2.05 in chips)=20
Seat 6: drinkedfish ($2.23 in chips)=20
Seat 7: July Van7 ($2.10 in chips)=20
Seat 8: the_wickstar ($2.77 in chips)=20
Seat 9: Luks_Jr ($2.19 in chips)=20
manugar91: posts small blind $0.01
rssollero: posts big blind $0.02
*** HOLE CARDS ***
Dealt to the_wickstar [Jh 7h]
drinkedfish: folds=20
July Van7: folds=20
the_wickstar: folds=20
Luks_Jr: folds=20
Kabit510: folds=20
zecateto: raises $0.04 to $0.06
howata: calls $0.06
manugar91: folds=20
rssollero: calls $0.04
*** FLOP *** [Td 7d 5c]
rssollero: checks=20
zecateto: bets $0.09
howata: folds=20
rssollero: folds=20
Uncalled bet ($0.09) returned to zecateto
zecateto collected $0.18 from pot
zecateto: doesn't show hand=20
*** SUMMARY ***
Total pot $0.19 | Rake $0.01=20
Board [Td 7d 5c]
Seat 1: Kabit510 folded before Flop (didn't bet)
Seat 2: zecateto collected ($0.18)
Seat 3: howata (button) folded on the Flop
Seat 4: manugar91 (small blind) folded before Flop
Seat 5: rssollero (big blind) folded on the Flop
Seat 6: drinkedfish folded before Flop (didn't bet)
Seat 7: July Van7 folded before Flop (didn't bet)
Seat 8: the_wickstar folded before Flop (didn't bet)
Seat 9: Luks_Jr folded before Flop (didn't bet)


*********** # 117 **************
PokerStars Hand #170015862266:  Hold'em No Limit ($0.01/$0.02 USD) - 20=
17/05/06 12:56:39 CUST [2017/05/05 22:56:39 ET]
Table 'Diotima' 9-max Seat #7 is the button
Seat 1: windy417 ($2.04 in chips)=20
Seat 3: Minato1529 ($0.97 in chips)=20
Seat 4: H1JackH1gh ($3.22 in chips)=20
Seat 5: the_wickstar ($1.67 in chips)=20
Seat 6: vbg92 ($1.57 in chips)=20
Seat 7: BRAT PIDD ($2.08 in chips)=20
Seat 8: pdgnqn28 ($1.46 in chips)=20
Seat 9: settecba ($2 in chips)=20
pdgnqn28: posts small blind $0.01
settecba: posts big blind $0.02
*** HOLE CARDS ***
Dealt to the_wickstar [9c 8h]
windy417: folds=20
Minato1529: folds=20
Minato1529 leaves the table
H1JackH1gh: folds=20
the_wickstar: folds=20
vbg92: folds=20
BRAT PIDD: folds=20
pdgnqn28: raises $0.04 to $0.06
settecba: folds=20
Uncalled bet ($0.04) returned to pdgnqn28
pdgnqn28 collected $0.04 from pot
*** SUMMARY ***
Total pot $0.04 | Rake $0=20
Seat 1: windy417 folded before Flop (didn't bet)
Seat 3: Minato1529 folded before Flop (didn't bet)
Seat 4: H1JackH1gh folded before Flop (didn't bet)
Seat 5: the_wickstar folded before Flop (didn't bet)
Seat 6: vbg92 folded before Flop (didn't bet)
Seat 7: BRAT PIDD (button) folded before Flop (didn't bet)
Seat 8: pdgnqn28 (small blind) collected ($0.04)
Seat 9: settecba (big blind) folded before Flop


*********** # 118 **************
PokerStars Hand #170015854950:  Hold'em No Limit ($0.01/$0.02 USD) - 20=
17/05/06 12:56:16 CUST [2017/05/05 22:56:16 ET]
Table 'Wodan' 9-max Seat #5 is the button
Seat 1: H1JackH1gh ($2.42 in chips)=20
Seat 2: VishegasM ($2.28 in chips)=20
Seat 3: StarsEyeDee ($2.55 in chips)=20
Seat 4: Lanesra_90 ($2.11 in chips)=20
Seat 5: diment76 ($1.86 in chips)=20
Seat 6: Souljacker87 ($6.84 in chips)=20
Seat 7: the_wickstar ($0.35 in chips)=20
Seat 8: JOSSEPH K ($2.01 in chips)=20
Seat 9: rana3792 ($1.95 in chips)=20
Souljacker87: posts small blind $0.01
the_wickstar: posts big blind $0.02
*** HOLE CARDS ***
Dealt to the_wickstar [9d 8c]
JOSSEPH K: folds=20
rana3792: folds=20
H1JackH1gh: folds=20
VishegasM: raises $0.04 to $0.06
StarsEyeDee: folds=20
Lanesra_90: calls $0.06
diment76: folds=20
Souljacker87: calls $0.05
the_wickstar: folds=20
*** FLOP *** [Ad Ah 3d]
Souljacker87: checks=20
VishegasM: bets $0.13
Lanesra_90: calls $0.13
Souljacker87: folds=20
*** TURN *** [Ad Ah 3d] [4d]
VishegasM: checks=20
Lanesra_90: bets $0.22
VishegasM: calls $0.22
*** RIVER *** [Ad Ah 3d 4d] [Td]
VishegasM: checks=20
Lanesra_90: bets $0.55
VishegasM: folds=20
Uncalled bet ($0.55) returned to Lanesra_90
Lanesra_90 collected $0.87 from pot
Lanesra_90: doesn't show hand=20
*** SUMMARY ***
Total pot $0.90 | Rake $0.03=20
Board [Ad Ah 3d 4d Td]
Seat 1: H1JackH1gh folded before Flop (didn't bet)
Seat 2: VishegasM folded on the River
Seat 3: StarsEyeDee folded before Flop (didn't bet)
Seat 4: Lanesra_90 collected ($0.87)
Seat 5: diment76 (button) folded before Flop (didn't bet)
Seat 6: Souljacker87 (small blind) folded on the Flop
Seat 7: the_wickstar (big blind) folded before Flop
Seat 8: JOSSEPH K folded before Flop (didn't bet)
Seat 9: rana3792 folded before Flop (didn't bet)


*********** # 119 **************
PokerStars Hand #170015850803:  Hold'em No Limit ($0.01/$0.02 USD) - 20=
17/05/06 12:56:03 CUST [2017/05/05 22:56:03 ET]
Table 'Diotima' 9-max Seat #6 is the button
Seat 1: windy417 ($2.04 in chips)=20
Seat 2: kt621 ($3.14 in chips)=20
Seat 3: Minato1529 ($0.97 in chips)=20
Seat 4: H1JackH1gh ($3.22 in chips)=20
Seat 5: the_wickstar ($1.67 in chips)=20
Seat 6: vbg92 ($1.63 in chips)=20
Seat 7: BRAT PIDD ($2 in chips)=20
Seat 8: pdgnqn28 ($1.48 in chips)=20
BRAT PIDD: posts small blind $0.01
pdgnqn28: posts big blind $0.02
settecba: sits out=20
*** HOLE CARDS ***
Dealt to the_wickstar [8h Tc]
windy417: folds=20
kt621: folds=20
Minato1529: folds=20
H1JackH1gh: folds=20
the_wickstar: folds=20
vbg92: raises $0.04 to $0.06
BRAT PIDD: raises $0.14 to $0.20
kt621 leaves the table
pdgnqn28: folds=20
vbg92: folds=20
Uncalled bet ($0.14) returned to BRAT PIDD
BRAT PIDD collected $0.14 from pot
BRAT PIDD: doesn't show hand=20
*** SUMMARY ***
Total pot $0.14 | Rake $0=20
Seat 1: windy417 folded before Flop (didn't bet)
Seat 2: kt621 folded before Flop (didn't bet)
Seat 3: Minato1529 folded before Flop (didn't bet)
Seat 4: H1JackH1gh folded before Flop (didn't bet)
Seat 5: the_wickstar folded before Flop (didn't bet)
Seat 6: vbg92 (button) folded before Flop
Seat 7: BRAT PIDD (small blind) collected ($0.14)
Seat 8: pdgnqn28 (big blind) folded before Flop


*********** # 120 **************
PokerStars Hand #170015849671:  Hold'em No Limit ($0.01/$0.02 USD) - 20=
17/05/06 12:55:59 CUST [2017/05/05 22:55:59 ET]
Table 'Mathilde III' 9-max Seat #2 is the button
Seat 1: Kabit510 ($2.07 in chips)=20
Seat 2: zecateto ($4.79 in chips)=20
Seat 3: howata ($2.12 in chips)=20
Seat 4: manugar91 ($2 in chips)=20
Seat 5: rssollero ($2.05 in chips)=20
Seat 6: drinkedfish ($2.23 in chips)=20
Seat 7: July Van7 ($2.10 in chips)=20
Seat 8: the_wickstar ($2.77 in chips)=20
Seat 9: Luks_Jr ($2.19 in chips)=20
howata: posts small blind $0.01
manugar91: posts big blind $0.02
*** HOLE CARDS ***
Dealt to the_wickstar [8d 6h]
rssollero: folds=20
drinkedfish: folds=20
July Van7: folds=20
the_wickstar: folds=20
Luks_Jr: folds=20
Kabit510: folds=20
zecateto: raises $0.04 to $0.06
howata: folds=20
manugar91: folds=20
Uncalled bet ($0.04) returned to zecateto
zecateto collected $0.05 from pot
zecateto: doesn't show hand=20
*** SUMMARY ***
Total pot $0.05 | Rake $0=20
Seat 1: Kabit510 folded before Flop (didn't bet)
Seat 2: zecateto (button) collected ($0.05)
Seat 3: howata (small blind) folded before Flop
Seat 4: manugar91 (big blind) folded before Flop
Seat 5: rssollero folded before Flop (didn't bet)
Seat 6: drinkedfish folded before Flop (didn't bet)
Seat 7: July Van7 folded before Flop (didn't bet)
Seat 8: the_wickstar folded before Flop (didn't bet)
Seat 9: Luks_Jr folded before Flop (didn't bet)


*********** # 121 **************
PokerStars Hand #170015846641:  Hold'em No Limit ($0.01/$0.02 USD) - 20=
17/05/06 12:55:49 CUST [2017/05/05 22:55:49 ET]
Table 'Wodan' 9-max Seat #4 is the button
Seat 1: H1JackH1gh ($2.42 in chips)=20
Seat 2: VishegasM ($2.28 in chips)=20
Seat 3: StarsEyeDee ($2.50 in chips)=20
Seat 4: Lanesra_90 ($2.11 in chips)=20
Seat 5: diment76 ($1.87 in chips)=20
Seat 6: Souljacker87 ($6.86 in chips)=20
Seat 7: the_wickstar ($0.35 in chips)=20
Seat 8: JOSSEPH K ($2.01 in chips)=20
Seat 9: rana3792 ($1.97 in chips)=20
diment76: posts small blind $0.01
Souljacker87: posts big blind $0.02
*** HOLE CARDS ***
Dealt to the_wickstar [Tc Qc]
the_wickstar: folds=20
JOSSEPH K: folds=20
rana3792: calls $0.02
H1JackH1gh: folds=20
VishegasM: folds=20
StarsEyeDee: raises $2.48 to $2.50 and is all-in
Lanesra_90: folds=20
diment76: folds=20
Souljacker87: folds=20
rana3792: folds=20
Uncalled bet ($2.48) returned to StarsEyeDee
StarsEyeDee collected $0.07 from pot
StarsEyeDee: doesn't show hand=20
*** SUMMARY ***
Total pot $0.07 | Rake $0=20
Seat 1: H1JackH1gh folded before Flop (didn't bet)
Seat 2: VishegasM folded before Flop (didn't bet)
Seat 3: StarsEyeDee collected ($0.07)
Seat 4: Lanesra_90 (button) folded before Flop (didn't bet)
Seat 5: diment76 (small blind) folded before Flop
Seat 6: Souljacker87 (big blind) folded before Flop
Seat 7: the_wickstar folded before Flop (didn't bet)
Seat 8: JOSSEPH K folded before Flop (didn't bet)
Seat 9: rana3792 folded before Flop


*********** # 122 **************
PokerStars Hand #170015835103:  Hold'em No Limit ($0.01/$0.02 USD) - 20=
17/05/06 12:55:13 CUST [2017/05/05 22:55:13 ET]
Table 'Diotima' 9-max Seat #5 is the button
Seat 1: windy417 ($2.04 in chips)=20
Seat 2: kt621 ($3.11 in chips)=20
Seat 3: Minato1529 ($0.97 in chips)=20
Seat 4: H1JackH1gh ($3.22 in chips)=20
Seat 5: the_wickstar ($1.67 in chips)=20
Seat 6: vbg92 ($1.64 in chips)=20
Seat 7: BRAT PIDD ($2 in chips)=20
Seat 8: pdgnqn28 ($1.48 in chips)=20
vbg92: posts small blind $0.01
BRAT PIDD: posts big blind $0.02
settecba: sits out=20
*** HOLE CARDS ***
Dealt to the_wickstar [8h 5c]
pdgnqn28: folds=20
windy417: folds=20
kt621: raises $0.04 to $0.06
Minato1529: folds=20
H1JackH1gh: folds=20
the_wickstar: folds=20
vbg92: folds=20
BRAT PIDD: folds=20
Uncalled bet ($0.04) returned to kt621
kt621 collected $0.05 from pot
kt621: doesn't show hand=20
*** SUMMARY ***
Total pot $0.05 | Rake $0=20
Seat 1: windy417 folded before Flop (didn't bet)
Seat 2: kt621 collected ($0.05)
Seat 3: Minato1529 folded before Flop (didn't bet)
Seat 4: H1JackH1gh folded before Flop (didn't bet)
Seat 5: the_wickstar (button) folded before Flop (didn't bet)
Seat 6: vbg92 (small blind) folded before Flop
Seat 7: BRAT PIDD (big blind) folded before Flop
Seat 8: pdgnqn28 folded before Flop (didn't bet)


*********** # 123 **************
PokerStars Hand #170015827470:  Hold'em No Limit ($0.01/$0.02 USD) - 20=
17/05/06 12:54:51 CUST [2017/05/05 22:54:51 ET]
Table 'Mathilde III' 9-max Seat #1 is the button
Seat 1: Kabit510 ($2.07 in chips)=20
Seat 2: zecateto ($4.80 in chips)=20
Seat 3: howata ($2.14 in chips)=20
Seat 4: manugar91 ($2 in chips)=20
Seat 5: rssollero ($2.02 in chips)=20
Seat 6: drinkedfish ($2.23 in chips)=20
Seat 7: July Van7 ($2.10 in chips)=20
Seat 8: the_wickstar ($2.77 in chips)=20
Seat 9: Luks_Jr ($2.19 in chips)=20
zecateto: posts small blind $0.01
howata: posts big blind $0.02
*** HOLE CARDS ***
Dealt to the_wickstar [8s 6h]
manugar91: folds=20
rssollero: calls $0.02
drinkedfish: folds=20
July Van7: folds=20
the_wickstar: folds=20
Luks_Jr: folds=20
Kabit510: folds=20
zecateto: folds=20
howata: checks=20
*** FLOP *** [9s Kd As]
howata: checks=20
rssollero: bets $0.02
howata: folds=20
Uncalled bet ($0.02) returned to rssollero
rssollero collected $0.05 from pot
rssollero: doesn't show hand=20
*** SUMMARY ***
Total pot $0.05 | Rake $0=20
Board [9s Kd As]
Seat 1: Kabit510 (button) folded before Flop (didn't bet)
Seat 2: zecateto (small blind) folded before Flop
Seat 3: howata (big blind) folded on the Flop
Seat 4: manugar91 folded before Flop (didn't bet)
Seat 5: rssollero collected ($0.05)
Seat 6: drinkedfish folded before Flop (didn't bet)
Seat 7: July Van7 folded before Flop (didn't bet)
Seat 8: the_wickstar folded before Flop (didn't bet)
Seat 9: Luks_Jr folded before Flop (didn't bet)


*********** # 124 **************
PokerStars Hand #170015824520:  Hold'em No Limit ($0.01/$0.02 USD) - 20=
17/05/06 12:54:42 CUST [2017/05/05 22:54:42 ET]
Table 'Wodan' 9-max Seat #3 is the button
Seat 1: H1JackH1gh ($2.42 in chips)=20
Seat 2: VishegasM ($2 in chips)=20
Seat 3: StarsEyeDee ($2.59 in chips)=20
Seat 4: Lanesra_90 ($2.20 in chips)=20
Seat 5: diment76 ($1.89 in chips)=20
Seat 6: Souljacker87 ($6.86 in chips)=20
Seat 7: the_wickstar ($0.44 in chips)=20
Seat 8: JOSSEPH K ($2.01 in chips)=20
Seat 9: rana3792 ($1.97 in chips)=20
Lanesra_90: posts small blind $0.01
diment76: posts big blind $0.02
*** HOLE CARDS ***
Dealt to the_wickstar [3c 3s]
Souljacker87: folds=20
the_wickstar: calls $0.02
JOSSEPH K: folds=20
rana3792: folds=20
H1JackH1gh: folds=20
VishegasM: raises $0.07 to $0.09
StarsEyeDee: calls $0.09
Lanesra_90: calls $0.08
diment76: folds=20
the_wickstar: calls $0.07
*** FLOP *** [Kh Ac 4s]
Lanesra_90: checks=20
the_wickstar: checks=20
VishegasM: bets $0.24
StarsEyeDee: folds=20
Lanesra_90: folds=20
the_wickstar: folds=20
Uncalled bet ($0.24) returned to VishegasM
VishegasM collected $0.37 from pot
VishegasM: doesn't show hand=20
*** SUMMARY ***
Total pot $0.38 | Rake $0.01=20
Board [Kh Ac 4s]
Seat 1: H1JackH1gh folded before Flop (didn't bet)
Seat 2: VishegasM collected ($0.37)
Seat 3: StarsEyeDee (button) folded on the Flop
Seat 4: Lanesra_90 (small blind) folded on the Flop
Seat 5: diment76 (big blind) folded before Flop
Seat 6: Souljacker87 folded before Flop (didn't bet)
Seat 7: the_wickstar folded on the Flop
Seat 8: JOSSEPH K folded before Flop (didn't bet)
Seat 9: rana3792 folded before Flop (didn't bet)


*********** # 125 **************
PokerStars Hand #170015813160:  Hold'em No Limit ($0.01/$0.02 USD) - 20=
17/05/06 12:54:10 CUST [2017/05/05 22:54:10 ET]
Table 'Diotima' 9-max Seat #4 is the button
Seat 1: windy417 ($2.18 in chips)=20
Seat 2: kt621 ($2.95 in chips)=20
Seat 3: Minato1529 ($0.97 in chips)=20
Seat 4: H1JackH1gh ($3.22 in chips)=20
Seat 5: the_wickstar ($1.68 in chips)=20
Seat 6: vbg92 ($1.66 in chips)=20
Seat 7: BRAT PIDD ($2 in chips)=20
Seat 8: pdgnqn28 ($1.48 in chips)=20
the_wickstar: posts small blind $0.01
vbg92: posts big blind $0.02
settecba: sits out=20
*** HOLE CARDS ***
Dealt to the_wickstar [7d 2c]
BRAT PIDD: folds=20
pdgnqn28: folds=20
windy417: raises $0.04 to $0.06
kt621: calls $0.06
Minato1529: folds=20
H1JackH1gh: folds=20
the_wickstar: folds=20
vbg92: folds=20
*** FLOP *** [6d 8s 5c]
windy417: bets $0.08
kt621: calls $0.08
*** TURN *** [6d 8s 5c] [3h]
windy417: checks=20
kt621: bets $0.15
windy417: folds=20
Uncalled bet ($0.15) returned to kt621
kt621 collected $0.30 from pot
kt621: doesn't show hand=20
*** SUMMARY ***
Total pot $0.31 | Rake $0.01=20
Board [6d 8s 5c 3h]
Seat 1: windy417 folded on the Turn
Seat 2: kt621 collected ($0.30)
Seat 3: Minato1529 folded before Flop (didn't bet)
Seat 4: H1JackH1gh (button) folded before Flop (didn't bet)
Seat 5: the_wickstar (small blind) folded before Flop
Seat 6: vbg92 (big blind) folded before Flop
Seat 7: BRAT PIDD folded before Flop (didn't bet)
Seat 8: pdgnqn28 folded before Flop (didn't bet)


*********** # 126 **************
PokerStars Hand #170015808052:  Hold'em No Limit ($0.01/$0.02 USD) - 20=
17/05/06 12:53:56 CUST [2017/05/05 22:53:56 ET]
Table 'Mathilde III' 9-max Seat #9 is the button
Seat 1: Kabit510 ($2.08 in chips)=20
Seat 2: zecateto ($4.74 in chips)=20
Seat 3: howata ($2.14 in chips)=20
Seat 4: manugar91 ($2 in chips)=20
Seat 5: rssollero ($2.02 in chips)=20
Seat 6: drinkedfish ($2.23 in chips)=20
Seat 7: July Van7 ($2.10 in chips)=20
Seat 8: the_wickstar ($2.77 in chips)=20
Seat 9: Luks_Jr ($2.24 in chips)=20
Kabit510: posts small blind $0.01
zecateto: posts big blind $0.02
*** HOLE CARDS ***
Dealt to the_wickstar [3h 5c]
howata: folds=20
manugar91: folds=20
rssollero: folds=20
drinkedfish: folds=20
July Van7: folds=20
the_wickstar: folds=20
Luks_Jr: calls $0.02
Kabit510: folds=20
zecateto: checks=20
*** FLOP *** [6h 3s Kc]
zecateto: bets $0.03
Luks_Jr: calls $0.03
*** TURN *** [6h 3s Kc] [Qd]
zecateto: bets $0.06
Luks_Jr: folds=20
Uncalled bet ($0.06) returned to zecateto
zecateto collected $0.11 from pot
zecateto: doesn't show hand=20
*** SUMMARY ***
Total pot $0.11 | Rake $0=20
Board [6h 3s Kc Qd]
Seat 1: Kabit510 (small blind) folded before Flop
Seat 2: zecateto (big blind) collected ($0.11)
Seat 3: howata folded before Flop (didn't bet)
Seat 4: manugar91 folded before Flop (didn't bet)
Seat 5: rssollero folded before Flop (didn't bet)
Seat 6: drinkedfish folded before Flop (didn't bet)
Seat 7: July Van7 folded before Flop (didn't bet)
Seat 8: the_wickstar folded before Flop (didn't bet)
Seat 9: Luks_Jr (button) folded on the Turn


*********** # 127 **************
PokerStars Hand #170015796328:  Hold'em No Limit ($0.01/$0.02 USD) - 20=
17/05/06 12:53:23 CUST [2017/05/05 22:53:23 ET]
Table 'Diotima' 9-max Seat #3 is the button
Seat 1: windy417 ($2.18 in chips)=20
Seat 2: kt621 ($2.92 in chips)=20
Seat 3: Minato1529 ($0.97 in chips)=20
Seat 4: H1JackH1gh ($3.23 in chips)=20
Seat 5: the_wickstar ($1.70 in chips)=20
Seat 6: vbg92 ($1.66 in chips)=20
Seat 7: BRAT PIDD ($2 in chips)=20
Seat 8: pdgnqn28 ($1.48 in chips)=20
H1JackH1gh: posts small blind $0.01
the_wickstar: posts big blind $0.02
settecba: sits out=20
*** HOLE CARDS ***
Dealt to the_wickstar [4h Th]
vbg92: folds=20
BRAT PIDD: folds=20
pdgnqn28 has timed out
pdgnqn28: folds=20
windy417: folds=20
kt621: raises $0.04 to $0.06
Minato1529: folds=20
H1JackH1gh: folds=20
the_wickstar: folds=20
Uncalled bet ($0.04) returned to kt621
kt621 collected $0.05 from pot
kt621: doesn't show hand=20
*** SUMMARY ***
Total pot $0.05 | Rake $0=20
Seat 1: windy417 folded before Flop (didn't bet)
Seat 2: kt621 collected ($0.05)
Seat 3: Minato1529 (button) folded before Flop (didn't bet)
Seat 4: H1JackH1gh (small blind) folded before Flop
Seat 5: the_wickstar (big blind) folded before Flop
Seat 6: vbg92 folded before Flop (didn't bet)
Seat 7: BRAT PIDD folded before Flop (didn't bet)
Seat 8: pdgnqn28 folded before Flop (didn't bet)


*********** # 128 **************
PokerStars Hand #170015791277:  Hold'em No Limit ($0.01/$0.02 USD) - 20=
17/05/06 12:53:09 CUST [2017/05/05 22:53:09 ET]
Table 'Mathilde III' 9-max Seat #8 is the button
Seat 1: Kabit510 ($2.10 in chips)=20
Seat 2: zecateto ($4.74 in chips)=20
Seat 3: howata ($2.14 in chips)=20
Seat 4: manugar91 ($2 in chips)=20
Seat 5: rssollero ($2.02 in chips)=20
Seat 6: drinkedfish ($2.23 in chips)=20
Seat 7: July Van7 ($2.07 in chips)=20
Seat 8: the_wickstar ($2.77 in chips)=20
Seat 9: Luks_Jr ($2.25 in chips)=20
Luks_Jr: posts small blind $0.01
Kabit510: posts big blind $0.02
*** HOLE CARDS ***
Dealt to the_wickstar [Ts 9c]
zecateto: folds=20
howata: folds=20
manugar91: folds=20
rssollero: folds=20
drinkedfish: folds=20
July Van7: raises $0.04 to $0.06
the_wickstar: folds=20
Luks_Jr: folds=20
Kabit510: folds=20
Uncalled bet ($0.04) returned to July Van7
July Van7 collected $0.05 from pot
July Van7: doesn't show hand=20
*** SUMMARY ***
Total pot $0.05 | Rake $0=20
Seat 1: Kabit510 (big blind) folded before Flop
Seat 2: zecateto folded before Flop (didn't bet)
Seat 3: howata folded before Flop (didn't bet)
Seat 4: manugar91 folded before Flop (didn't bet)
Seat 5: rssollero folded before Flop (didn't bet)
Seat 6: drinkedfish folded before Flop (didn't bet)
Seat 7: July Van7 collected ($0.05)
Seat 8: the_wickstar (button) folded before Flop (didn't bet)
Seat 9: Luks_Jr (small blind) folded before Flop


*********** # 129 **************
PokerStars Hand #170015789848:  Hold'em No Limit ($0.01/$0.02 USD) - 20=
17/05/06 12:53:05 CUST [2017/05/05 22:53:05 ET]
Table 'Wodan' 9-max Seat #2 is the button
Seat 1: H1JackH1gh ($2.42 in chips)=20
Seat 2: VishegasM ($2 in chips)=20
Seat 3: StarsEyeDee ($2.39 in chips)=20
Seat 4: Lanesra_90 ($2.35 in chips)=20
Seat 5: diment76 ($1.89 in chips)=20
Seat 6: Souljacker87 ($6.86 in chips)=20
Seat 7: the_wickstar ($0.50 in chips)=20
Seat 8: JOSSEPH K ($2.01 in chips)=20
Seat 9: rana3792 ($1.97 in chips)=20
StarsEyeDee: posts small blind $0.01
Lanesra_90: posts big blind $0.02
*** HOLE CARDS ***
Dealt to the_wickstar [Qh Jd]
diment76: folds=20
Souljacker87: folds=20
the_wickstar: calls $0.02
JOSSEPH K: folds=20
rana3792: folds=20
H1JackH1gh: folds=20
VishegasM: folds=20
StarsEyeDee: raises $0.04 to $0.06
Lanesra_90: calls $0.04
the_wickstar: calls $0.04
*** FLOP *** [8h 5h 7c]
StarsEyeDee: checks=20
Lanesra_90: bets $0.09
the_wickstar: folds=20
StarsEyeDee: calls $0.09
*** TURN *** [8h 5h 7c] [Kd]
StarsEyeDee: checks=20
Lanesra_90: checks=20
*** RIVER *** [8h 5h 7c Kd] [Ks]
StarsEyeDee: checks=20
Lanesra_90: checks=20
*** SHOW DOWN ***
StarsEyeDee: shows [Ac Kh] (three of a kind, Kings)
Lanesra_90: mucks hand=20
StarsEyeDee collected $0.35 from pot
*** SUMMARY ***
Total pot $0.36 | Rake $0.01=20
Board [8h 5h 7c Kd Ks]
Seat 1: H1JackH1gh folded before Flop (didn't bet)
Seat 2: VishegasM (button) folded before Flop (didn't bet)
Seat 3: StarsEyeDee (small blind) showed [Ac Kh] and won ($0.35) with t=
hree of a kind, Kings
Seat 4: Lanesra_90 (big blind) mucked [As Ts]
Seat 5: diment76 folded before Flop (didn't bet)
Seat 6: Souljacker87 folded before Flop (didn't bet)
Seat 7: the_wickstar folded on the Flop
Seat 8: JOSSEPH K folded before Flop (didn't bet)
Seat 9: rana3792 folded before Flop (didn't bet)


*********** # 130 **************
PokerStars Hand #170015778547:  Hold'em No Limit ($0.01/$0.02 USD) - 20=
17/05/06 12:52:33 CUST [2017/05/05 22:52:33 ET]
Table 'Mathilde III' 9-max Seat #7 is the button
Seat 1: Kabit510 ($2.10 in chips)=20
Seat 2: zecateto ($4.74 in chips)=20
Seat 3: howata ($2.14 in chips)=20
Seat 4: manugar91 ($2 in chips)=20
Seat 5: rssollero ($2.02 in chips)=20
Seat 6: drinkedfish ($2.23 in chips)=20
Seat 7: July Van7 ($2.04 in chips)=20
Seat 8: the_wickstar ($2.78 in chips)=20
Seat 9: Luks_Jr ($2.27 in chips)=20
the_wickstar: posts small blind $0.01
Luks_Jr: posts big blind $0.02
*** HOLE CARDS ***
Dealt to the_wickstar [9s 3s]
Kabit510: folds=20
zecateto: folds=20
howata: folds=20
manugar91: folds=20
rssollero: folds=20
drinkedfish: folds=20
July Van7: raises $0.03 to $0.05
the_wickstar: folds=20
Luks_Jr: folds=20
Uncalled bet ($0.03) returned to July Van7
July Van7 collected $0.05 from pot
July Van7: doesn't show hand=20
*** SUMMARY ***
Total pot $0.05 | Rake $0=20
Seat 1: Kabit510 folded before Flop (didn't bet)
Seat 2: zecateto folded before Flop (didn't bet)
Seat 3: howata folded before Flop (didn't bet)
Seat 4: manugar91 folded before Flop (didn't bet)
Seat 5: rssollero folded before Flop (didn't bet)
Seat 6: drinkedfish folded before Flop (didn't bet)
Seat 7: July Van7 (button) collected ($0.05)
Seat 8: the_wickstar (small blind) folded before Flop
Seat 9: Luks_Jr (big blind) folded before Flop


*********** # 131 **************
PokerStars Hand #170015765354:  Hold'em No Limit ($0.01/$0.02 USD) - 20=
17/05/06 12:51:56 CUST [2017/05/05 22:51:56 ET]
Table 'Diotima' 9-max Seat #2 is the button
Seat 1: windy417 ($2.24 in chips)=20
Seat 2: kt621 ($2.78 in chips)=20
Seat 3: Minato1529 ($0.98 in chips)=20
Seat 4: H1JackH1gh ($3.25 in chips)=20
Seat 5: the_wickstar ($1.70 in chips)=20
Seat 6: vbg92 ($1.66 in chips)=20
Seat 7: BRAT PIDD ($2 in chips)=20
Seat 8: pdgnqn28 ($1.54 in chips)=20
Minato1529: posts small blind $0.01
H1JackH1gh: posts big blind $0.02
settecba: sits out=20
*** HOLE CARDS ***
Dealt to the_wickstar [7s 9c]
the_wickstar: folds=20
vbg92: folds=20
BRAT PIDD: folds=20
pdgnqn28: raises $0.04 to $0.06
windy417: calls $0.06
kt621: calls $0.06
Minato1529: folds=20
H1JackH1gh: folds=20
*** FLOP *** [2c 6c 5h]
pdgnqn28: checks=20
windy417: checks=20
kt621: bets $0.16
pdgnqn28: folds=20
windy417: folds=20
Uncalled bet ($0.16) returned to kt621
kt621 collected $0.20 from pot
kt621: doesn't show hand=20
*** SUMMARY ***
Total pot $0.21 | Rake $0.01=20
Board [2c 6c 5h]
Seat 1: windy417 folded on the Flop
Seat 2: kt621 (button) collected ($0.20)
Seat 3: Minato1529 (small blind) folded before Flop
Seat 4: H1JackH1gh (big blind) folded before Flop
Seat 5: the_wickstar folded before Flop (didn't bet)
Seat 6: vbg92 folded before Flop (didn't bet)
Seat 7: BRAT PIDD folded before Flop (didn't bet)
Seat 8: pdgnqn28 folded on the Flop


*********** # 132 **************
PokerStars Hand #170015761020:  Hold'em No Limit ($0.01/$0.02 USD) - 20=
17/05/06 12:51:44 CUST [2017/05/05 22:51:44 ET]
Table 'Mathilde III' 9-max Seat #6 is the button
Seat 1: Kabit510 ($2.10 in chips)=20
Seat 2: zecateto ($4.76 in chips)=20
Seat 3: howata ($2.14 in chips)=20
Seat 4: manugar91 ($2 in chips)=20
Seat 5: rssollero ($2.02 in chips)=20
Seat 6: drinkedfish ($2.23 in chips)=20
Seat 7: July Van7 ($2 in chips)=20
Seat 8: the_wickstar ($2.80 in chips)=20
Seat 9: Luks_Jr ($2.27 in chips)=20
July Van7: posts small blind $0.01
the_wickstar: posts big blind $0.02
*** HOLE CARDS ***
Dealt to the_wickstar [Jd 2d]
Luks_Jr: folds=20
Kabit510: folds=20
zecateto: calls $0.02
howata: folds=20
manugar91: folds=20
rssollero: folds=20
drinkedfish: folds=20
July Van7: raises $0.06 to $0.08
the_wickstar: folds=20
zecateto: folds=20
Uncalled bet ($0.06) returned to July Van7
July Van7 collected $0.06 from pot
July Van7: doesn't show hand=20
*** SUMMARY ***
Total pot $0.06 | Rake $0=20
Seat 1: Kabit510 folded before Flop (didn't bet)
Seat 2: zecateto folded before Flop
Seat 3: howata folded before Flop (didn't bet)
Seat 4: manugar91 folded before Flop (didn't bet)
Seat 5: rssollero folded before Flop (didn't bet)
Seat 6: drinkedfish (button) folded before Flop (didn't bet)
Seat 7: July Van7 (small blind) collected ($0.06)
Seat 8: the_wickstar (big blind) folded before Flop
Seat 9: Luks_Jr folded before Flop (didn't bet)


*********** # 133 **************
PokerStars Hand #170015757190:  Hold'em No Limit ($0.01/$0.02 USD) - 20=
17/05/06 12:51:33 CUST [2017/05/05 22:51:33 ET]
Table 'Wodan' 9-max Seat #1 is the button
Seat 1: H1JackH1gh ($2.42 in chips)=20
Seat 2: VishegasM ($2 in chips)=20
Seat 3: StarsEyeDee ($2.41 in chips)=20
Seat 4: Lanesra_90 ($2 in chips)=20
Seat 5: diment76 ($1.89 in chips)=20
Seat 6: Souljacker87 ($7.20 in chips)=20
Seat 7: the_wickstar ($0.50 in chips)=20
Seat 8: JOSSEPH K ($2.01 in chips)=20
Seat 9: rana3792 ($1.97 in chips)=20
VishegasM: posts small blind $0.01
StarsEyeDee: posts big blind $0.02
*** HOLE CARDS ***
Dealt to the_wickstar [8h 5s]
Lanesra_90: raises $0.04 to $0.06
diment76: folds=20
Souljacker87: calls $0.06
the_wickstar: folds=20
JOSSEPH K: folds=20
rana3792: folds=20
H1JackH1gh: folds=20
VishegasM: folds=20
StarsEyeDee: folds=20
*** FLOP *** [7s 3h Td]
Lanesra_90: bets $0.09
Souljacker87: calls $0.09
*** TURN *** [7s 3h Td] [5h]
Lanesra_90: bets $0.19
Souljacker87: calls $0.19
*** RIVER *** [7s 3h Td 5h] [Tc]
Lanesra_90: bets $0.42
Souljacker87: folds=20
Uncalled bet ($0.42) returned to Lanesra_90
Lanesra_90 collected $0.69 from pot
Lanesra_90: doesn't show hand=20
*** SUMMARY ***
Total pot $0.71 | Rake $0.02=20
Board [7s 3h Td 5h Tc]
Seat 1: H1JackH1gh (button) folded before Flop (didn't bet)
Seat 2: VishegasM (small blind) folded before Flop
Seat 3: StarsEyeDee (big blind) folded before Flop
Seat 4: Lanesra_90 collected ($0.69)
Seat 5: diment76 folded before Flop (didn't bet)
Seat 6: Souljacker87 folded on the River
Seat 7: the_wickstar folded before Flop (didn't bet)
Seat 8: JOSSEPH K folded before Flop (didn't bet)
Seat 9: rana3792 folded before Flop (didn't bet)


*********** # 134 **************
PokerStars Hand #170015744914:  Hold'em No Limit ($0.01/$0.02 USD) - 20=
17/05/06 12:50:58 CUST [2017/05/05 22:50:58 ET]
Table 'Diotima' 9-max Seat #1 is the button
Seat 1: windy417 ($2.32 in chips)=20
Seat 2: kt621 ($2.79 in chips)=20
Seat 3: Minato1529 ($1 in chips)=20
Seat 4: H1JackH1gh ($3.07 in chips)=20
Seat 5: the_wickstar ($1.70 in chips)=20
Seat 6: vbg92 ($1.66 in chips)=20
Seat 7: BRAT PIDD ($2.03 in chips)=20
Seat 8: pdgnqn28 ($1.54 in chips)=20
kt621: posts small blind $0.01
Minato1529: posts big blind $0.02
settecba: sits out=20
*** HOLE CARDS ***
Dealt to the_wickstar [Jd 8s]
H1JackH1gh: raises $0.06 to $0.08
the_wickstar: folds=20
vbg92: folds=20
BRAT PIDD: calls $0.08
pdgnqn28: folds=20
windy417: calls $0.08
kt621: folds=20
Minato1529: folds=20
*** FLOP *** [2c Ac 8c]
H1JackH1gh: bets $0.18
BRAT PIDD: folds=20
windy417: folds=20
Uncalled bet ($0.18) returned to H1JackH1gh
H1JackH1gh collected $0.26 from pot
H1JackH1gh: doesn't show hand=20
*** SUMMARY ***
Total pot $0.27 | Rake $0.01=20
Board [2c Ac 8c]
Seat 1: windy417 (button) folded on the Flop
Seat 2: kt621 (small blind) folded before Flop
Seat 3: Minato1529 (big blind) folded before Flop
Seat 4: H1JackH1gh collected ($0.26)
Seat 5: the_wickstar folded before Flop (didn't bet)
Seat 6: vbg92 folded before Flop (didn't bet)
Seat 7: BRAT PIDD folded on the Flop
Seat 8: pdgnqn28 folded before Flop (didn't bet)


*********** # 135 **************
PokerStars Hand #170015730242:  Hold'em No Limit ($0.01/$0.02 USD) - 20=
17/05/06 12:50:18 CUST [2017/05/05 22:50:18 ET]
Table 'Wodan' 9-max Seat #9 is the button
Seat 1: H1JackH1gh ($2.43 in chips)=20
Seat 2: VishegasM ($2 in chips)=20
Seat 3: StarsEyeDee ($2.31 in chips)=20
Seat 4: Lanesra_90 ($2 in chips)=20
Seat 5: diment76 ($1.89 in chips)=20
Seat 6: Souljacker87 ($7.20 in chips)=20
Seat 7: the_wickstar ($0.50 in chips)=20
Seat 8: JOSSEPH K ($2.09 in chips)=20
Seat 9: rana3792 ($1.97 in chips)=20
H1JackH1gh: posts small blind $0.01
VishegasM: posts big blind $0.02
*** HOLE CARDS ***
Dealt to the_wickstar [Ts 3s]
StarsEyeDee: raises $0.06 to $0.08
Lanesra_90: folds=20
diment76: folds=20
Souljacker87: folds=20
the_wickstar: folds=20
JOSSEPH K: calls $0.08
rana3792: folds=20
H1JackH1gh: folds=20
VishegasM: folds=20
*** FLOP *** [Kh 5h Jh]
StarsEyeDee: checks=20
JOSSEPH K: checks=20
*** TURN *** [Kh 5h Jh] [5s]
StarsEyeDee: bets $0.02
JOSSEPH K: folds=20
Uncalled bet ($0.02) returned to StarsEyeDee
StarsEyeDee collected $0.18 from pot
StarsEyeDee: doesn't show hand=20
*** SUMMARY ***
Total pot $0.19 | Rake $0.01=20
Board [Kh 5h Jh 5s]
Seat 1: H1JackH1gh (small blind) folded before Flop
Seat 2: VishegasM (big blind) folded before Flop
Seat 3: StarsEyeDee collected ($0.18)
Seat 4: Lanesra_90 folded before Flop (didn't bet)
Seat 5: diment76 folded before Flop (didn't bet)
Seat 6: Souljacker87 folded before Flop (didn't bet)
Seat 7: the_wickstar folded before Flop (didn't bet)
Seat 8: JOSSEPH K folded on the Turn
Seat 9: rana3792 (button) folded before Flop (didn't bet)


*********** # 136 **************
PokerStars Hand #170015727702:  Hold'em No Limit ($0.01/$0.02 USD) - 20=
17/05/06 12:50:11 CUST [2017/05/05 22:50:11 ET]
Table 'Mathilde III' 9-max Seat #5 is the button
Seat 1: Kabit510 ($2.10 in chips)=20
Seat 2: zecateto ($4.76 in chips)=20
Seat 3: howata ($2.14 in chips)=20
Seat 4: manugar91 ($2 in chips)=20
Seat 5: rssollero ($2.02 in chips)=20
Seat 6: drinkedfish ($2.24 in chips)=20
Seat 7: July Van7 ($2 in chips)=20
Seat 8: the_wickstar ($2.80 in chips)=20
Seat 9: Luks_Jr ($1.76 in chips)=20
drinkedfish: posts small blind $0.01
July Van7: posts big blind $0.02
*** HOLE CARDS ***
Dealt to the_wickstar [2d 4c]
the_wickstar: folds=20
Luks_Jr: raises $0.02 to $0.04
Kabit510: folds=20
zecateto: folds=20
howata: folds=20
manugar91: folds=20
rssollero: folds=20
drinkedfish: folds=20
July Van7: raises $0.08 to $0.12
Luks_Jr: calls $0.08
*** FLOP *** [Kh 9h Jd]
July Van7: bets $0.14
Luks_Jr: calls $0.14
*** TURN *** [Kh 9h Jd] [4s]
July Van7: checks=20
Luks_Jr: bets $0.28
July Van7: calls $0.28
*** RIVER *** [Kh 9h Jd 4s] [Ac]
July Van7: checks=20
Luks_Jr: bets $0.76
July Van7: folds=20
Uncalled bet ($0.76) returned to Luks_Jr
Luks_Jr collected $1.05 from pot
Luks_Jr: doesn't show hand=20
*** SUMMARY ***
Total pot $1.09 | Rake $0.04=20
Board [Kh 9h Jd 4s Ac]
Seat 1: Kabit510 folded before Flop (didn't bet)
Seat 2: zecateto folded before Flop (didn't bet)
Seat 3: howata folded before Flop (didn't bet)
Seat 4: manugar91 folded before Flop (didn't bet)
Seat 5: rssollero (button) folded before Flop (didn't bet)
Seat 6: drinkedfish (small blind) folded before Flop
Seat 7: July Van7 (big blind) folded on the River
Seat 8: the_wickstar folded before Flop (didn't bet)
Seat 9: Luks_Jr collected ($1.05)


*********** # 137 **************
PokerStars Hand #170015718326:  Hold'em No Limit ($0.01/$0.02 USD) - 20=
17/05/06 12:49:45 CUST [2017/05/05 22:49:45 ET]
Table 'Mathilde III' 9-max Seat #4 is the button
Seat 1: Kabit510 ($2.10 in chips)=20
Seat 2: zecateto ($4.76 in chips)=20
Seat 3: howata ($2.14 in chips)=20
Seat 4: manugar91 ($2 in chips)=20
Seat 5: rssollero ($2 in chips)=20
Seat 6: drinkedfish ($2.26 in chips)=20
Seat 8: the_wickstar ($2.80 in chips)=20
Seat 9: Luks_Jr ($1.76 in chips)=20
rssollero: posts small blind $0.01
drinkedfish: posts big blind $0.02
July Van7: sits out=20
*** HOLE CARDS ***
Dealt to the_wickstar [2s 3h]
the_wickstar: folds=20
Luks_Jr: folds=20
Kabit510: folds=20
zecateto: folds=20
howata: folds=20
manugar91: folds=20
rssollero: raises $0.04 to $0.06
drinkedfish: folds=20
Uncalled bet ($0.04) returned to rssollero
rssollero collected $0.04 from pot
rssollero: doesn't show hand=20
*** SUMMARY ***
Total pot $0.04 | Rake $0=20
Seat 1: Kabit510 folded before Flop (didn't bet)
Seat 2: zecateto folded before Flop (didn't bet)
Seat 3: howata folded before Flop (didn't bet)
Seat 4: manugar91 (button) folded before Flop (didn't bet)
Seat 5: rssollero (small blind) collected ($0.04)
Seat 6: drinkedfish (big blind) folded before Flop
Seat 8: the_wickstar folded before Flop (didn't bet)
Seat 9: Luks_Jr folded before Flop (didn't bet)


*********** # 138 **************
PokerStars Hand #170015710655:  Hold'em No Limit ($0.01/$0.02 USD) - 20=
17/05/06 12:49:23 CUST [2017/05/05 22:49:23 ET]
Table 'Wodan' 9-max Seat #8 is the button
Seat 1: H1JackH1gh ($2.45 in chips)=20
Seat 2: VishegasM ($2 in chips)=20
Seat 3: StarsEyeDee ($2.31 in chips)=20
Seat 4: Lanesra_90 ($2 in chips)=20
Seat 5: diment76 ($1.89 in chips)=20
Seat 6: Souljacker87 ($7.26 in chips)=20
Seat 7: the_wickstar ($0.50 in chips)=20
Seat 8: JOSSEPH K ($2 in chips)=20
Seat 9: rana3792 ($1.98 in chips)=20
rana3792: posts small blind $0.01
H1JackH1gh: posts big blind $0.02
*** HOLE CARDS ***
Dealt to the_wickstar [4d 6c]
VishegasM: folds=20
StarsEyeDee: folds=20
Lanesra_90: folds=20
diment76: folds=20
Souljacker87: raises $0.04 to $0.06
the_wickstar: folds=20
JOSSEPH K: raises $0.12 to $0.18
rana3792: folds=20
H1JackH1gh: folds=20
Souljacker87: folds=20
Uncalled bet ($0.12) returned to JOSSEPH K
JOSSEPH K collected $0.15 from pot
JOSSEPH K: doesn't show hand=20
*** SUMMARY ***
Total pot $0.15 | Rake $0=20
Seat 1: H1JackH1gh (big blind) folded before Flop
Seat 2: VishegasM folded before Flop (didn't bet)
Seat 3: StarsEyeDee folded before Flop (didn't bet)
Seat 4: Lanesra_90 folded before Flop (didn't bet)
Seat 5: diment76 folded before Flop (didn't bet)
Seat 6: Souljacker87 folded before Flop
Seat 7: the_wickstar folded before Flop (didn't bet)
Seat 8: JOSSEPH K (button) collected ($0.15)
Seat 9: rana3792 (small blind) folded before Flop


*********** # 139 **************
PokerStars Hand #170015709477:  Hold'em No Limit ($0.01/$0.02 USD) - 20=
17/05/06 12:49:20 CUST [2017/05/05 22:49:20 ET]
Table 'Mathilde III' 9-max Seat #3 is the button
Seat 1: Kabit510 ($2.07 in chips)=20
Seat 2: zecateto ($4.76 in chips)=20
Seat 3: howata ($2.14 in chips)=20
Seat 4: manugar91 ($2 in chips)=20
Seat 5: rssollero ($2 in chips)=20
Seat 6: drinkedfish ($2.26 in chips)=20
Seat 8: the_wickstar ($2.80 in chips)=20
Seat 9: Luks_Jr ($1.76 in chips)=20
manugar91: posts small blind $0.01
rssollero: posts big blind $0.02
July Van7: sits out=20
*** HOLE CARDS ***
Dealt to the_wickstar [8c 7s]
drinkedfish: folds=20
the_wickstar: folds=20
Luks_Jr: folds=20
Kabit510: raises $0.04 to $0.06
zecateto: folds=20
howata: folds=20
manugar91: folds=20
rssollero: folds=20
Uncalled bet ($0.04) returned to Kabit510
Kabit510 collected $0.05 from pot
Kabit510: doesn't show hand=20
*** SUMMARY ***
Total pot $0.05 | Rake $0=20
Seat 1: Kabit510 collected ($0.05)
Seat 2: zecateto folded before Flop (didn't bet)
Seat 3: howata (button) folded before Flop (didn't bet)
Seat 4: manugar91 (small blind) folded before Flop
Seat 5: rssollero (big blind) folded before Flop
Seat 6: drinkedfish folded before Flop (didn't bet)
Seat 8: the_wickstar folded before Flop (didn't bet)
Seat 9: Luks_Jr folded before Flop (didn't bet)


*********** # 140 **************
PokerStars Hand #170015700749:  Hold'em No Limit ($0.01/$0.02 USD) - 20=
17/05/06 12:48:56 CUST [2017/05/05 22:48:56 ET]
Table 'Diotima' 9-max Seat #8 is the button
Seat 1: windy417 ($2.33 in chips)=20
Seat 2: kt621 ($3.49 in chips)=20
Seat 4: H1JackH1gh ($3.07 in chips)=20
Seat 5: the_wickstar ($1 in chips)=20
Seat 6: vbg92 ($1.70 in chips)=20
Seat 7: BRAT PIDD ($2.03 in chips)=20
Seat 8: pdgnqn28 ($1.54 in chips)=20
settecba will be allowed to play after the button
windy417: posts small blind $0.01
kt621: posts big blind $0.02
Minato1529: sits out=20
*** HOLE CARDS ***
Dealt to the_wickstar [7s 7h]
H1JackH1gh: folds=20
the_wickstar: raises $0.02 to $0.04
vbg92: calls $0.04
BRAT PIDD: folds=20
pdgnqn28: folds=20
windy417: folds=20
kt621: calls $0.02
*** FLOP *** [7d 2s 2d]
kt621: checks=20
the_wickstar: bets $0.05
vbg92: folds=20
kt621: calls $0.05
*** TURN *** [7d 2s 2d] [5s]
kt621: bets $0.11
the_wickstar: calls $0.11
*** RIVER *** [7d 2s 2d 5s] [Qd]
kt621: checks=20
the_wickstar: bets $0.21
kt621: raises $0.29 to $0.50
the_wickstar: calls $0.29
*** SHOW DOWN ***
kt621: shows [8d Ad] (a flush, Ace high)
the_wickstar: shows [7s 7h] (a full house, Sevens full of Deuces)
the_wickstar collected $1.40 from pot
*** SUMMARY ***
Total pot $1.45 | Rake $0.05=20
Board [7d 2s 2d 5s Qd]
Seat 1: windy417 (small blind) folded before Flop
Seat 2: kt621 (big blind) showed [8d Ad] and lost with a flush, Ace high
Seat 4: H1JackH1gh folded before Flop (didn't bet)
Seat 5: the_wickstar showed [7s 7h] and won ($1.40) with a full house, =
Sevens full of Deuces
Seat 6: vbg92 folded on the Flop
Seat 7: BRAT PIDD folded before Flop (didn't bet)
Seat 8: pdgnqn28 (button) folded before Flop (didn't bet)


*********** # 141 **************
PokerStars Hand #170015699009:  Hold'em No Limit ($0.01/$0.02 USD) - 20=
17/05/06 12:48:51 CUST [2017/05/05 22:48:51 ET]
Table 'Wodan' 9-max Seat #7 is the button
Seat 1: H1JackH1gh ($2.45 in chips)=20
Seat 2: VishegasM ($2.01 in chips)=20
Seat 3: StarsEyeDee ($2.31 in chips)=20
Seat 4: Lanesra_90 ($2 in chips)=20
Seat 5: diment76 ($1.72 in chips)=20
Seat 6: Souljacker87 ($7.26 in chips)=20
Seat 7: the_wickstar ($0.50 in chips)=20
Seat 8: JOSSEPH K ($2.01 in chips)=20
Seat 9: rana3792 ($2 in chips)=20
JOSSEPH K: posts small blind $0.01
rana3792: posts big blind $0.02
*** HOLE CARDS ***
Dealt to the_wickstar [2d 3h]
H1JackH1gh: folds=20
VishegasM: raises $0.05 to $0.07
StarsEyeDee: folds=20
Lanesra_90: calls $0.07
diment76: raises $0.13 to $0.20
Souljacker87: folds=20
the_wickstar: folds=20
JOSSEPH K: folds=20
rana3792: folds=20
VishegasM: folds=20
Lanesra_90: folds=20
Uncalled bet ($0.13) returned to diment76
diment76 collected $0.24 from pot
*** SUMMARY ***
Total pot $0.24 | Rake $0=20
Seat 1: H1JackH1gh folded before Flop (didn't bet)
Seat 2: VishegasM folded before Flop
Seat 3: StarsEyeDee folded before Flop (didn't bet)
Seat 4: Lanesra_90 folded before Flop
Seat 5: diment76 collected ($0.24)
Seat 6: Souljacker87 folded before Flop (didn't bet)
Seat 7: the_wickstar (button) folded before Flop (didn't bet)
Seat 8: JOSSEPH K (small blind) folded before Flop
Seat 9: rana3792 (big blind) folded before Flop


*********** # 142 **************
PokerStars Hand #170015691654:  Hold'em No Limit ($0.01/$0.02 USD) - 20=
17/05/06 12:48:31 CUST [2017/05/05 22:48:31 ET]
Table 'Wodan' 9-max Seat #6 is the button
Seat 1: H1JackH1gh ($2.45 in chips)=20
Seat 2: VishegasM ($2.01 in chips)=20
Seat 3: StarsEyeDee ($2.31 in chips)=20
Seat 4: Lanesra_90 ($2 in chips)=20
Seat 5: diment76 ($1.72 in chips)=20
Seat 6: Souljacker87 ($7.26 in chips)=20
Seat 7: the_wickstar ($0.51 in chips)=20
Seat 8: JOSSEPH K ($2 in chips)=20
the_wickstar: posts small blind $0.01
JOSSEPH K: posts big blind $0.02
rana3792: sits out=20
*** HOLE CARDS ***
Dealt to the_wickstar [5h 3c]
H1JackH1gh: folds=20
VishegasM: folds=20
StarsEyeDee: folds=20
Lanesra_90: folds=20
diment76: folds=20
Souljacker87: folds=20
the_wickstar: folds=20
Uncalled bet ($0.01) returned to JOSSEPH K
JOSSEPH K collected $0.02 from pot
JOSSEPH K: doesn't show hand=20
*** SUMMARY ***
Total pot $0.02 | Rake $0=20
Seat 1: H1JackH1gh folded before Flop (didn't bet)
Seat 2: VishegasM folded before Flop (didn't bet)
Seat 3: StarsEyeDee folded before Flop (didn't bet)
Seat 4: Lanesra_90 folded before Flop (didn't bet)
Seat 5: diment76 folded before Flop (didn't bet)
Seat 6: Souljacker87 (button) folded before Flop (didn't bet)
Seat 7: the_wickstar (small blind) folded before Flop
Seat 8: JOSSEPH K (big blind) collected ($0.02)


*********** # 143 **************
PokerStars Hand #170015685271:  Hold'em No Limit ($0.01/$0.02 USD) - 20=
17/05/06 12:48:13 CUST [2017/05/05 22:48:13 ET]
Table 'Diotima' 9-max Seat #7 is the button
Seat 1: windy417 ($2.35 in chips)=20
Seat 2: kt621 ($3.49 in chips)=20
Seat 4: H1JackH1gh ($3.07 in chips)=20
Seat 5: the_wickstar ($1 in chips)=20
Seat 6: vbg92 ($1.70 in chips)=20
Seat 7: BRAT PIDD ($2 in chips)=20
Seat 8: pdgnqn28 ($1.55 in chips)=20
pdgnqn28: posts small blind $0.01
marcos91pt was removed from the table for failing to post
windy417: posts big blind $0.02
Minato1529: sits out=20
*** HOLE CARDS ***
Dealt to the_wickstar [3s 2s]
kt621: folds=20
settecba joins the table at seat #9=20
H1JackH1gh: folds=20
the_wickstar: folds=20
vbg92: folds=20
BRAT PIDD: raises $0.02 to $0.04
pdgnqn28: folds=20
windy417: folds=20
Uncalled bet ($0.02) returned to BRAT PIDD
BRAT PIDD collected $0.05 from pot
BRAT PIDD: doesn't show hand=20
*** SUMMARY ***
Total pot $0.05 | Rake $0=20
Seat 1: windy417 (big blind) folded before Flop
Seat 2: kt621 folded before Flop (didn't bet)
Seat 4: H1JackH1gh folded before Flop (didn't bet)
Seat 5: the_wickstar folded before Flop (didn't bet)
Seat 6: vbg92 folded before Flop (didn't bet)
Seat 7: BRAT PIDD (button) collected ($0.05)
Seat 8: pdgnqn28 (small blind) folded before Flop


*********** # 144 **************
PokerStars Hand #170015684977:  Hold'em No Limit ($0.01/$0.02 USD) - 20=
17/05/06 12:48:12 CUST [2017/05/05 22:48:12 ET]
Table 'Mathilde III' 9-max Seat #2 is the button
Seat 1: Kabit510 ($2.07 in chips)=20
Seat 2: zecateto ($4.91 in chips)=20
Seat 3: howata ($1.98 in chips)=20
Seat 4: manugar91 ($2 in chips)=20
Seat 6: drinkedfish ($2.26 in chips)=20
Seat 8: the_wickstar ($2.80 in chips)=20
Seat 9: Luks_Jr ($1.76 in chips)=20
howata: posts small blind $0.01
manugar91: posts big blind $0.02
rssollero: sits out=20
July Van7: sits out=20
*** HOLE CARDS ***
Dealt to the_wickstar [4d 9d]
drinkedfish: folds=20
the_wickstar has timed out
the_wickstar: folds=20
Luks_Jr: folds=20
Kabit510: folds=20
zecateto: raises $0.04 to $0.06
howata: raises $0.09 to $0.15
manugar91: folds=20
zecateto: calls $0.09
*** FLOP *** [Qc Kc 2s]
howata: bets $0.16
zecateto: folds=20
Uncalled bet ($0.16) returned to howata
howata collected $0.31 from pot
howata: doesn't show hand=20
*** SUMMARY ***
Total pot $0.32 | Rake $0.01=20
Board [Qc Kc 2s]
Seat 1: Kabit510 folded before Flop (didn't bet)
Seat 2: zecateto (button) folded on the Flop
Seat 3: howata (small blind) collected ($0.31)
Seat 4: manugar91 (big blind) folded before Flop
Seat 6: drinkedfish folded before Flop (didn't bet)
Seat 8: the_wickstar folded before Flop (didn't bet)
Seat 9: Luks_Jr folded before Flop (didn't bet)


*********** # 145 **************
PokerStars Hand #170015659973:  Hold'em No Limit ($0.01/$0.02 USD) - 20=
17/05/06 12:47:16 CUST [2017/05/05 22:47:16 ET]
Table 'Wodan' 9-max Seat #5 is the button
Seat 1: H1JackH1gh ($2 in chips)=20
Seat 2: VishegasM ($2.01 in chips)=20
Seat 3: StarsEyeDee ($2.31 in chips)=20
Seat 4: Lanesra_90 ($2 in chips)=20
Seat 5: diment76 ($1.72 in chips)=20
Seat 6: Souljacker87 ($7.34 in chips)=20
Seat 7: the_wickstar ($0.83 in chips)=20
Souljacker87: posts small blind $0.01
the_wickstar: posts big blind $0.02
JOSSEPH K: sits out=20
rana3792: sits out=20
*** HOLE CARDS ***
Dealt to the_wickstar [Qc Jc]
H1JackH1gh: raises $0.06 to $0.08
VishegasM: folds=20
StarsEyeDee: folds=20
Lanesra_90: calls $0.08
diment76: folds=20
Souljacker87: calls $0.07
the_wickstar: calls $0.06
*** FLOP *** [4h 3h Jd]
Souljacker87: checks=20
the_wickstar: checks=20
H1JackH1gh: bets $0.24
Lanesra_90: folds=20
Souljacker87: folds=20
the_wickstar: calls $0.24
*** TURN *** [4h 3h Jd] [8c]
the_wickstar: checks=20
H1JackH1gh: bets $0.51
the_wickstar: folds=20
Uncalled bet ($0.51) returned to H1JackH1gh
H1JackH1gh collected $0.77 from pot
H1JackH1gh: doesn't show hand=20
*** SUMMARY ***
Total pot $0.80 | Rake $0.03=20
Board [4h 3h Jd 8c]
Seat 1: H1JackH1gh collected ($0.77)
Seat 2: VishegasM folded before Flop (didn't bet)
Seat 3: StarsEyeDee folded before Flop (didn't bet)
Seat 4: Lanesra_90 folded on the Flop
Seat 5: diment76 (button) folded before Flop (didn't bet)
Seat 6: Souljacker87 (small blind) folded on the Flop
Seat 7: the_wickstar (big blind) folded on the Turn


*********** # 146 **************
PokerStars Hand #170015658229:  Hold'em No Limit ($0.01/$0.02 USD) - 20=
17/05/06 12:47:11 CUST [2017/05/05 22:47:11 ET]
Table 'Mathilde III' 9-max Seat #1 is the button
Seat 1: Kabit510 ($2.07 in chips)=20
Seat 2: zecateto ($4.75 in chips)=20
Seat 3: howata ($2 in chips)=20
Seat 4: manugar91 ($2 in chips)=20
Seat 6: drinkedfish ($2.26 in chips)=20
Seat 8: the_wickstar ($2.80 in chips)=20
Seat 9: Luks_Jr ($1.91 in chips)=20
zecateto: posts small blind $0.01
howata: posts big blind $0.02
rssollero: sits out=20
July Van7: sits out=20
*** HOLE CARDS ***
Dealt to the_wickstar [2d 5s]
manugar91: folds=20
drinkedfish: folds=20
the_wickstar: folds=20
Luks_Jr: raises $0.02 to $0.04
Kabit510: folds=20
zecateto: calls $0.03
howata: folds=20
*** FLOP *** [Jc 6h Tc]
zecateto: bets $0.05
Luks_Jr: calls $0.05
*** TURN *** [Jc 6h Tc] [Ah]
zecateto: bets $0.06
Luks_Jr: calls $0.06
*** RIVER *** [Jc 6h Tc Ah] [9h]
zecateto: bets $0.31
Luks_Jr: folds=20
Uncalled bet ($0.31) returned to zecateto
zecateto collected $0.31 from pot
zecateto: doesn't show hand=20
*** SUMMARY ***
Total pot $0.32 | Rake $0.01=20
Board [Jc 6h Tc Ah 9h]
Seat 1: Kabit510 (button) folded before Flop (didn't bet)
Seat 2: zecateto (small blind) collected ($0.31)
Seat 3: howata (big blind) folded before Flop
Seat 4: manugar91 folded before Flop (didn't bet)
Seat 6: drinkedfish folded before Flop (didn't bet)
Seat 8: the_wickstar folded before Flop (didn't bet)
Seat 9: Luks_Jr folded on the River


*********** # 147 **************
PokerStars Hand #170015644448:  Hold'em No Limit ($0.01/$0.02 USD) - 20=
17/05/06 12:46:33 CUST [2017/05/05 22:46:33 ET]
Table 'Wodan' 9-max Seat #4 is the button
Seat 1: H1JackH1gh ($2 in chips)=20
Seat 2: VishegasM ($2.01 in chips)=20
Seat 3: StarsEyeDee ($2.19 in chips)=20
Seat 4: Lanesra_90 ($2 in chips)=20
Seat 5: diment76 ($1.73 in chips)=20
Seat 6: Souljacker87 ($7.40 in chips)=20
Seat 7: the_wickstar ($0.83 in chips)=20
diment76: posts small blind $0.01
Souljacker87: posts big blind $0.02
JOSSEPH K: sits out=20
rana3792: sits out=20
*** HOLE CARDS ***
Dealt to the_wickstar [5c Td]
the_wickstar: folds=20
H1JackH1gh: raises $0.04 to $0.06
VishegasM: folds=20
StarsEyeDee: calls $0.06
Lanesra_90: folds=20
diment76: folds=20
Souljacker87: calls $0.04
*** FLOP *** [5s Jc 2d]
Souljacker87: checks=20
H1JackH1gh: checks=20
StarsEyeDee: bets $0.08
Souljacker87: folds=20
H1JackH1gh: folds=20
Uncalled bet ($0.08) returned to StarsEyeDee
StarsEyeDee collected $0.18 from pot
StarsEyeDee: doesn't show hand=20
*** SUMMARY ***
Total pot $0.19 | Rake $0.01=20
Board [5s Jc 2d]
Seat 1: H1JackH1gh folded on the Flop
Seat 2: VishegasM folded before Flop (didn't bet)
Seat 3: StarsEyeDee collected ($0.18)
Seat 4: Lanesra_90 (button) folded before Flop (didn't bet)
Seat 5: diment76 (small blind) folded before Flop
Seat 6: Souljacker87 (big blind) folded on the Flop
Seat 7: the_wickstar folded before Flop (didn't bet)


*********** # 148 **************
PokerStars Hand #170015642988:  Hold'em No Limit ($0.01/$0.02 USD) - 20=
17/05/06 12:46:29 CUST [2017/05/05 22:46:29 ET]
Table 'Diotima' 9-max Seat #6 is the button
Seat 1: windy417 ($2.35 in chips)=20
Seat 2: kt621 ($3.10 in chips)=20
Seat 4: H1JackH1gh ($3.07 in chips)=20
Seat 5: the_wickstar ($1 in chips)=20
Seat 6: vbg92 ($1.70 in chips)=20
Seat 7: BRAT PIDD ($2 in chips)=20
Seat 8: pdgnqn28 ($1.57 in chips)=20
BRAT PIDD: posts small blind $0.01
pdgnqn28: posts big blind $0.02
Minato1529: sits out=20
*** HOLE CARDS ***
Dealt to the_wickstar [8h 7h]
windy417: folds=20
kt621: raises $0.04 to $0.06
H1JackH1gh: folds=20
the_wickstar: folds=20
vbg92 has timed out
vbg92: folds=20
BRAT PIDD: raises $0.14 to $0.20
pdgnqn28: folds=20
kt621: calls $0.14
*** FLOP *** [9c Ts Js]
BRAT PIDD: checks=20
kt621: bets $0.20
BRAT PIDD: calls $0.20
*** TURN *** [9c Ts Js] [Jd]
BRAT PIDD: checks=20
kt621: bets $0.46
BRAT PIDD: folds=20
Uncalled bet ($0.46) returned to kt621
kt621 collected $0.79 from pot
kt621: doesn't show hand=20
*** SUMMARY ***
Total pot $0.82 | Rake $0.03=20
Board [9c Ts Js Jd]
Seat 1: windy417 folded before Flop (didn't bet)
Seat 2: kt621 collected ($0.79)
Seat 4: H1JackH1gh folded before Flop (didn't bet)
Seat 5: the_wickstar folded before Flop (didn't bet)
Seat 6: vbg92 (button) folded before Flop (didn't bet)
Seat 7: BRAT PIDD (small blind) folded on the Turn
Seat 8: pdgnqn28 (big blind) folded before Flop


*********** # 149 **************
PokerStars Hand #170015635087:  Hold'em No Limit ($0.01/$0.02 USD) - 20=
17/05/06 12:46:08 CUST [2017/05/05 22:46:08 ET]
Table 'Diotima' 9-max Seat #5 is the button
Seat 1: windy417 ($2.35 in chips)=20
Seat 2: kt621 ($3.10 in chips)=20
Seat 4: H1JackH1gh ($3.04 in chips)=20
Seat 5: the_wickstar ($1 in chips)=20
Seat 6: vbg92 ($1.71 in chips)=20
Seat 7: BRAT PIDD ($2 in chips)=20
Seat 8: pdgnqn28 ($1.57 in chips)=20
vbg92: posts small blind $0.01
BRAT PIDD: posts big blind $0.02
Minato1529: sits out=20
*** HOLE CARDS ***
Dealt to the_wickstar [Qd 2s]
pdgnqn28: folds=20
windy417: folds=20
kt621: folds=20
H1JackH1gh: raises $0.04 to $0.06
the_wickstar: folds=20
vbg92: folds=20
BRAT PIDD: folds=20
Uncalled bet ($0.04) returned to H1JackH1gh
H1JackH1gh collected $0.05 from pot
H1JackH1gh: doesn't show hand=20
*** SUMMARY ***
Total pot $0.05 | Rake $0=20
Seat 1: windy417 folded before Flop (didn't bet)
Seat 2: kt621 folded before Flop (didn't bet)
Seat 4: H1JackH1gh collected ($0.05)
Seat 5: the_wickstar (button) folded before Flop (didn't bet)
Seat 6: vbg92 (small blind) folded before Flop
Seat 7: BRAT PIDD (big blind) folded before Flop
Seat 8: pdgnqn28 folded before Flop (didn't bet)


*********** # 150 **************
PokerStars Hand #170015634076:  Hold'em No Limit ($0.01/$0.02 USD) - 20=
17/05/06 12:46:05 CUST [2017/05/05 22:46:05 ET]
Table 'Mathilde III' 9-max Seat #9 is the button
Seat 1: Kabit510 ($2.08 in chips)=20
Seat 2: zecateto ($2.56 in chips)=20
Seat 3: howata ($2 in chips)=20
Seat 4: manugar91 ($2.34 in chips)=20
Seat 6: drinkedfish ($2.26 in chips)=20
Seat 8: the_wickstar ($2.80 in chips)=20
Seat 9: Luks_Jr ($1.91 in chips)=20
Kabit510: posts small blind $0.01
zecateto: posts big blind $0.02
rssollero: sits out=20
July Van7: sits out=20
*** HOLE CARDS ***
Dealt to the_wickstar [Ad 9d]
howata: folds=20
manugar91: raises $0.04 to $0.06
drinkedfish: folds=20
the_wickstar: folds=20
Luks_Jr: folds=20
Kabit510: folds=20
zecateto: calls $0.04
*** FLOP *** [Ac As 7h]
zecateto: checks=20
manugar91: checks=20
*** TURN *** [Ac As 7h] [5d]
zecateto: bets $0.13
manugar91: calls $0.13
*** RIVER *** [Ac As 7h 5d] [3h]
zecateto: bets $0.38
manugar91: raises $1.77 to $2.15 and is all-in
zecateto: calls $1.77
*** SHOW DOWN ***
manugar91: shows [Jc Ah] (three of a kind, Aces)
zecateto: shows [5h 5s] (a full house, Fives full of Aces)
zecateto collected $4.53 from pot
*** SUMMARY ***
Total pot $4.69 | Rake $0.16=20
Board [Ac As 7h 5d 3h]
Seat 1: Kabit510 (small blind) folded before Flop
Seat 2: zecateto (big blind) showed [5h 5s] and won ($4.53) with a full=
 house, Fives full of Aces
Seat 3: howata folded before Flop (didn't bet)
Seat 4: manugar91 showed [Jc Ah] and lost with three of a kind, Aces
Seat 6: drinkedfish folded before Flop (didn't bet)
Seat 8: the_wickstar folded before Flop (didn't bet)
Seat 9: Luks_Jr (button) folded before Flop (didn't bet)


*********** # 151 **************
PokerStars Hand #170015614455:  Hold'em No Limit ($0.01/$0.02 USD) - 20=
17/05/06 12:45:12 CUST [2017/05/05 22:45:12 ET]
Table 'Wodan' 9-max Seat #3 is the button
Seat 1: H1JackH1gh ($2 in chips)=20
Seat 2: VishegasM ($2.01 in chips)=20
Seat 3: StarsEyeDee ($2.16 in chips)=20
Seat 4: Lanesra_90 ($2 in chips)=20
Seat 5: diment76 ($1.75 in chips)=20
Seat 6: Souljacker87 ($7.40 in chips)=20
Seat 7: the_wickstar ($0.83 in chips)=20
Lanesra_90: posts small blind $0.01
diment76: posts big blind $0.02
JOSSEPH K: sits out=20
rana3792: sits out=20
*** HOLE CARDS ***
Dealt to the_wickstar [3h 6s]
Souljacker87: folds=20
the_wickstar: folds=20
H1JackH1gh: folds=20
VishegasM: folds=20
StarsEyeDee: calls $0.02
Lanesra_90: folds=20
diment76: checks=20
*** FLOP *** [Js 7s 6h]
diment76: checks=20
StarsEyeDee: checks=20
*** TURN *** [Js 7s 6h] [4h]
diment76: checks=20
StarsEyeDee: checks=20
*** RIVER *** [Js 7s 6h 4h] [8s]
diment76: checks=20
StarsEyeDee: bets $0.40
diment76: folds=20
Uncalled bet ($0.40) returned to StarsEyeDee
StarsEyeDee collected $0.05 from pot
StarsEyeDee: doesn't show hand=20
*** SUMMARY ***
Total pot $0.05 | Rake $0=20
Board [Js 7s 6h 4h 8s]
Seat 1: H1JackH1gh folded before Flop (didn't bet)
Seat 2: VishegasM folded before Flop (didn't bet)
Seat 3: StarsEyeDee (button) collected ($0.05)
Seat 4: Lanesra_90 (small blind) folded before Flop
Seat 5: diment76 (big blind) folded on the River
Seat 6: Souljacker87 folded before Flop (didn't bet)
Seat 7: the_wickstar folded before Flop (didn't bet)


*********** # 152 **************
PokerStars Hand #170015612418:  Hold'em No Limit ($0.01/$0.02 USD) - 20=
17/05/06 12:45:06 CUST [2017/05/05 22:45:06 ET]
Table 'Diotima' 9-max Seat #4 is the button
Seat 1: windy417 ($2.32 in chips)=20
Seat 2: kt621 ($3.10 in chips)=20
Seat 4: H1JackH1gh ($3.04 in chips)=20
Seat 5: the_wickstar ($1.01 in chips)=20
Seat 6: vbg92 ($1.73 in chips)=20
Seat 7: BRAT PIDD ($2 in chips)=20
Seat 8: pdgnqn28 ($1.57 in chips)=20
the_wickstar: posts small blind $0.01
vbg92: posts big blind $0.02
Minato1529: sits out=20
*** HOLE CARDS ***
Dealt to the_wickstar [5s 9h]
BRAT PIDD: folds=20
pdgnqn28: folds=20
windy417: raises $0.04 to $0.06
kt621: folds=20
H1JackH1gh: folds=20
the_wickstar: folds=20
vbg92: folds=20
Uncalled bet ($0.04) returned to windy417
windy417 collected $0.05 from pot
*** SUMMARY ***
Total pot $0.05 | Rake $0=20
Seat 1: windy417 collected ($0.05)
Seat 2: kt621 folded before Flop (didn't bet)
Seat 4: H1JackH1gh (button) folded before Flop (didn't bet)
Seat 5: the_wickstar (small blind) folded before Flop
Seat 6: vbg92 (big blind) folded before Flop
Seat 7: BRAT PIDD folded before Flop (didn't bet)
Seat 8: pdgnqn28 folded before Flop (didn't bet)


*********** # 153 **************
PokerStars Hand #170015606487:  Hold'em No Limit ($0.01/$0.02 USD) - 20=
17/05/06 12:44:50 CUST [2017/05/05 22:44:50 ET]
Table 'Mathilde III' 9-max Seat #8 is the button
Seat 1: Kabit510 ($2.10 in chips)=20
Seat 2: zecateto ($2.50 in chips)=20
Seat 3: howata ($2 in chips)=20
Seat 4: manugar91 ($2.34 in chips)=20
Seat 6: drinkedfish ($2.26 in chips)=20
Seat 8: the_wickstar ($2.82 in chips)=20
Seat 9: Luks_Jr ($1.93 in chips)=20
Luks_Jr: posts small blind $0.01
Kabit510: posts big blind $0.02
rssollero: sits out=20
July Van7: sits out=20
*** HOLE CARDS ***
Dealt to the_wickstar [2c Ac]
zecateto: calls $0.02
howata: folds=20
manugar91: folds=20
drinkedfish: folds=20
the_wickstar: calls $0.02
Luks_Jr: calls $0.01
Kabit510: checks=20
*** FLOP *** [8s Qh 7s]
Luks_Jr: checks=20
Kabit510: checks=20
zecateto: checks=20
the_wickstar: checks=20
*** TURN *** [8s Qh 7s] [Jd]
Luks_Jr: checks=20
Kabit510: checks=20
zecateto: bets $0.04
the_wickstar: folds=20
Luks_Jr: folds=20
Kabit510: folds=20
Uncalled bet ($0.04) returned to zecateto
zecateto collected $0.08 from pot
zecateto: doesn't show hand=20
*** SUMMARY ***
Total pot $0.08 | Rake $0=20
Board [8s Qh 7s Jd]
Seat 1: Kabit510 (big blind) folded on the Turn
Seat 2: zecateto collected ($0.08)
Seat 3: howata folded before Flop (didn't bet)
Seat 4: manugar91 folded before Flop (didn't bet)
Seat 6: drinkedfish folded before Flop (didn't bet)
Seat 8: the_wickstar (button) folded on the Turn
Seat 9: Luks_Jr (small blind) folded on the Turn


*********** # 154 **************
PokerStars Hand #170015602678:  Hold'em No Limit ($0.01/$0.02 USD) - 20=
17/05/06 12:44:39 CUST [2017/05/05 22:44:39 ET]
Table 'Wodan' 9-max Seat #2 is the button
Seat 1: H1JackH1gh ($2 in chips)=20
Seat 2: VishegasM ($2.01 in chips)=20
Seat 3: StarsEyeDee ($2.14 in chips)=20
Seat 4: Lanesra_90 ($2.02 in chips)=20
Seat 5: diment76 ($1.75 in chips)=20
Seat 6: Souljacker87 ($7.40 in chips)=20
Seat 7: the_wickstar ($0.83 in chips)=20
StarsEyeDee: posts small blind $0.01
Lanesra_90: posts big blind $0.02
JOSSEPH K: sits out=20
rana3792: sits out=20
*** HOLE CARDS ***
Dealt to the_wickstar [7d 2s]
diment76: folds=20
Souljacker87: folds=20
the_wickstar: folds=20
H1JackH1gh: folds=20
VishegasM: folds=20
StarsEyeDee: raises $0.06 to $0.08
Lanesra_90: folds=20
Uncalled bet ($0.06) returned to StarsEyeDee
StarsEyeDee collected $0.04 from pot
StarsEyeDee: doesn't show hand=20
*** SUMMARY ***
Total pot $0.04 | Rake $0=20
Seat 1: H1JackH1gh folded before Flop (didn't bet)
Seat 2: VishegasM (button) folded before Flop (didn't bet)
Seat 3: StarsEyeDee (small blind) collected ($0.04)
Seat 4: Lanesra_90 (big blind) folded before Flop
Seat 5: diment76 folded before Flop (didn't bet)
Seat 6: Souljacker87 folded before Flop (didn't bet)
Seat 7: the_wickstar folded before Flop (didn't bet)


*********** # 155 **************
PokerStars Hand #170015595946:  Hold'em No Limit ($0.01/$0.02 USD) - 20=
17/05/06 12:44:21 CUST [2017/05/05 22:44:21 ET]
Table 'Mathilde III' 9-max Seat #6 is the button
Seat 1: Kabit510 ($2.10 in chips)=20
Seat 2: zecateto ($2.50 in chips)=20
Seat 3: howata ($2 in chips)=20
Seat 4: manugar91 ($2.34 in chips)=20
Seat 6: drinkedfish ($2.26 in chips)=20
Seat 8: the_wickstar ($2.83 in chips)=20
Seat 9: Luks_Jr ($1.92 in chips)=20
July Van7 will be allowed to play after the button
the_wickstar: posts small blind $0.01
Luks_Jr: posts big blind $0.02
rssollero: sits out=20
*** HOLE CARDS ***
Dealt to the_wickstar [2d Jc]
Kabit510: folds=20
zecateto: folds=20
howata: folds=20
manugar91: folds=20
drinkedfish: folds=20
the_wickstar: folds=20
Uncalled bet ($0.01) returned to Luks_Jr
Luks_Jr collected $0.02 from pot
Luks_Jr: doesn't show hand=20
*** SUMMARY ***
Total pot $0.02 | Rake $0=20
Seat 1: Kabit510 folded before Flop (didn't bet)
Seat 2: zecateto folded before Flop (didn't bet)
Seat 3: howata folded before Flop (didn't bet)
Seat 4: manugar91 folded before Flop (didn't bet)
Seat 6: drinkedfish (button) folded before Flop (didn't bet)
Seat 8: the_wickstar (small blind) folded before Flop
Seat 9: Luks_Jr (big blind) collected ($0.02)


*********** # 156 **************
PokerStars Hand #170015593964:  Hold'em No Limit ($0.01/$0.02 USD) - 20=
17/05/06 12:44:15 CUST [2017/05/05 22:44:15 ET]
Table 'Wodan' 9-max Seat #1 is the button
Seat 1: H1JackH1gh ($2 in chips)=20
Seat 2: VishegasM ($2.02 in chips)=20
Seat 3: StarsEyeDee ($2.13 in chips)=20
Seat 4: Lanesra_90 ($2.02 in chips)=20
Seat 5: diment76 ($1.75 in chips)=20
Seat 6: Souljacker87 ($7.40 in chips)=20
Seat 7: the_wickstar ($0.83 in chips)=20
VishegasM: posts small blind $0.01
StarsEyeDee: posts big blind $0.02
JOSSEPH K: sits out=20
rana3792: sits out=20
*** HOLE CARDS ***
Dealt to the_wickstar [5h Qs]
Lanesra_90: folds=20
diment76: folds=20
Souljacker87: folds=20
the_wickstar: folds=20
H1JackH1gh: folds=20
VishegasM: folds=20
Uncalled bet ($0.01) returned to StarsEyeDee
StarsEyeDee collected $0.02 from pot
StarsEyeDee: doesn't show hand=20
*** SUMMARY ***
Total pot $0.02 | Rake $0=20
Seat 1: H1JackH1gh (button) folded before Flop (didn't bet)
Seat 2: VishegasM (small blind) folded before Flop
Seat 3: StarsEyeDee (big blind) collected ($0.02)
Seat 4: Lanesra_90 folded before Flop (didn't bet)
Seat 5: diment76 folded before Flop (didn't bet)
Seat 6: Souljacker87 folded before Flop (didn't bet)
Seat 7: the_wickstar folded before Flop (didn't bet)


*********** # 157 **************
PokerStars Hand #170015587934:  Hold'em No Limit ($0.01/$0.02 USD) - 20=
17/05/06 12:43:59 CUST [2017/05/05 22:43:59 ET]
Table 'Diotima' 9-max Seat #2 is the button
Seat 1: windy417 ($2 in chips)=20
Seat 2: kt621 ($3.10 in chips)=20
Seat 4: H1JackH1gh ($3.05 in chips)=20
Seat 5: the_wickstar ($1.03 in chips)=20
Seat 6: vbg92 ($1.73 in chips)=20
Seat 7: BRAT PIDD ($2.26 in chips)=20
Seat 8: pdgnqn28 ($1.57 in chips)=20
Minato1529 will be allowed to play after the button
H1JackH1gh: posts small blind $0.01
the_wickstar: posts big blind $0.02
*** HOLE CARDS ***
Dealt to the_wickstar [9c 6d]
vbg92: folds=20
BRAT PIDD: raises $0.04 to $0.06
pdgnqn28: folds=20
windy417: calls $0.06
kt621: folds=20
H1JackH1gh: folds=20
the_wickstar: folds=20
*** FLOP *** [5c 8c As]
BRAT PIDD: bets $0.09
windy417: calls $0.09
*** TURN *** [5c 8c As] [6s]
BRAT PIDD: checks=20
windy417: bets $0.16
BRAT PIDD: calls $0.16
*** RIVER *** [5c 8c As 6s] [Tc]
BRAT PIDD: checks=20
windy417: checks=20
*** SHOW DOWN ***
BRAT PIDD: shows [Ah Jh] (a pair of Aces)
windy417: shows [Qd Ad] (a pair of Aces - Queen kicker)
windy417 collected $0.63 from pot
*** SUMMARY ***
Total pot $0.65 | Rake $0.02=20
Board [5c 8c As 6s Tc]
Seat 1: windy417 showed [Qd Ad] and won ($0.63) with a pair of Aces
Seat 2: kt621 (button) folded before Flop (didn't bet)
Seat 4: H1JackH1gh (small blind) folded before Flop
Seat 5: the_wickstar (big blind) folded before Flop
Seat 6: vbg92 folded before Flop (didn't bet)
Seat 7: BRAT PIDD showed [Ah Jh] and lost with a pair of Aces
Seat 8: pdgnqn28 folded before Flop (didn't bet)


*********** # 158 **************
PokerStars Hand #170015573771:  Hold'em No Limit ($0.01/$0.02 USD) - 20=
17/05/06 12:43:21 CUST [2017/05/05 22:43:21 ET]
Table 'Wodan' 9-max Seat #7 is the button
Seat 1: H1JackH1gh ($2 in chips)=20
Seat 2: VishegasM ($2.04 in chips)=20
Seat 3: StarsEyeDee ($2.13 in chips)=20
Seat 4: Lanesra_90 ($2.02 in chips)=20
Seat 5: diment76 ($1.75 in chips)=20
Seat 6: Souljacker87 ($7.40 in chips)=20
Seat 7: the_wickstar ($0.80 in chips)=20
JOSSEPH K will be allowed to play after the button
H1JackH1gh: posts small blind $0.01
VishegasM: posts big blind $0.02
*** HOLE CARDS ***
Dealt to the_wickstar [Ad 2d]
StarsEyeDee: folds=20
Lanesra_90: folds=20
diment76: folds=20
Souljacker87: folds=20
the_wickstar: calls $0.02
H1JackH1gh: folds=20
VishegasM: checks=20
*** FLOP *** [4s 6d 6c]
VishegasM: checks=20
the_wickstar: checks=20
*** TURN *** [4s 6d 6c] [As]
VishegasM: checks=20
the_wickstar: bets $0.03
VishegasM: folds=20
Uncalled bet ($0.03) returned to the_wickstar
the_wickstar collected $0.05 from pot
*** SUMMARY ***
Total pot $0.05 | Rake $0=20
Board [4s 6d 6c As]
Seat 1: H1JackH1gh (small blind) folded before Flop
Seat 2: VishegasM (big blind) folded on the Turn
Seat 3: StarsEyeDee folded before Flop (didn't bet)
Seat 4: Lanesra_90 folded before Flop (didn't bet)
Seat 5: diment76 folded before Flop (didn't bet)
Seat 6: Souljacker87 folded before Flop (didn't bet)
Seat 7: the_wickstar (button) collected ($0.05)


*********** # 159 **************
PokerStars Hand #170015565727:  Hold'em No Limit ($0.01/$0.02 USD) - 20=
17/05/06 12:42:58 CUST [2017/05/05 22:42:58 ET]
Table 'Diotima' 9-max Seat #1 is the button
Seat 1: windy417 ($2 in chips)=20
Seat 2: kt621 ($2.97 in chips)=20
Seat 4: H1JackH1gh ($3.17 in chips)=20
Seat 5: the_wickstar ($1.05 in chips)=20
Seat 6: vbg92 ($1.73 in chips)=20
Seat 7: BRAT PIDD ($2.26 in chips)=20
Seat 8: pdgnqn28 ($1.57 in chips)=20
kt621: posts small blind $0.01
BAS RUTTE318: is sitting out=20
BAS RUTTE318 leaves the table
H1JackH1gh: posts big blind $0.02
*** HOLE CARDS ***
Dealt to the_wickstar [Ks Qd]
Minato1529 joins the table at seat #3=20
the_wickstar: calls $0.02
vbg92: folds=20
BRAT PIDD: folds=20
pdgnqn28: folds=20
windy417: folds=20
kt621: raises $0.02 to $0.04
H1JackH1gh: raises $0.08 to $0.12
the_wickstar: folds=20
kt621: calls $0.08
*** FLOP *** [4c 2h Ts]
kt621: checks=20
H1JackH1gh: checks=20
*** TURN *** [4c 2h Ts] [7s]
kt621: bets $0.13
H1JackH1gh: folds=20
Uncalled bet ($0.13) returned to kt621
kt621 collected $0.25 from pot
kt621: doesn't show hand=20
*** SUMMARY ***
Total pot $0.26 | Rake $0.01=20
Board [4c 2h Ts 7s]
Seat 1: windy417 (button) folded before Flop (didn't bet)
Seat 2: kt621 (small blind) collected ($0.25)
Seat 4: H1JackH1gh (big blind) folded on the Turn
Seat 5: the_wickstar folded before Flop
Seat 6: vbg92 folded before Flop (didn't bet)
Seat 7: BRAT PIDD folded before Flop (didn't bet)
Seat 8: pdgnqn28 folded before Flop (didn't bet)


*********** # 160 **************
PokerStars Hand #170015558839:  Hold'em No Limit ($0.01/$0.02 USD) - 20=
17/05/06 12:42:39 CUST [2017/05/05 22:42:39 ET]
Table 'Mathilde III' 9-max Seat #4 is the button
Seat 1: Kabit510 ($2.10 in chips)=20
Seat 2: zecateto ($2.27 in chips)=20
Seat 3: howata ($2 in chips)=20
Seat 4: manugar91 ($2.55 in chips)=20
Seat 6: drinkedfish ($2.28 in chips)=20
Seat 8: the_wickstar ($2.85 in chips)=20
Seat 9: Luks_Jr ($1.92 in chips)=20
drinkedfish: posts small blind $0.01
the_wickstar: posts big blind $0.02
*** HOLE CARDS ***
Dealt to the_wickstar [Kd 3s]
Luks_Jr: folds=20
Kabit510: folds=20
July Van7 joins the table at seat #7=20
rssollero joins the table at seat #5=20
zecateto: calls $0.02
howata: folds=20
manugar91: calls $0.02
drinkedfish: calls $0.01
the_wickstar: checks=20
*** FLOP *** [2h 7h 9d]
drinkedfish: checks=20
the_wickstar: checks=20
zecateto: checks=20
manugar91: bets $0.04
drinkedfish: folds=20
the_wickstar: folds=20
zecateto: calls $0.04
*** TURN *** [2h 7h 9d] [6s]
zecateto: bets $0.15
manugar91: calls $0.15
*** RIVER *** [2h 7h 9d 6s] [Ks]
zecateto: bets $0.44
manugar91: folds=20
Uncalled bet ($0.44) returned to zecateto
zecateto collected $0.44 from pot
zecateto: doesn't show hand=20
*** SUMMARY ***
Total pot $0.46 | Rake $0.02=20
Board [2h 7h 9d 6s Ks]
Seat 1: Kabit510 folded before Flop (didn't bet)
Seat 2: zecateto collected ($0.44)
Seat 3: howata folded before Flop (didn't bet)
Seat 4: manugar91 (button) folded on the River
Seat 6: drinkedfish (small blind) folded on the Flop
Seat 8: the_wickstar (big blind) folded on the Flop
Seat 9: Luks_Jr folded before Flop (didn't bet)


*********** # 161 **************
PokerStars Hand #170015558122:  Hold'em No Limit ($0.01/$0.02 USD) - 20=
17/05/06 12:42:38 CUST [2017/05/05 22:42:38 ET]
Table 'Diotima' 9-max Seat #8 is the button
Seat 1: windy417 ($2 in chips)=20
Seat 2: kt621 ($2.96 in chips)=20
Seat 3: BAS RUTTE318 ($1.48 in chips)=20
Seat 4: H1JackH1gh ($3.17 in chips)=20
Seat 5: the_wickstar ($1.05 in chips)=20
Seat 6: vbg92 ($1.73 in chips)=20
Seat 7: BRAT PIDD ($2.26 in chips)=20
Seat 8: pdgnqn28 ($1.57 in chips)=20
windy417: posts small blind $0.01
kt621: posts big blind $0.02
*** HOLE CARDS ***
Dealt to the_wickstar [8c Td]
BAS RUTTE318: folds=20
H1JackH1gh: folds=20
the_wickstar: folds=20
vbg92: folds=20
BRAT PIDD: folds=20
pdgnqn28: folds=20
windy417: folds=20
Uncalled bet ($0.01) returned to kt621
kt621 collected $0.02 from pot
kt621: doesn't show hand=20
*** SUMMARY ***
Total pot $0.02 | Rake $0=20
Seat 1: windy417 (small blind) folded before Flop
Seat 2: kt621 (big blind) collected ($0.02)
Seat 3: BAS RUTTE318 folded before Flop (didn't bet)
Seat 4: H1JackH1gh folded before Flop (didn't bet)
Seat 5: the_wickstar folded before Flop (didn't bet)
Seat 6: vbg92 folded before Flop (didn't bet)
Seat 7: BRAT PIDD folded before Flop (didn't bet)
Seat 8: pdgnqn28 (button) folded before Flop (didn't bet)


*********** # 162 **************
PokerStars Hand #170015553074:  Hold'em No Limit ($0.01/$0.02 USD) - 20=
17/05/06 12:42:24 CUST [2017/05/05 22:42:24 ET]
Table 'Wodan' 9-max Seat #6 is the button
Seat 1: H1JackH1gh ($2 in chips)=20
Seat 2: VishegasM ($2.04 in chips)=20
Seat 3: StarsEyeDee ($2.13 in chips)=20
Seat 4: Lanesra_90 ($2.02 in chips)=20
Seat 5: diment76 ($1.75 in chips)=20
Seat 6: Souljacker87 ($6.24 in chips)=20
Seat 7: the_wickstar ($0.81 in chips)=20
Seat 9: rana3792 ($1.24 in chips)=20
the_wickstar: posts small blind $0.01
TiZheRad: is sitting out=20
rana3792: posts big blind $0.02
*** HOLE CARDS ***
Dealt to the_wickstar [7s Js]
TiZheRad leaves the table
H1JackH1gh: folds=20
JOSSEPH K joins the table at seat #8=20
VishegasM: folds=20
StarsEyeDee: folds=20
Lanesra_90: folds=20
diment76: folds=20
Souljacker87: calls $0.02
the_wickstar: folds=20
rana3792: raises $0.04 to $0.06
Souljacker87: calls $0.04
*** FLOP *** [5h 3h 2d]
rana3792: bets $0.13
Souljacker87: raises $0.19 to $0.32
rana3792: raises $0.86 to $1.18 and is all-in
Souljacker87: calls $0.86
*** TURN *** [5h 3h 2d] [9d]
*** RIVER *** [5h 3h 2d 9d] [2h]
*** SHOW DOWN ***
rana3792: shows [Ac Kh] (a pair of Deuces)
Souljacker87: shows [4c 3s] (two pair, Threes and Deuces)
Souljacker87 collected $2.40 from pot
*** SUMMARY ***
Total pot $2.49 | Rake $0.09=20
Board [5h 3h 2d 9d 2h]
Seat 1: H1JackH1gh folded before Flop (didn't bet)
Seat 2: VishegasM folded before Flop (didn't bet)
Seat 3: StarsEyeDee folded before Flop (didn't bet)
Seat 4: Lanesra_90 folded before Flop (didn't bet)
Seat 5: diment76 folded before Flop (didn't bet)
Seat 6: Souljacker87 (button) showed [4c 3s] and won ($2.40) with two p=
air, Threes and Deuces
Seat 7: the_wickstar (small blind) folded before Flop
Seat 9: rana3792 (big blind) showed [Ac Kh] and lost with a pair of Deu=
ces


*********** # 163 **************
PokerStars Hand #170015543798:  Hold'em No Limit ($0.01/$0.02 USD) - 20=
17/05/06 12:41:59 CUST [2017/05/05 22:41:59 ET]
Table 'Wodan' 9-max Seat #5 is the button
Seat 1: H1JackH1gh ($2 in chips)=20
Seat 2: VishegasM ($2.04 in chips)=20
Seat 3: StarsEyeDee ($2.10 in chips)=20
Seat 4: Lanesra_90 ($2.02 in chips)=20
Seat 5: diment76 ($1.75 in chips)=20
Seat 6: Souljacker87 ($6.25 in chips)=20
Seat 7: the_wickstar ($0.83 in chips)=20
Seat 8: TiZheRad ($1.42 in chips)=20
Seat 9: rana3792 ($1.24 in chips)=20
Souljacker87: posts small blind $0.01
the_wickstar: posts big blind $0.02
*** HOLE CARDS ***
Dealt to the_wickstar [9s 7h]
TiZheRad: folds=20
rana3792: folds=20
H1JackH1gh: folds=20
VishegasM: folds=20
StarsEyeDee: raises $0.04 to $0.06
Lanesra_90: folds=20
diment76: folds=20
Souljacker87: folds=20
the_wickstar: folds=20
Uncalled bet ($0.04) returned to StarsEyeDee
StarsEyeDee collected $0.05 from pot
StarsEyeDee: doesn't show hand=20
*** SUMMARY ***
Total pot $0.05 | Rake $0=20
Seat 1: H1JackH1gh folded before Flop (didn't bet)
Seat 2: VishegasM folded before Flop (didn't bet)
Seat 3: StarsEyeDee collected ($0.05)
Seat 4: Lanesra_90 folded before Flop (didn't bet)
Seat 5: diment76 (button) folded before Flop (didn't bet)
Seat 6: Souljacker87 (small blind) folded before Flop
Seat 7: the_wickstar (big blind) folded before Flop
Seat 8: TiZheRad folded before Flop (didn't bet)
Seat 9: rana3792 folded before Flop (didn't bet)


*********** # 164 **************
PokerStars Hand #170015540856:  Hold'em No Limit ($0.01/$0.02 USD) - 20=
17/05/06 12:41:51 CUST [2017/05/05 22:41:51 ET]
Table 'Mathilde III' 9-max Seat #3 is the button
Seat 1: Kabit510 ($2.10 in chips)=20
Seat 2: zecateto ($2.27 in chips)=20
Seat 3: howata ($1.97 in chips)=20
Seat 4: manugar91 ($2.56 in chips)=20
Seat 6: drinkedfish ($2.30 in chips)=20
Seat 8: the_wickstar ($2.85 in chips)=20
Seat 9: Luks_Jr ($1.92 in chips)=20
manugar91: posts small blind $0.01
drinkedfish: posts big blind $0.02
*** HOLE CARDS ***
Dealt to the_wickstar [2h Kc]
the_wickstar: folds=20
Luks_Jr has timed out
Luks_Jr: folds=20
Kabit510: folds=20
zecateto: folds=20
howata: raises $0.04 to $0.06
manugar91: folds=20
drinkedfish: folds=20
Uncalled bet ($0.04) returned to howata
howata collected $0.05 from pot
howata: doesn't show hand=20
*** SUMMARY ***
Total pot $0.05 | Rake $0=20
Seat 1: Kabit510 folded before Flop (didn't bet)
Seat 2: zecateto folded before Flop (didn't bet)
Seat 3: howata (button) collected ($0.05)
Seat 4: manugar91 (small blind) folded before Flop
Seat 6: drinkedfish (big blind) folded before Flop
Seat 8: the_wickstar folded before Flop (didn't bet)
Seat 9: Luks_Jr folded before Flop (didn't bet)


*********** # 165 **************
PokerStars Hand #170015532604:  Hold'em No Limit ($0.01/$0.02 USD) - 20=
17/05/06 12:41:28 CUST [2017/05/05 22:41:28 ET]
Table 'Diotima' 9-max Seat #7 is the button
Seat 1: windy417 ($2 in chips)=20
Seat 2: kt621 ($2.96 in chips)=20
Seat 3: BAS RUTTE318 ($1.69 in chips)=20
Seat 4: H1JackH1gh ($3.17 in chips)=20
Seat 5: the_wickstar ($1.05 in chips)=20
Seat 6: vbg92 ($1.73 in chips)=20
Seat 7: BRAT PIDD ($2.04 in chips)=20
Seat 8: pdgnqn28 ($1.58 in chips)=20
pdgnqn28: posts small blind $0.01
windy417: posts big blind $0.02
*** HOLE CARDS ***
Dealt to the_wickstar [8d 2c]
kt621: folds=20
BAS RUTTE318: calls $0.02
H1JackH1gh: folds=20
the_wickstar: folds=20
vbg92: folds=20
BRAT PIDD: raises $0.08 to $0.10
pdgnqn28: folds=20
windy417: folds=20
BAS RUTTE318: calls $0.08
*** FLOP *** [6h Qh 3d]
BAS RUTTE318: bets $0.11
BRAT PIDD: calls $0.11
*** TURN *** [6h Qh 3d] [9s]
BAS RUTTE318: checks=20
BRAT PIDD: checks=20
*** RIVER *** [6h Qh 3d 9s] [Ah]
BAS RUTTE318: checks=20
BRAT PIDD: checks=20
*** SHOW DOWN ***
BAS RUTTE318: shows [7s 7c] (a pair of Sevens)
BRAT PIDD: shows [Js Jd] (a pair of Jacks)
BRAT PIDD collected $0.43 from pot
*** SUMMARY ***
Total pot $0.45 | Rake $0.02=20
Board [6h Qh 3d 9s Ah]
Seat 1: windy417 (big blind) folded before Flop
Seat 2: kt621 folded before Flop (didn't bet)
Seat 3: BAS RUTTE318 showed [7s 7c] and lost with a pair of Sevens
Seat 4: H1JackH1gh folded before Flop (didn't bet)
Seat 5: the_wickstar folded before Flop (didn't bet)
Seat 6: vbg92 folded before Flop (didn't bet)
Seat 7: BRAT PIDD (button) showed [Js Jd] and won ($0.43) with a pair o=
f Jacks
Seat 8: pdgnqn28 (small blind) folded before Flop


*********** # 166 **************
PokerStars Hand #170015521893:  Hold'em No Limit ($0.01/$0.02 USD) - 20=
17/05/06 12:40:59 CUST [2017/05/05 22:40:59 ET]
Table 'Wodan' 9-max Seat #4 is the button
Seat 1: H1JackH1gh ($2 in chips)=20
Seat 2: VishegasM ($2.04 in chips)=20
Seat 3: StarsEyeDee ($2.10 in chips)=20
Seat 4: Lanesra_90 ($2.02 in chips)=20
Seat 5: diment76 ($1.76 in chips)=20
Seat 6: Souljacker87 ($6.31 in chips)=20
Seat 7: the_wickstar ($0.71 in chips)=20
Seat 8: TiZheRad ($1.42 in chips)=20
Seat 9: rana3792 ($1.24 in chips)=20
diment76: posts small blind $0.01
Souljacker87: posts big blind $0.02
*** HOLE CARDS ***
Dealt to the_wickstar [Js Jc]
the_wickstar: raises $0.04 to $0.06
TiZheRad: folds=20
rana3792: folds=20
H1JackH1gh: calls $0.06
VishegasM: folds=20
StarsEyeDee: folds=20
Lanesra_90: folds=20
diment76: folds=20
Souljacker87: calls $0.04
*** FLOP *** [Ad 8c 3h]
Souljacker87: checks=20
the_wickstar: checks=20
H1JackH1gh: checks=20
*** TURN *** [Ad 8c 3h] [2d]
Souljacker87: checks=20
the_wickstar: bets $0.12
H1JackH1gh: folds=20
Souljacker87: folds=20
Uncalled bet ($0.12) returned to the_wickstar
the_wickstar collected $0.18 from pot
*** SUMMARY ***
Total pot $0.19 | Rake $0.01=20
Board [Ad 8c 3h 2d]
Seat 1: H1JackH1gh folded on the Turn
Seat 2: VishegasM folded before Flop (didn't bet)
Seat 3: StarsEyeDee folded before Flop (didn't bet)
Seat 4: Lanesra_90 (button) folded before Flop (didn't bet)
Seat 5: diment76 (small blind) folded before Flop
Seat 6: Souljacker87 (big blind) folded on the Turn
Seat 7: the_wickstar collected ($0.18)
Seat 8: TiZheRad folded before Flop (didn't bet)
Seat 9: rana3792 folded before Flop (didn't bet)


*********** # 167 **************
PokerStars Hand #170015519638:  Hold'em No Limit ($0.01/$0.02 USD) - 20=
17/05/06 12:40:53 CUST [2017/05/05 22:40:53 ET]
Table 'Mathilde III' 9-max Seat #2 is the button
Seat 1: Kabit510 ($2.10 in chips)=20
Seat 2: zecateto ($2.22 in chips)=20
Seat 3: howata ($1.98 in chips)=20
Seat 4: manugar91 ($2.60 in chips)=20
Seat 5: VishegasM ($2 in chips)=20
Seat 6: drinkedfish ($2.30 in chips)=20
Seat 8: the_wickstar ($2.85 in chips)=20
Seat 9: Luks_Jr ($1.92 in chips)=20
howata: posts small blind $0.01
manugar91: posts big blind $0.02
*** HOLE CARDS ***
Dealt to the_wickstar [6s 3d]
VishegasM: folds=20
VishegasM leaves the table
drinkedfish: folds=20
the_wickstar: folds=20
Luks_Jr: folds=20
Kabit510: folds=20
zecateto: raises $0.02 to $0.04
howata: folds=20
manugar91: calls $0.02
*** FLOP *** [Qh 3s 2c]
manugar91: checks=20
zecateto: bets $0.05
manugar91: folds=20
Uncalled bet ($0.05) returned to zecateto
zecateto collected $0.09 from pot
zecateto: doesn't show hand=20
*** SUMMARY ***
Total pot $0.09 | Rake $0=20
Board [Qh 3s 2c]
Seat 1: Kabit510 folded before Flop (didn't bet)
Seat 2: zecateto (button) collected ($0.09)
Seat 3: howata (small blind) folded before Flop
Seat 4: manugar91 (big blind) folded on the Flop
Seat 5: VishegasM folded before Flop (didn't bet)
Seat 6: drinkedfish folded before Flop (didn't bet)
Seat 8: the_wickstar folded before Flop (didn't bet)
Seat 9: Luks_Jr folded before Flop (didn't bet)


*********** # 168 **************
PokerStars Hand #170015512593:  Hold'em No Limit ($0.01/$0.02 USD) - 20=
17/05/06 12:40:33 CUST [2017/05/05 22:40:33 ET]
Table 'Diotima' 9-max Seat #6 is the button
Seat 1: windy417 ($2 in chips)=20
Seat 2: kt621 ($1.52 in chips)=20
Seat 3: BAS RUTTE318 ($1.69 in chips)=20
Seat 4: H1JackH1gh ($3.17 in chips)=20
Seat 5: the_wickstar ($1.05 in chips)=20
Seat 6: vbg92 ($1.73 in chips)=20
Seat 7: BRAT PIDD ($2.05 in chips)=20
Seat 8: pdgnqn28 ($1.60 in chips)=20
BRAT PIDD: posts small blind $0.01
pdgnqn28: posts big blind $0.02
*** HOLE CARDS ***
Dealt to the_wickstar [6h 2c]
windy417: raises $0.04 to $0.06
kt621: raises $0.10 to $0.16
BAS RUTTE318: folds=20
H1JackH1gh: folds=20
the_wickstar: folds=20
vbg92: folds=20
BRAT PIDD: folds=20
pdgnqn28: folds=20
windy417: calls $0.10
*** FLOP *** [Qd 4c Js]
windy417: checks=20
kt621: bets $0.34
windy417: raises $1.50 to $1.84 and is all-in
kt621: calls $1.02 and is all-in
Uncalled bet ($0.48) returned to windy417
*** TURN *** [Qd 4c Js] [6c]
*** RIVER *** [Qd 4c Js 6c] [7c]
*** SHOW DOWN ***
windy417: shows [Kh Ks] (a pair of Kings)
kt621: shows [Qh Qs] (three of a kind, Queens)
kt621 collected $2.96 from pot
*** SUMMARY ***
Total pot $3.07 | Rake $0.11=20
Board [Qd 4c Js 6c 7c]
Seat 1: windy417 showed [Kh Ks] and lost with a pair of Kings
Seat 2: kt621 showed [Qh Qs] and won ($2.96) with three of a kind, Quee=
ns
Seat 3: BAS RUTTE318 folded before Flop (didn't bet)
Seat 4: H1JackH1gh folded before Flop (didn't bet)
Seat 5: the_wickstar folded before Flop (didn't bet)
Seat 6: vbg92 (button) folded before Flop (didn't bet)
Seat 7: BRAT PIDD (small blind) folded before Flop
Seat 8: pdgnqn28 (big blind) folded before Flop


*********** # 169 **************
PokerStars Hand #170015503572:  Hold'em No Limit ($0.01/$0.02 USD) - 20=
17/05/06 12:40:09 CUST [2017/05/05 22:40:09 ET]
Table 'Diotima' 9-max Seat #5 is the button
Seat 1: windy417 ($2 in chips)=20
Seat 2: kt621 ($1.52 in chips)=20
Seat 3: BAS RUTTE318 ($1.69 in chips)=20
Seat 4: H1JackH1gh ($3.17 in chips)=20
Seat 5: the_wickstar ($1.02 in chips)=20
Seat 6: vbg92 ($1.74 in chips)=20
Seat 7: BRAT PIDD ($2.07 in chips)=20
vbg92: posts small blind $0.01
BRAT PIDD: posts big blind $0.02
pdgnqn28: sits out=20
*** HOLE CARDS ***
Dealt to the_wickstar [Qs Ad]
windy417: folds=20
kt621: folds=20
BAS RUTTE318: folds=20
H1JackH1gh: folds=20
the_wickstar: raises $0.04 to $0.06
vbg92: folds=20
BRAT PIDD: folds=20
Uncalled bet ($0.04) returned to the_wickstar
the_wickstar collected $0.05 from pot
*** SUMMARY ***
Total pot $0.05 | Rake $0=20
Seat 1: windy417 folded before Flop (didn't bet)
Seat 2: kt621 folded before Flop (didn't bet)
Seat 3: BAS RUTTE318 folded before Flop (didn't bet)
Seat 4: H1JackH1gh folded before Flop (didn't bet)
Seat 5: the_wickstar (button) collected ($0.05)
Seat 6: vbg92 (small blind) folded before Flop
Seat 7: BRAT PIDD (big blind) folded before Flop


*********** # 170 **************
PokerStars Hand #170015502635:  Hold'em No Limit ($0.01/$0.02 USD) - 20=
17/05/06 12:40:07 CUST [2017/05/05 22:40:07 ET]
Table 'Wodan' 9-max Seat #3 is the button
Seat 1: H1JackH1gh ($2 in chips)=20
Seat 2: VishegasM ($2.04 in chips)=20
Seat 3: StarsEyeDee ($1.98 in chips)=20
Seat 4: Lanesra_90 ($2.03 in chips)=20
Seat 5: diment76 ($1.82 in chips)=20
Seat 6: Souljacker87 ($6.37 in chips)=20
Seat 7: the_wickstar ($0.71 in chips)=20
Seat 8: TiZheRad ($1.42 in chips)=20
Seat 9: rana3792 ($1.24 in chips)=20
Lanesra_90: posts small blind $0.01
diment76: posts big blind $0.02
*** HOLE CARDS ***
Dealt to the_wickstar [4h Kc]
Souljacker87: raises $0.04 to $0.06
the_wickstar: folds=20
TiZheRad: folds=20
rana3792: folds=20
H1JackH1gh: folds=20
VishegasM: folds=20
StarsEyeDee: calls $0.06
Lanesra_90: folds=20
diment76: calls $0.04
*** FLOP *** [3c Qc 5c]
diment76: checks=20
Souljacker87: checks=20
StarsEyeDee: bets $0.11
diment76: folds=20
Souljacker87: folds=20
Uncalled bet ($0.11) returned to StarsEyeDee
StarsEyeDee collected $0.18 from pot
StarsEyeDee: doesn't show hand=20
*** SUMMARY ***
Total pot $0.19 | Rake $0.01=20
Board [3c Qc 5c]
Seat 1: H1JackH1gh folded before Flop (didn't bet)
Seat 2: VishegasM folded before Flop (didn't bet)
Seat 3: StarsEyeDee (button) collected ($0.18)
Seat 4: Lanesra_90 (small blind) folded before Flop
Seat 5: diment76 (big blind) folded on the Flop
Seat 6: Souljacker87 folded on the Flop
Seat 7: the_wickstar folded before Flop (didn't bet)
Seat 8: TiZheRad folded before Flop (didn't bet)
Seat 9: rana3792 folded before Flop (didn't bet)


*********** # 171 **************
PokerStars Hand #170015499719:  Hold'em No Limit ($0.01/$0.02 USD) - 20=
17/05/06 12:39:59 CUST [2017/05/05 22:39:59 ET]
Table 'Mathilde III' 9-max Seat #1 is the button
Seat 1: Kabit510 ($2.10 in chips)=20
Seat 2: zecateto ($2.14 in chips)=20
Seat 3: howata ($2 in chips)=20
Seat 4: manugar91 ($2.66 in chips)=20
Seat 5: VishegasM ($2 in chips)=20
Seat 6: drinkedfish ($2.30 in chips)=20
Seat 8: the_wickstar ($2.85 in chips)=20
Seat 9: Luks_Jr ($1.92 in chips)=20
zecateto: posts small blind $0.01
howata: posts big blind $0.02
*** HOLE CARDS ***
Dealt to the_wickstar [5d 3s]
Da Newf leaves the table
manugar91: raises $0.04 to $0.06
VishegasM: folds=20
drinkedfish: folds=20
the_wickstar: folds=20
Luks_Jr: folds=20
Kabit510: folds=20
zecateto: calls $0.05
howata: folds=20
*** FLOP *** [6c 4c 3h]
zecateto: bets $0.14
manugar91: folds=20
Uncalled bet ($0.14) returned to zecateto
zecateto collected $0.14 from pot
zecateto: doesn't show hand=20
*** SUMMARY ***
Total pot $0.14 | Rake $0=20
Board [6c 4c 3h]
Seat 1: Kabit510 (button) folded before Flop (didn't bet)
Seat 2: zecateto (small blind) collected ($0.14)
Seat 3: howata (big blind) folded before Flop
Seat 4: manugar91 folded on the Flop
Seat 5: VishegasM folded before Flop (didn't bet)
Seat 6: drinkedfish folded before Flop (didn't bet)
Seat 8: the_wickstar folded before Flop (didn't bet)
Seat 9: Luks_Jr folded before Flop (didn't bet)


*********** # 172 **************
PokerStars Hand #170015482663:  Hold'em No Limit ($0.01/$0.02 USD) - 20=
17/05/06 12:39:13 CUST [2017/05/05 22:39:13 ET]
Table 'Diotima' 9-max Seat #4 is the button
Seat 1: windy417 ($2 in chips)=20
Seat 2: kt621 ($1.58 in chips)=20
Seat 3: BAS RUTTE318 ($1.69 in chips)=20
Seat 4: H1JackH1gh ($3.17 in chips)=20
Seat 5: the_wickstar ($1.08 in chips)=20
Seat 6: vbg92 ($1.63 in chips)=20
Seat 7: BRAT PIDD ($2.07 in chips)=20
the_wickstar: posts small blind $0.01
vbg92: posts big blind $0.02
pdgnqn28: sits out=20
*** HOLE CARDS ***
Dealt to the_wickstar [Kc Td]
BRAT PIDD: folds=20
windy417: folds=20
kt621: raises $0.02 to $0.04
BAS RUTTE318: folds=20
H1JackH1gh: folds=20
the_wickstar: calls $0.03
vbg92: calls $0.02
*** FLOP *** [Qs 4s Ts]
the_wickstar: checks=20
vbg92: checks=20
kt621: bets $0.02
the_wickstar: calls $0.02
vbg92: raises $0.08 to $0.10
kt621: folds=20
the_wickstar: folds=20
Uncalled bet ($0.08) returned to vbg92
vbg92 collected $0.17 from pot
*** SUMMARY ***
Total pot $0.18 | Rake $0.01=20
Board [Qs 4s Ts]
Seat 1: windy417 folded before Flop (didn't bet)
Seat 2: kt621 folded on the Flop
Seat 3: BAS RUTTE318 folded before Flop (didn't bet)
Seat 4: H1JackH1gh (button) folded before Flop (didn't bet)
Seat 5: the_wickstar (small blind) folded on the Flop
Seat 6: vbg92 (big blind) collected ($0.17)
Seat 7: BRAT PIDD folded before Flop (didn't bet)


*********** # 173 **************
PokerStars Hand #170015480857:  Hold'em No Limit ($0.01/$0.02 USD) - 20=
17/05/06 12:39:08 CUST [2017/05/05 22:39:08 ET]
Table 'Wodan' 9-max Seat #2 is the button
Seat 1: H1JackH1gh ($2 in chips)=20
Seat 2: VishegasM ($2.04 in chips)=20
Seat 3: StarsEyeDee ($1.99 in chips)=20
Seat 4: Lanesra_90 ($2.05 in chips)=20
Seat 5: diment76 ($1.82 in chips)=20
Seat 6: Souljacker87 ($6.37 in chips)=20
Seat 7: the_wickstar ($0.71 in chips)=20
Seat 8: TiZheRad ($1.05 in chips)=20
Seat 9: rana3792 ($1.61 in chips)=20
StarsEyeDee: posts small blind $0.01
Lanesra_90: posts big blind $0.02
*** HOLE CARDS ***
Dealt to the_wickstar [2d 9d]
diment76: folds=20
Souljacker87: folds=20
the_wickstar: folds=20
TiZheRad: raises $0.04 to $0.06
rana3792: calls $0.06
H1JackH1gh: folds=20
VishegasM: folds=20
StarsEyeDee: folds=20
Lanesra_90: folds=20
*** FLOP *** [3h 8s 7d]
TiZheRad: bets $0.11
rana3792: calls $0.11
*** TURN *** [3h 8s 7d] [6c]
TiZheRad: checks=20
rana3792: bets $0.20
TiZheRad: calls $0.20
*** RIVER *** [3h 8s 7d 6c] [9c]
TiZheRad: checks=20
rana3792: checks=20
*** SHOW DOWN ***
TiZheRad: shows [Qd Qc] (a pair of Queens)
rana3792: mucks hand=20
TiZheRad collected $0.74 from pot
*** SUMMARY ***
Total pot $0.77 | Rake $0.03=20
Board [3h 8s 7d 6c 9c]
Seat 1: H1JackH1gh folded before Flop (didn't bet)
Seat 2: VishegasM (button) folded before Flop (didn't bet)
Seat 3: StarsEyeDee (small blind) folded before Flop
Seat 4: Lanesra_90 (big blind) folded before Flop
Seat 5: diment76 folded before Flop (didn't bet)
Seat 6: Souljacker87 folded before Flop (didn't bet)
Seat 7: the_wickstar folded before Flop (didn't bet)
Seat 8: TiZheRad showed [Qd Qc] and won ($0.74) with a pair of Queens
Seat 9: rana3792 mucked [8d Ad]


*********** # 174 **************
PokerStars Hand #170015470752:  Hold'em No Limit ($0.01/$0.02 USD) - 20=
17/05/06 12:38:41 CUST [2017/05/05 22:38:41 ET]
Table 'Diotima' 9-max Seat #3 is the button
Seat 1: windy417 ($2 in chips)=20
Seat 2: kt621 ($1.58 in chips)=20
Seat 3: BAS RUTTE318 ($1.69 in chips)=20
Seat 4: H1JackH1gh ($3.18 in chips)=20
Seat 5: the_wickstar ($1.10 in chips)=20
Seat 6: vbg92 ($1.60 in chips)=20
Seat 7: BRAT PIDD ($2.07 in chips)=20
H1JackH1gh: posts small blind $0.01
the_wickstar: posts big blind $0.02
pdgnqn28: sits out=20
*** HOLE CARDS ***
Dealt to the_wickstar [5d 6c]
vbg92: raises $0.02 to $0.04
BRAT PIDD: folds=20
windy417: folds=20
kt621: folds=20
BAS RUTTE318: folds=20
H1JackH1gh: folds=20
the_wickstar: folds=20
Uncalled bet ($0.02) returned to vbg92
vbg92 collected $0.05 from pot
*** SUMMARY ***
Total pot $0.05 | Rake $0=20
Seat 1: windy417 folded before Flop (didn't bet)
Seat 2: kt621 folded before Flop (didn't bet)
Seat 3: BAS RUTTE318 (button) folded before Flop (didn't bet)
Seat 4: H1JackH1gh (small blind) folded before Flop
Seat 5: the_wickstar (big blind) folded before Flop
Seat 6: vbg92 collected ($0.05)
Seat 7: BRAT PIDD folded before Flop (didn't bet)


*********** # 175 **************
PokerStars Hand #170015464828:  Hold'em No Limit ($0.01/$0.02 USD) - 20=
17/05/06 12:38:26 CUST [2017/05/05 22:38:26 ET]
Table 'Mathilde III' 9-max Seat #8 is the button
Seat 1: Kabit510 ($2.10 in chips)=20
Seat 2: zecateto ($1.13 in chips)=20
Seat 3: howata ($2 in chips)=20
Seat 4: manugar91 ($2.66 in chips)=20
Seat 5: VishegasM ($2 in chips)=20
Seat 6: drinkedfish ($2.30 in chips)=20
Seat 7: Da Newf ($1.08 in chips)=20
Seat 8: the_wickstar ($2.85 in chips)=20
Seat 9: Luks_Jr ($1.93 in chips)=20
Luks_Jr: posts small blind $0.01
Kabit510: posts big blind $0.02
*** HOLE CARDS ***
Dealt to the_wickstar [Td 3h]
zecateto: folds=20
howata: folds=20
manugar91: folds=20
VishegasM: folds=20
drinkedfish: folds=20
Da Newf: folds=20
the_wickstar has timed out
the_wickstar: folds=20
Luks_Jr: folds=20
Uncalled bet ($0.01) returned to Kabit510
Kabit510 collected $0.02 from pot
Kabit510: doesn't show hand=20
*** SUMMARY ***
Total pot $0.02 | Rake $0=20
Seat 1: Kabit510 (big blind) collected ($0.02)
Seat 2: zecateto folded before Flop (didn't bet)
Seat 3: howata folded before Flop (didn't bet)
Seat 4: manugar91 folded before Flop (didn't bet)
Seat 5: VishegasM folded before Flop (didn't bet)
Seat 6: drinkedfish folded before Flop (didn't bet)
Seat 7: Da Newf folded before Flop (didn't bet)
Seat 8: the_wickstar (button) folded before Flop (didn't bet)
Seat 9: Luks_Jr (small blind) folded before Flop


*********** # 176 **************
PokerStars Hand #170015453102:  Hold'em No Limit ($0.01/$0.02 USD) - 20=
17/05/06 12:37:54 CUST [2017/05/05 22:37:54 ET]
Table 'Wodan' 9-max Seat #1 is the button
Seat 1: H1JackH1gh ($2 in chips)=20
Seat 2: VishegasM ($2.05 in chips)=20
Seat 3: StarsEyeDee ($1.91 in chips)=20
Seat 4: Lanesra_90 ($2.05 in chips)=20
Seat 5: diment76 ($1.82 in chips)=20
Seat 6: Souljacker87 ($6.39 in chips)=20
Seat 7: the_wickstar ($0.77 in chips)=20
Seat 8: TiZheRad ($1.05 in chips)=20
Seat 9: rana3792 ($1.61 in chips)=20
VishegasM: posts small blind $0.01
StarsEyeDee: posts big blind $0.02
*** HOLE CARDS ***
Dealt to the_wickstar [3d 4s]
Lanesra_90: folds=20
diment76: folds=20
Souljacker87: calls $0.02
the_wickstar: calls $0.02
TiZheRad: folds=20
rana3792: folds=20
H1JackH1gh: folds=20
VishegasM: folds=20
StarsEyeDee: checks=20
*** FLOP *** [4h 7h 5s]
StarsEyeDee: bets $0.04
Souljacker87: folds=20
the_wickstar: calls $0.04
*** TURN *** [4h 7h 5s] [Ks]
StarsEyeDee: bets $0.08
the_wickstar: folds=20
Uncalled bet ($0.08) returned to StarsEyeDee
StarsEyeDee collected $0.14 from pot
StarsEyeDee: doesn't show hand=20
*** SUMMARY ***
Total pot $0.15 | Rake $0.01=20
Board [4h 7h 5s Ks]
Seat 1: H1JackH1gh (button) folded before Flop (didn't bet)
Seat 2: VishegasM (small blind) folded before Flop
Seat 3: StarsEyeDee (big blind) collected ($0.14)
Seat 4: Lanesra_90 folded before Flop (didn't bet)
Seat 5: diment76 folded before Flop (didn't bet)
Seat 6: Souljacker87 folded on the Flop
Seat 7: the_wickstar folded on the Turn
Seat 8: TiZheRad folded before Flop (didn't bet)
Seat 9: rana3792 folded before Flop (didn't bet)


*********** # 177 **************
PokerStars Hand #170015450706:  Hold'em No Limit ($0.01/$0.02 USD) - 20=
17/05/06 12:37:48 CUST [2017/05/05 22:37:48 ET]
Table 'Mathilde III' 9-max Seat #7 is the button
Seat 1: Kabit510 ($2.10 in chips)=20
Seat 2: zecateto ($1.10 in chips)=20
Seat 3: howata ($2 in chips)=20
Seat 4: manugar91 ($2.66 in chips)=20
Seat 5: VishegasM ($2 in chips)=20
Seat 6: drinkedfish ($2.30 in chips)=20
Seat 7: Da Newf ($1.08 in chips)=20
Seat 8: the_wickstar ($2.86 in chips)=20
Seat 9: Luks_Jr ($1.95 in chips)=20
the_wickstar: posts small blind $0.01
Luks_Jr: posts big blind $0.02
*** HOLE CARDS ***
Dealt to the_wickstar [Js 2c]
Kabit510: folds=20
zecateto: raises $0.04 to $0.06
howata: folds=20
manugar91: folds=20
VishegasM: folds=20
drinkedfish: folds=20
Da Newf: folds=20
the_wickstar: folds=20
Luks_Jr: folds=20
Uncalled bet ($0.04) returned to zecateto
zecateto collected $0.05 from pot
zecateto: doesn't show hand=20
*** SUMMARY ***
Total pot $0.05 | Rake $0=20
Seat 1: Kabit510 folded before Flop (didn't bet)
Seat 2: zecateto collected ($0.05)
Seat 3: howata folded before Flop (didn't bet)
Seat 4: manugar91 folded before Flop (didn't bet)
Seat 5: VishegasM folded before Flop (didn't bet)
Seat 6: drinkedfish folded before Flop (didn't bet)
Seat 7: Da Newf (button) folded before Flop (didn't bet)
Seat 8: the_wickstar (small blind) folded before Flop
Seat 9: Luks_Jr (big blind) folded before Flop


*********** # 178 **************
PokerStars Hand #170015434408:  Hold'em No Limit ($0.01/$0.02 USD) - 20=
17/05/06 12:37:04 CUST [2017/05/05 22:37:04 ET]
Table 'Wodan' 9-max Seat #9 is the button
Seat 1: H1JackH1gh ($2 in chips)=20
Seat 2: VishegasM ($2.07 in chips)=20
Seat 3: StarsEyeDee ($1.88 in chips)=20
Seat 4: Lanesra_90 ($2.05 in chips)=20
Seat 5: diment76 ($1.82 in chips)=20
Seat 6: Souljacker87 ($6.39 in chips)=20
Seat 7: the_wickstar ($0.77 in chips)=20
Seat 8: TiZheRad ($1.05 in chips)=20
Seat 9: rana3792 ($1.61 in chips)=20
H1JackH1gh: posts small blind $0.01
VishegasM: posts big blind $0.02
*** HOLE CARDS ***
Dealt to the_wickstar [3h 7d]
StarsEyeDee: raises $0.04 to $0.06
Lanesra_90: folds=20
diment76: folds=20
Souljacker87: folds=20
the_wickstar: folds=20
TiZheRad: folds=20
rana3792: folds=20
H1JackH1gh: folds=20
VishegasM: folds=20
Uncalled bet ($0.04) returned to StarsEyeDee
StarsEyeDee collected $0.05 from pot
StarsEyeDee: doesn't show hand=20
*** SUMMARY ***
Total pot $0.05 | Rake $0=20
Seat 1: H1JackH1gh (small blind) folded before Flop
Seat 2: VishegasM (big blind) folded before Flop
Seat 3: StarsEyeDee collected ($0.05)
Seat 4: Lanesra_90 folded before Flop (didn't bet)
Seat 5: diment76 folded before Flop (didn't bet)
Seat 6: Souljacker87 folded before Flop (didn't bet)
Seat 7: the_wickstar folded before Flop (didn't bet)
Seat 8: TiZheRad folded before Flop (didn't bet)
Seat 9: rana3792 (button) folded before Flop (didn't bet)


*********** # 179 **************
PokerStars Hand #170015433122:  Hold'em No Limit ($0.01/$0.02 USD) - 20=
17/05/06 12:37:01 CUST [2017/05/05 22:37:01 ET]
Table 'Mathilde III' 9-max Seat #6 is the button
Seat 1: Kabit510 ($2.10 in chips)=20
Seat 2: zecateto ($1.12 in chips)=20
Seat 3: howata ($2 in chips)=20
Seat 4: manugar91 ($2.66 in chips)=20
Seat 5: VishegasM ($1.99 in chips)=20
Seat 6: drinkedfish ($2.25 in chips)=20
Seat 7: Da Newf ($1.09 in chips)=20
Seat 8: the_wickstar ($2.88 in chips)=20
Seat 9: Luks_Jr ($1.95 in chips)=20
Da Newf: posts small blind $0.01
the_wickstar: posts big blind $0.02
*** HOLE CARDS ***
Dealt to the_wickstar [Kd 3c]
Luks_Jr: folds=20
Kabit510: folds=20
zecateto: calls $0.02
howata: folds=20
manugar91: folds=20
VishegasM: folds=20
drinkedfish: raises $0.06 to $0.08
Da Newf: folds=20
the_wickstar: folds=20
zecateto: folds=20
Uncalled bet ($0.06) returned to drinkedfish
drinkedfish collected $0.07 from pot
drinkedfish: doesn't show hand=20
*** SUMMARY ***
Total pot $0.07 | Rake $0=20
Seat 1: Kabit510 folded before Flop (didn't bet)
Seat 2: zecateto folded before Flop
Seat 3: howata folded before Flop (didn't bet)
Seat 4: manugar91 folded before Flop (didn't bet)
Seat 5: VishegasM folded before Flop (didn't bet)
Seat 6: drinkedfish (button) collected ($0.07)
Seat 7: Da Newf (small blind) folded before Flop
Seat 8: the_wickstar (big blind) folded before Flop
Seat 9: Luks_Jr folded before Flop (didn't bet)


*********** # 180 **************
PokerStars Hand #170015412937:  Hold'em No Limit ($0.01/$0.02 USD) - 20=
17/05/06 12:36:07 CUST [2017/05/05 22:36:07 ET]
Table 'Wodan' 9-max Seat #8 is the button
Seat 1: H1JackH1gh ($2.06 in chips)=20
Seat 2: VishegasM ($2.07 in chips)=20
Seat 3: StarsEyeDee ($1.88 in chips)=20
Seat 4: Lanesra_90 ($2.05 in chips)=20
Seat 5: diment76 ($1.82 in chips)=20
Seat 6: Souljacker87 ($6.39 in chips)=20
Seat 7: the_wickstar ($0.77 in chips)=20
Seat 8: TiZheRad ($0.78 in chips)=20
Seat 9: rana3792 ($1.62 in chips)=20
rana3792: posts small blind $0.01
H1JackH1gh: posts big blind $0.02
*** HOLE CARDS ***
Dealt to the_wickstar [3s 5h]
VishegasM: folds=20
StarsEyeDee: folds=20
Lanesra_90: folds=20
diment76: folds=20
Souljacker87: folds=20
the_wickstar: folds=20
TiZheRad: raises $0.04 to $0.06
rana3792: folds=20
H1JackH1gh: calls $0.04
*** FLOP *** [Qd Jd 3c]
H1JackH1gh: checks=20
TiZheRad: bets $0.08
H1JackH1gh: calls $0.08
*** TURN *** [Qd Jd 3c] [2d]
H1JackH1gh: checks=20
TiZheRad: bets $0.14
H1JackH1gh: calls $0.14
*** RIVER *** [Qd Jd 3c 2d] [5s]
H1JackH1gh: checks=20
TiZheRad: bets $0.25
H1JackH1gh: folds=20
Uncalled bet ($0.25) returned to TiZheRad
TiZheRad collected $0.55 from pot
TiZheRad: doesn't show hand=20
*** SUMMARY ***
Total pot $0.57 | Rake $0.02=20
Board [Qd Jd 3c 2d 5s]
Seat 1: H1JackH1gh (big blind) folded on the River
Seat 2: VishegasM folded before Flop (didn't bet)
Seat 3: StarsEyeDee folded before Flop (didn't bet)
Seat 4: Lanesra_90 folded before Flop (didn't bet)
Seat 5: diment76 folded before Flop (didn't bet)
Seat 6: Souljacker87 folded before Flop (didn't bet)
Seat 7: the_wickstar folded before Flop (didn't bet)
Seat 8: TiZheRad (button) collected ($0.55)
Seat 9: rana3792 (small blind) folded before Flop


*********** # 181 **************
PokerStars Hand #170015405502:  Hold'em No Limit ($0.01/$0.02 USD) - 20=
17/05/06 12:35:47 CUST [2017/05/05 22:35:47 ET]
Table 'Mathilde III' 9-max Seat #5 is the button
Seat 1: Kabit510 ($2.10 in chips)=20
Seat 2: zecateto ($1.12 in chips)=20
Seat 3: howata ($2 in chips)=20
Seat 4: manugar91 ($2.66 in chips)=20
Seat 5: VishegasM ($1.99 in chips)=20
Seat 6: drinkedfish ($2.26 in chips)=20
Seat 7: Da Newf ($1.06 in chips)=20
Seat 8: the_wickstar ($2.90 in chips)=20
Seat 9: Luks_Jr ($1.95 in chips)=20
drinkedfish: posts small blind $0.01
Da Newf: posts big blind $0.02
*** HOLE CARDS ***
Dealt to the_wickstar [Qs Kh]
the_wickstar: calls $0.02
Luks_Jr: folds=20
Kabit510: folds=20
zecateto: folds=20
howata: folds=20
manugar91: folds=20
VishegasM: folds=20
drinkedfish: folds=20
Da Newf: checks=20
*** FLOP *** [7c 5s 2s]
Da Newf: bets $0.02
the_wickstar: folds=20
Uncalled bet ($0.02) returned to Da Newf
Da Newf collected $0.05 from pot
Da Newf: doesn't show hand=20
*** SUMMARY ***
Total pot $0.05 | Rake $0=20
Board [7c 5s 2s]
Seat 1: Kabit510 folded before Flop (didn't bet)
Seat 2: zecateto folded before Flop (didn't bet)
Seat 3: howata folded before Flop (didn't bet)
Seat 4: manugar91 folded before Flop (didn't bet)
Seat 5: VishegasM (button) folded before Flop (didn't bet)
Seat 6: drinkedfish (small blind) folded before Flop
Seat 7: Da Newf (big blind) collected ($0.05)
Seat 8: the_wickstar folded on the Flop
Seat 9: Luks_Jr folded before Flop (didn't bet)


*********** # 182 **************
PokerStars Hand #170015389477:  Hold'em No Limit ($0.01/$0.02 USD) - 20=
17/05/06 12:35:05 CUST [2017/05/05 22:35:05 ET]
Table 'Wodan' 9-max Seat #7 is the button
Seat 1: H1JackH1gh ($2.06 in chips)=20
Seat 3: StarsEyeDee ($1.88 in chips)=20
Seat 4: Lanesra_90 ($2.05 in chips)=20
Seat 5: diment76 ($1.82 in chips)=20
Seat 6: Souljacker87 ($6.39 in chips)=20
Seat 7: the_wickstar ($1.11 in chips)=20
Seat 8: TiZheRad ($0.79 in chips)=20
Seat 9: rana3792 ($1.29 in chips)=20
TiZheRad: posts small blind $0.01
rana3792: posts big blind $0.02
*** HOLE CARDS ***
Dealt to the_wickstar [8c As]
H1JackH1gh: folds=20
StarsEyeDee: folds=20
Lanesra_90: folds=20
diment76: folds=20
Souljacker87: folds=20
the_wickstar: calls $0.02
TiZheRad: folds=20
rana3792: raises $0.02 to $0.04
the_wickstar: calls $0.02
*** FLOP *** [Qc 9d 4h]
rana3792: bets $0.05
the_wickstar: raises $0.05 to $0.10
rana3792: calls $0.05
*** TURN *** [Qc 9d 4h] [7h]
rana3792: checks=20
the_wickstar: bets $0.20
rana3792: calls $0.20
*** RIVER *** [Qc 9d 4h 7h] [Ts]
rana3792: bets $0.67
the_wickstar: folds=20
Uncalled bet ($0.67) returned to rana3792
rana3792 collected $0.67 from pot
rana3792: doesn't show hand=20
*** SUMMARY ***
Total pot $0.69 | Rake $0.02=20
Board [Qc 9d 4h 7h Ts]
Seat 1: H1JackH1gh folded before Flop (didn't bet)
Seat 3: StarsEyeDee folded before Flop (didn't bet)
Seat 4: Lanesra_90 folded before Flop (didn't bet)
Seat 5: diment76 folded before Flop (didn't bet)
Seat 6: Souljacker87 folded before Flop (didn't bet)
Seat 7: the_wickstar (button) folded on the River
Seat 8: TiZheRad (small blind) folded before Flop
Seat 9: rana3792 (big blind) collected ($0.67)


*********** # 183 **************
PokerStars Hand #170015386514:  Hold'em No Limit ($0.01/$0.02 USD) - 20=
17/05/06 12:34:57 CUST [2017/05/05 22:34:57 ET]
Table 'Mathilde III' 9-max Seat #4 is the button
Seat 1: Kabit510 ($2.10 in chips)=20
Seat 2: zecateto ($1.12 in chips)=20
Seat 3: howata ($2 in chips)=20
Seat 4: manugar91 ($2.66 in chips)=20
Seat 5: VishegasM ($2 in chips)=20
Seat 6: drinkedfish ($2.25 in chips)=20
Seat 7: Da Newf ($1.06 in chips)=20
Seat 8: the_wickstar ($2.90 in chips)=20
Seat 9: Luks_Jr ($1.95 in chips)=20
VishegasM: posts small blind $0.01
drinkedfish: posts big blind $0.02
*** HOLE CARDS ***
Dealt to the_wickstar [9h Kc]
Da Newf: folds=20
the_wickstar: folds=20
Luks_Jr: folds=20
Kabit510: folds=20
zecateto: folds=20
howata: folds=20
manugar91: folds=20
VishegasM: folds=20
Uncalled bet ($0.01) returned to drinkedfish
drinkedfish collected $0.02 from pot
drinkedfish: doesn't show hand=20
*** SUMMARY ***
Total pot $0.02 | Rake $0=20
Seat 1: Kabit510 folded before Flop (didn't bet)
Seat 2: zecateto folded before Flop (didn't bet)
Seat 3: howata folded before Flop (didn't bet)
Seat 4: manugar91 (button) folded before Flop (didn't bet)
Seat 5: VishegasM (small blind) folded before Flop
Seat 6: drinkedfish (big blind) collected ($0.02)
Seat 7: Da Newf folded before Flop (didn't bet)
Seat 8: the_wickstar folded before Flop (didn't bet)
Seat 9: Luks_Jr folded before Flop (didn't bet)


*********** # 184 **************
PokerStars Hand #170015374548:  Hold'em No Limit ($0.01/$0.02 USD) - 20=
17/05/06 12:34:25 CUST [2017/05/05 22:34:25 ET]
Table 'Mathilde III' 9-max Seat #3 is the button
Seat 1: Kabit510 ($2.07 in chips)=20
Seat 2: zecateto ($1.12 in chips)=20
Seat 3: howata ($2 in chips)=20
Seat 4: manugar91 ($2.67 in chips)=20
Seat 5: VishegasM ($2.01 in chips)=20
Seat 6: drinkedfish ($2.25 in chips)=20
Seat 7: Da Newf ($1.06 in chips)=20
Seat 8: the_wickstar ($2.90 in chips)=20
Seat 9: Luks_Jr ($1.95 in chips)=20
manugar91: posts small blind $0.01
VishegasM: posts big blind $0.02
*** HOLE CARDS ***
Dealt to the_wickstar [7h Kh]
drinkedfish: folds=20
Da Newf: folds=20
the_wickstar: folds=20
Luks_Jr: folds=20
Kabit510: raises $0.04 to $0.06
zecateto: folds=20
howata: folds=20
manugar91: folds=20
VishegasM: folds=20
Uncalled bet ($0.04) returned to Kabit510
Kabit510 collected $0.05 from pot
Kabit510: doesn't show hand=20
*** SUMMARY ***
Total pot $0.05 | Rake $0=20
Seat 1: Kabit510 collected ($0.05)
Seat 2: zecateto folded before Flop (didn't bet)
Seat 3: howata (button) folded before Flop (didn't bet)
Seat 4: manugar91 (small blind) folded before Flop
Seat 5: VishegasM (big blind) folded before Flop
Seat 6: drinkedfish folded before Flop (didn't bet)
Seat 7: Da Newf folded before Flop (didn't bet)
Seat 8: the_wickstar folded before Flop (didn't bet)
Seat 9: Luks_Jr folded before Flop (didn't bet)


*********** # 185 **************
PokerStars Hand #170015370579:  Hold'em No Limit ($0.01/$0.02 USD) - 20=
17/05/06 12:34:14 CUST [2017/05/05 22:34:14 ET]
Table 'Wodan' 9-max Seat #6 is the button
Seat 1: H1JackH1gh ($2.06 in chips)=20
Seat 2: VishegasM ($2.07 in chips)=20
Seat 3: StarsEyeDee ($1.88 in chips)=20
Seat 4: Lanesra_90 ($2.05 in chips)=20
Seat 5: diment76 ($1.82 in chips)=20
Seat 6: Souljacker87 ($6.39 in chips)=20
Seat 7: the_wickstar ($1.07 in chips)=20
Seat 8: TiZheRad ($0.81 in chips)=20
Seat 9: rana3792 ($1.31 in chips)=20
the_wickstar: posts small blind $0.01
TiZheRad: posts big blind $0.02
*** HOLE CARDS ***
Dealt to the_wickstar [Ac Ad]
rana3792: calls $0.02
H1JackH1gh: folds=20
VishegasM has timed out
VishegasM: folds=20
StarsEyeDee: folds=20
Lanesra_90: folds=20
diment76: folds=20
Souljacker87: folds=20
the_wickstar: raises $0.06 to $0.08
TiZheRad: folds=20
rana3792: folds=20
Uncalled bet ($0.06) returned to the_wickstar
the_wickstar collected $0.06 from pot
*** SUMMARY ***
Total pot $0.06 | Rake $0=20
Seat 1: H1JackH1gh folded before Flop (didn't bet)
Seat 2: VishegasM folded before Flop (didn't bet)
Seat 3: StarsEyeDee folded before Flop (didn't bet)
Seat 4: Lanesra_90 folded before Flop (didn't bet)
Seat 5: diment76 folded before Flop (didn't bet)
Seat 6: Souljacker87 (button) folded before Flop (didn't bet)
Seat 7: the_wickstar (small blind) collected ($0.06)
Seat 8: TiZheRad (big blind) folded before Flop
Seat 9: rana3792 folded before Flop


*********** # 186 **************
PokerStars Hand #170015357038:  Hold'em No Limit ($0.01/$0.02 USD) - 20=
17/05/06 12:33:38 CUST [2017/05/05 22:33:38 ET]
Table 'Wodan' 9-max Seat #5 is the button
Seat 1: H1JackH1gh ($2.06 in chips)=20
Seat 2: VishegasM ($2.07 in chips)=20
Seat 3: StarsEyeDee ($1.88 in chips)=20
Seat 4: Lanesra_90 ($2.05 in chips)=20
Seat 5: diment76 ($1.82 in chips)=20
Seat 6: Souljacker87 ($6.40 in chips)=20
Seat 7: the_wickstar ($1.13 in chips)=20
Seat 8: TiZheRad ($0.74 in chips)=20
Seat 9: rana3792 ($1.31 in chips)=20
Souljacker87: posts small blind $0.01
the_wickstar: posts big blind $0.02
*** HOLE CARDS ***
Dealt to the_wickstar [5h 5d]
TiZheRad: raises $0.04 to $0.06
rana3792: folds=20
H1JackH1gh: folds=20
VishegasM: folds=20
StarsEyeDee: folds=20
Lanesra_90: folds=20
diment76: folds=20
Souljacker87: folds=20
the_wickstar: calls $0.04
*** FLOP *** [8s 8h 4c]
the_wickstar: checks=20
TiZheRad: bets $0.10
the_wickstar: folds=20
Uncalled bet ($0.10) returned to TiZheRad
TiZheRad collected $0.13 from pot
TiZheRad: doesn't show hand=20
*** SUMMARY ***
Total pot $0.13 | Rake $0=20
Board [8s 8h 4c]
Seat 1: H1JackH1gh folded before Flop (didn't bet)
Seat 2: VishegasM folded before Flop (didn't bet)
Seat 3: StarsEyeDee folded before Flop (didn't bet)
Seat 4: Lanesra_90 folded before Flop (didn't bet)
Seat 5: diment76 (button) folded before Flop (didn't bet)
Seat 6: Souljacker87 (small blind) folded before Flop
Seat 7: the_wickstar (big blind) folded on the Flop
Seat 8: TiZheRad collected ($0.13)
Seat 9: rana3792 folded before Flop (didn't bet)


*********** # 187 **************
PokerStars Hand #170015353189:  Hold'em No Limit ($0.01/$0.02 USD) - 20=
17/05/06 12:33:29 CUST [2017/05/05 22:33:29 ET]
Table 'Mathilde III' 9-max Seat #2 is the button
Seat 1: Kabit510 ($2.07 in chips)=20
Seat 2: zecateto ($1.05 in chips)=20
Seat 3: howata ($2.01 in chips)=20
Seat 4: manugar91 ($2.73 in chips)=20
Seat 5: VishegasM ($2.01 in chips)=20
Seat 6: drinkedfish ($2.25 in chips)=20
Seat 7: Da Newf ($1.06 in chips)=20
Seat 8: the_wickstar ($2.90 in chips)=20
Seat 9: Luks_Jr ($1.95 in chips)=20
howata: posts small blind $0.01
manugar91: posts big blind $0.02
*** HOLE CARDS ***
Dealt to the_wickstar [8h 9c]
VishegasM: folds=20
drinkedfish: folds=20
Da Newf: folds=20
the_wickstar: folds=20
Luks_Jr: folds=20
Kabit510: folds=20
zecateto: raises $0.04 to $0.06
howata: folds=20
manugar91: calls $0.04
*** FLOP *** [6s 5c 7c]
manugar91: checks=20
zecateto: bets $0.13
manugar91: folds=20
Uncalled bet ($0.13) returned to zecateto
zecateto collected $0.13 from pot
zecateto: doesn't show hand=20
*** SUMMARY ***
Total pot $0.13 | Rake $0=20
Board [6s 5c 7c]
Seat 1: Kabit510 folded before Flop (didn't bet)
Seat 2: zecateto (button) collected ($0.13)
Seat 3: howata (small blind) folded before Flop
Seat 4: manugar91 (big blind) folded on the Flop
Seat 5: VishegasM folded before Flop (didn't bet)
Seat 6: drinkedfish folded before Flop (didn't bet)
Seat 7: Da Newf folded before Flop (didn't bet)
Seat 8: the_wickstar folded before Flop (didn't bet)
Seat 9: Luks_Jr folded before Flop (didn't bet)


*********** # 188 **************
PokerStars Hand #170015346480:  Hold'em No Limit ($0.01/$0.02 USD) - 20=
17/05/06 12:33:11 CUST [2017/05/05 22:33:11 ET]
Table 'Wodan' 9-max Seat #4 is the button
Seat 1: H1JackH1gh ($2.06 in chips)=20
Seat 2: VishegasM ($2 in chips)=20
Seat 3: StarsEyeDee ($1.88 in chips)=20
Seat 4: Lanesra_90 ($2.05 in chips)=20
Seat 5: diment76 ($1.83 in chips)=20
Seat 6: Souljacker87 ($6.47 in chips)=20
Seat 7: the_wickstar ($1.13 in chips)=20
Seat 8: TiZheRad ($0.74 in chips)=20
Seat 9: rana3792 ($1.31 in chips)=20
diment76: posts small blind $0.01
Souljacker87: posts big blind $0.02
*** HOLE CARDS ***
Dealt to the_wickstar [Qc 4h]
the_wickstar: folds=20
TiZheRad: folds=20
rana3792: folds=20
H1JackH1gh: folds=20
VishegasM: raises $0.05 to $0.07
StarsEyeDee: folds=20
Lanesra_90: folds=20
diment76: folds=20
Souljacker87: calls $0.05
*** FLOP *** [2c Ad 8c]
Souljacker87: checks=20
VishegasM: bets $0.09
Souljacker87: folds=20
Uncalled bet ($0.09) returned to VishegasM
VishegasM collected $0.14 from pot
VishegasM: doesn't show hand=20
*** SUMMARY ***
Total pot $0.15 | Rake $0.01=20
Board [2c Ad 8c]
Seat 1: H1JackH1gh folded before Flop (didn't bet)
Seat 2: VishegasM collected ($0.14)
Seat 3: StarsEyeDee folded before Flop (didn't bet)
Seat 4: Lanesra_90 (button) folded before Flop (didn't bet)
Seat 5: diment76 (small blind) folded before Flop
Seat 6: Souljacker87 (big blind) folded on the Flop
Seat 7: the_wickstar folded before Flop (didn't bet)
Seat 8: TiZheRad folded before Flop (didn't bet)
Seat 9: rana3792 folded before Flop (didn't bet)


*********** # 189 **************
PokerStars Hand #170015340686:  Hold'em No Limit ($0.01/$0.02 USD) - 20=
17/05/06 12:32:55 CUST [2017/05/05 22:32:55 ET]
Table 'Mathilde III' 9-max Seat #1 is the button
Seat 1: Kabit510 ($2.07 in chips)=20
Seat 2: zecateto ($1.06 in chips)=20
Seat 3: howata ($2 in chips)=20
Seat 4: manugar91 ($2.73 in chips)=20
Seat 5: VishegasM ($2.01 in chips)=20
Seat 6: drinkedfish ($2.25 in chips)=20
Seat 7: Da Newf ($1.06 in chips)=20
Seat 8: the_wickstar ($2.90 in chips)=20
Seat 9: Luks_Jr ($1.95 in chips)=20
zecateto: posts small blind $0.01
howata: posts big blind $0.02
*** HOLE CARDS ***
Dealt to the_wickstar [Qc 8s]
manugar91: folds=20
VishegasM: folds=20
drinkedfish: folds=20
Da Newf: folds=20
the_wickstar: folds=20
Luks_Jr: folds=20
Kabit510: folds=20
zecateto: folds=20
Uncalled bet ($0.01) returned to howata
howata collected $0.02 from pot
howata: doesn't show hand=20
*** SUMMARY ***
Total pot $0.02 | Rake $0=20
Seat 1: Kabit510 (button) folded before Flop (didn't bet)
Seat 2: zecateto (small blind) folded before Flop
Seat 3: howata (big blind) collected ($0.02)
Seat 4: manugar91 folded before Flop (didn't bet)
Seat 5: VishegasM folded before Flop (didn't bet)
Seat 6: drinkedfish folded before Flop (didn't bet)
Seat 7: Da Newf folded before Flop (didn't bet)
Seat 8: the_wickstar folded before Flop (didn't bet)
Seat 9: Luks_Jr folded before Flop (didn't bet)


*********** # 190 **************
PokerStars Hand #170015331421:  Hold'em No Limit ($0.01/$0.02 USD) - 20=
17/05/06 12:32:31 CUST [2017/05/05 22:32:31 ET]
Table 'Wodan' 9-max Seat #3 is the button
Seat 1: H1JackH1gh ($2.03 in chips)=20
Seat 2: VishegasM ($2 in chips)=20
Seat 3: StarsEyeDee ($1.88 in chips)=20
Seat 4: Lanesra_90 ($2.06 in chips)=20
Seat 5: diment76 ($1.85 in chips)=20
Seat 6: Souljacker87 ($6.47 in chips)=20
Seat 7: the_wickstar ($1.13 in chips)=20
Seat 8: TiZheRad ($0.74 in chips)=20
Seat 9: rana3792 ($1.31 in chips)=20
Lanesra_90: posts small blind $0.01
diment76: posts big blind $0.02
*** HOLE CARDS ***
Dealt to the_wickstar [2d As]
Souljacker87: folds=20
the_wickstar: folds=20
TiZheRad: folds=20
rana3792: folds=20
H1JackH1gh: raises $0.04 to $0.06
VishegasM: folds=20
StarsEyeDee: folds=20
Lanesra_90: folds=20
diment76: folds=20
Uncalled bet ($0.04) returned to H1JackH1gh
H1JackH1gh collected $0.05 from pot
H1JackH1gh: doesn't show hand=20
*** SUMMARY ***
Total pot $0.05 | Rake $0=20
Seat 1: H1JackH1gh collected ($0.05)
Seat 2: VishegasM folded before Flop (didn't bet)
Seat 3: StarsEyeDee (button) folded before Flop (didn't bet)
Seat 4: Lanesra_90 (small blind) folded before Flop
Seat 5: diment76 (big blind) folded before Flop
Seat 6: Souljacker87 folded before Flop (didn't bet)
Seat 7: the_wickstar folded before Flop (didn't bet)
Seat 8: TiZheRad folded before Flop (didn't bet)
Seat 9: rana3792 folded before Flop (didn't bet)


*********** # 191 **************
PokerStars Hand #170015330911:  Hold'em No Limit ($0.01/$0.02 USD) - 20=
17/05/06 12:32:29 CUST [2017/05/05 22:32:29 ET]
Table 'Mathilde III' 9-max Seat #9 is the button
Seat 1: Kabit510 ($2.08 in chips)=20
Seat 2: zecateto ($1.05 in chips)=20
Seat 3: howata ($2 in chips)=20
Seat 4: manugar91 ($2.73 in chips)=20
Seat 5: VishegasM ($2.01 in chips)=20
Seat 6: drinkedfish ($2.25 in chips)=20
Seat 7: Da Newf ($1.06 in chips)=20
Seat 8: the_wickstar ($2.90 in chips)=20
Seat 9: Luks_Jr ($1.95 in chips)=20
Kabit510: posts small blind $0.01
zecateto: posts big blind $0.02
*** HOLE CARDS ***
Dealt to the_wickstar [2s Kh]
howata: folds=20
manugar91: folds=20
VishegasM: folds=20
drinkedfish: folds=20
Da Newf: folds=20
the_wickstar: folds=20
Luks_Jr: folds=20
Kabit510: folds=20
Uncalled bet ($0.01) returned to zecateto
zecateto collected $0.02 from pot
zecateto: doesn't show hand=20
*** SUMMARY ***
Total pot $0.02 | Rake $0=20
Seat 1: Kabit510 (small blind) folded before Flop
Seat 2: zecateto (big blind) collected ($0.02)
Seat 3: howata folded before Flop (didn't bet)
Seat 4: manugar91 folded before Flop (didn't bet)
Seat 5: VishegasM folded before Flop (didn't bet)
Seat 6: drinkedfish folded before Flop (didn't bet)
Seat 7: Da Newf folded before Flop (didn't bet)
Seat 8: the_wickstar folded before Flop (didn't bet)
Seat 9: Luks_Jr (button) folded before Flop (didn't bet)


*********** # 192 **************
PokerStars Hand #170015321587:  Hold'em No Limit ($0.01/$0.02 USD) - 20=
17/05/06 12:32:05 CUST [2017/05/05 22:32:05 ET]
Table 'Wodan' 9-max Seat #2 is the button
Seat 1: H1JackH1gh ($2.03 in chips)=20
Seat 2: VishegasM ($2 in chips)=20
Seat 3: StarsEyeDee ($1.89 in chips)=20
Seat 4: Lanesra_90 ($2.08 in chips)=20
Seat 5: diment76 ($1.85 in chips)=20
Seat 6: Souljacker87 ($6.47 in chips)=20
Seat 7: the_wickstar ($1.13 in chips)=20
Seat 8: TiZheRad ($0.71 in chips)=20
Seat 9: rana3792 ($1.31 in chips)=20
StarsEyeDee: posts small blind $0.01
Lanesra_90: posts big blind $0.02
*** HOLE CARDS ***
Dealt to the_wickstar [3s Qh]
diment76: folds=20
Souljacker87: folds=20
the_wickstar: folds=20
TiZheRad: raises $0.04 to $0.06
rana3792: folds=20
H1JackH1gh: folds=20
VishegasM: folds=20
StarsEyeDee: folds=20
Lanesra_90: folds=20
Uncalled bet ($0.04) returned to TiZheRad
TiZheRad collected $0.05 from pot
TiZheRad: doesn't show hand=20
*** SUMMARY ***
Total pot $0.05 | Rake $0=20
Seat 1: H1JackH1gh folded before Flop (didn't bet)
Seat 2: VishegasM (button) folded before Flop (didn't bet)
Seat 3: StarsEyeDee (small blind) folded before Flop
Seat 4: Lanesra_90 (big blind) folded before Flop
Seat 5: diment76 folded before Flop (didn't bet)
Seat 6: Souljacker87 folded before Flop (didn't bet)
Seat 7: the_wickstar folded before Flop (didn't bet)
Seat 8: TiZheRad collected ($0.05)
Seat 9: rana3792 folded before Flop (didn't bet)


*********** # 193 **************
PokerStars Hand #170015311408:  Hold'em No Limit ($0.01/$0.02 USD) - 20=
17/05/06 12:31:38 CUST [2017/05/05 22:31:38 ET]
Table 'Mathilde III' 9-max Seat #8 is the button
Seat 1: Kabit510 ($2.10 in chips)=20
Seat 2: zecateto ($1.05 in chips)=20
Seat 3: howata ($2 in chips)=20
Seat 4: manugar91 ($2.73 in chips)=20
Seat 5: VishegasM ($2.01 in chips)=20
Seat 6: drinkedfish ($2.25 in chips)=20
Seat 7: Da Newf ($1.06 in chips)=20
Seat 8: the_wickstar ($2.87 in chips)=20
Seat 9: Luks_Jr ($1.96 in chips)=20
Luks_Jr: posts small blind $0.01
Kabit510: posts big blind $0.02
*** HOLE CARDS ***
Dealt to the_wickstar [Jd 5d]
zecateto: folds=20
howata: folds=20
manugar91: folds=20
VishegasM: folds=20
drinkedfish: folds=20
Da Newf: folds=20
the_wickstar: calls $0.02
Luks_Jr: folds=20
Kabit510: checks=20
*** FLOP *** [2h Th Ac]
Kabit510: checks=20
the_wickstar: bets $0.03
Kabit510: folds=20
Uncalled bet ($0.03) returned to the_wickstar
the_wickstar collected $0.05 from pot
*** SUMMARY ***
Total pot $0.05 | Rake $0=20
Board [2h Th Ac]
Seat 1: Kabit510 (big blind) folded on the Flop
Seat 2: zecateto folded before Flop (didn't bet)
Seat 3: howata folded before Flop (didn't bet)
Seat 4: manugar91 folded before Flop (didn't bet)
Seat 5: VishegasM folded before Flop (didn't bet)
Seat 6: drinkedfish folded before Flop (didn't bet)
Seat 7: Da Newf folded before Flop (didn't bet)
Seat 8: the_wickstar (button) collected ($0.05)
Seat 9: Luks_Jr (small blind) folded before Flop


*********** # 194 **************
PokerStars Hand #170015306636:  Hold'em No Limit ($0.01/$0.02 USD) - 20=
17/05/06 12:31:25 CUST [2017/05/05 22:31:25 ET]
Table 'Wodan' 9-max Seat #1 is the button
Seat 1: H1JackH1gh ($2 in chips)=20
Seat 2: VishegasM ($2.01 in chips)=20
Seat 3: StarsEyeDee ($1.91 in chips)=20
Seat 4: Lanesra_90 ($2.08 in chips)=20
Seat 5: diment76 ($1.85 in chips)=20
Seat 6: Souljacker87 ($6.47 in chips)=20
Seat 7: the_wickstar ($1.13 in chips)=20
Seat 8: TiZheRad ($0.71 in chips)=20
Seat 9: rana3792 ($1.31 in chips)=20
VishegasM: posts small blind $0.01
StarsEyeDee: posts big blind $0.02
*** HOLE CARDS ***
Dealt to the_wickstar [2h Qc]
Lanesra_90: folds=20
diment76: folds=20
Souljacker87: folds=20
the_wickstar: folds=20
TiZheRad: folds=20
rana3792: folds=20
H1JackH1gh: raises $0.04 to $0.06
VishegasM: folds=20
StarsEyeDee: folds=20
Uncalled bet ($0.04) returned to H1JackH1gh
H1JackH1gh collected $0.05 from pot
H1JackH1gh: doesn't show hand=20
*** SUMMARY ***
Total pot $0.05 | Rake $0=20
Seat 1: H1JackH1gh (button) collected ($0.05)
Seat 2: VishegasM (small blind) folded before Flop
Seat 3: StarsEyeDee (big blind) folded before Flop
Seat 4: Lanesra_90 folded before Flop (didn't bet)
Seat 5: diment76 folded before Flop (didn't bet)
Seat 6: Souljacker87 folded before Flop (didn't bet)
Seat 7: the_wickstar folded before Flop (didn't bet)
Seat 8: TiZheRad folded before Flop (didn't bet)
Seat 9: rana3792 folded before Flop (didn't bet)


*********** # 195 **************
PokerStars Hand #170015301846:  Hold'em No Limit ($0.01/$0.02 USD) - 20=
17/05/06 12:31:13 CUST [2017/05/05 22:31:13 ET]
Table 'Mathilde III' 9-max Seat #7 is the button
Seat 1: Kabit510 ($2.10 in chips)=20
Seat 2: zecateto ($1.05 in chips)=20
Seat 3: howata ($2 in chips)=20
Seat 4: manugar91 ($2.73 in chips)=20
Seat 5: VishegasM ($2.01 in chips)=20
Seat 6: drinkedfish ($2.25 in chips)=20
Seat 7: Da Newf ($1.06 in chips)=20
Seat 8: the_wickstar ($2.88 in chips)=20
Seat 9: Luks_Jr ($1.95 in chips)=20
the_wickstar: posts small blind $0.01
Luks_Jr: posts big blind $0.02
*** HOLE CARDS ***
Dealt to the_wickstar [Ks 9d]
Kabit510: folds=20
zecateto: folds=20
howata: folds=20
manugar91: folds=20
VishegasM: folds=20
drinkedfish: folds=20
Da Newf: folds=20
the_wickstar: folds=20
Uncalled bet ($0.01) returned to Luks_Jr
Luks_Jr collected $0.02 from pot
Luks_Jr: doesn't show hand=20
*** SUMMARY ***
Total pot $0.02 | Rake $0=20
Seat 1: Kabit510 folded before Flop (didn't bet)
Seat 2: zecateto folded before Flop (didn't bet)
Seat 3: howata folded before Flop (didn't bet)
Seat 4: manugar91 folded before Flop (didn't bet)
Seat 5: VishegasM folded before Flop (didn't bet)
Seat 6: drinkedfish folded before Flop (didn't bet)
Seat 7: Da Newf (button) folded before Flop (didn't bet)
Seat 8: the_wickstar (small blind) folded before Flop
Seat 9: Luks_Jr (big blind) collected ($0.02)


*********** # 196 **************
PokerStars Hand #170015296660:  Hold'em No Limit ($0.01/$0.02 USD) - 20=
17/05/06 12:30:59 CUST [2017/05/05 22:30:59 ET]
Table 'Wodan' 9-max Seat #9 is the button
Seat 1: H1JackH1gh ($2 in chips)=20
Seat 2: VishegasM ($2 in chips)=20
Seat 3: StarsEyeDee ($1.91 in chips)=20
Seat 4: Lanesra_90 ($2.08 in chips)=20
Seat 5: diment76 ($1.85 in chips)=20
Seat 6: Souljacker87 ($6.47 in chips)=20
Seat 7: the_wickstar ($1.13 in chips)=20
Seat 8: TiZheRad ($0.71 in chips)=20
Seat 9: rana3792 ($1.31 in chips)=20
H1JackH1gh: posts small blind $0.01
VishegasM: posts big blind $0.02
*** HOLE CARDS ***
Dealt to the_wickstar [Ks 6d]
StarsEyeDee: folds=20
Lanesra_90: folds=20
diment76: folds=20
Souljacker87: folds=20
the_wickstar: folds=20
TiZheRad: folds=20
rana3792: folds=20
H1JackH1gh: folds=20
Uncalled bet ($0.01) returned to VishegasM
VishegasM collected $0.02 from pot
VishegasM: doesn't show hand=20
*** SUMMARY ***
Total pot $0.02 | Rake $0=20
Seat 1: H1JackH1gh (small blind) folded before Flop
Seat 2: VishegasM (big blind) collected ($0.02)
Seat 3: StarsEyeDee folded before Flop (didn't bet)
Seat 4: Lanesra_90 folded before Flop (didn't bet)
Seat 5: diment76 folded before Flop (didn't bet)
Seat 6: Souljacker87 folded before Flop (didn't bet)
Seat 7: the_wickstar folded before Flop (didn't bet)
Seat 8: TiZheRad folded before Flop (didn't bet)
Seat 9: rana3792 (button) folded before Flop (didn't bet)


*********** # 197 **************
PokerStars Hand #170015271851:  Hold'em No Limit ($0.01/$0.02 USD) - 20=
17/05/06 12:29:53 CUST [2017/05/05 22:29:53 ET]
Table 'Mathilde III' 9-max Seat #6 is the button
Seat 1: Kabit510 ($2.10 in chips)=20
Seat 2: zecateto ($1.07 in chips)=20
Seat 3: howata ($2 in chips)=20
Seat 4: manugar91 ($2.75 in chips)=20
Seat 5: VishegasM ($2.01 in chips)=20
Seat 6: drinkedfish ($2.25 in chips)=20
Seat 7: Da Newf ($1.08 in chips)=20
Seat 8: the_wickstar ($2.82 in chips)=20
Seat 9: Luks_Jr ($1.95 in chips)=20
Da Newf: posts small blind $0.01
the_wickstar: posts big blind $0.02
*** HOLE CARDS ***
Dealt to the_wickstar [Th 5c]
Luks_Jr: folds=20
Kabit510: folds=20
zecateto: calls $0.02
howata: folds=20
manugar91: calls $0.02
VishegasM: folds=20
drinkedfish: folds=20
Da Newf: calls $0.01
the_wickstar: checks=20
*** FLOP *** [9c 9d 8d]
Da Newf: checks=20
the_wickstar: checks=20
zecateto: checks=20
manugar91: checks=20
*** TURN *** [9c 9d 8d] [4s]
Da Newf: checks=20
the_wickstar: bets $0.06
zecateto: folds=20
manugar91: folds=20
Da Newf: folds=20
Uncalled bet ($0.06) returned to the_wickstar
the_wickstar collected $0.08 from pot
*** SUMMARY ***
Total pot $0.08 | Rake $0=20
Board [9c 9d 8d 4s]
Seat 1: Kabit510 folded before Flop (didn't bet)
Seat 2: zecateto folded on the Turn
Seat 3: howata folded before Flop (didn't bet)
Seat 4: manugar91 folded on the Turn
Seat 5: VishegasM folded before Flop (didn't bet)
Seat 6: drinkedfish (button) folded before Flop (didn't bet)
Seat 7: Da Newf (small blind) folded on the Turn
Seat 8: the_wickstar (big blind) collected ($0.08)
Seat 9: Luks_Jr folded before Flop (didn't bet)


*********** # 198 **************
PokerStars Hand #170015271205:  Hold'em No Limit ($0.01/$0.02 USD) - 20=
17/05/06 12:29:52 CUST [2017/05/05 22:29:52 ET]
Table 'Wodan' 9-max Seat #8 is the button
Seat 1: H1JackH1gh ($2 in chips)=20
Seat 2: JOSSEPH K ($2 in chips)=20
Seat 3: StarsEyeDee ($1.93 in chips)=20
Seat 4: Lanesra_90 ($2.08 in chips)=20
Seat 5: diment76 ($1.85 in chips)=20
Seat 6: Souljacker87 ($6.40 in chips)=20
Seat 7: the_wickstar ($1.13 in chips)=20
Seat 8: TiZheRad ($0.73 in chips)=20
Seat 9: rana3792 ($1.32 in chips)=20
rana3792: posts small blind $0.01
H1JackH1gh: posts big blind $0.02
*** HOLE CARDS ***
Dealt to the_wickstar [5d Qc]
JOSSEPH K: folds=20
JOSSEPH K leaves the table
StarsEyeDee: calls $0.02
VishegasM joins the table at seat #2=20
Lanesra_90: folds=20
diment76: folds=20
Souljacker87: calls $0.02
the_wickstar: folds=20
TiZheRad: calls $0.02
rana3792: folds=20
H1JackH1gh: checks=20
*** FLOP *** [5h 3c 8h]
H1JackH1gh: checks=20
StarsEyeDee: checks=20
Souljacker87: bets $0.04
TiZheRad: folds=20
H1JackH1gh: folds=20
StarsEyeDee: folds=20
Uncalled bet ($0.04) returned to Souljacker87
Souljacker87 collected $0.09 from pot
Souljacker87: doesn't show hand=20
*** SUMMARY ***
Total pot $0.09 | Rake $0=20
Board [5h 3c 8h]
Seat 1: H1JackH1gh (big blind) folded on the Flop
Seat 2: JOSSEPH K folded before Flop (didn't bet)
Seat 3: StarsEyeDee folded on the Flop
Seat 4: Lanesra_90 folded before Flop (didn't bet)
Seat 5: diment76 folded before Flop (didn't bet)
Seat 6: Souljacker87 collected ($0.09)
Seat 7: the_wickstar folded before Flop (didn't bet)
Seat 8: TiZheRad (button) folded on the Flop
Seat 9: rana3792 (small blind) folded before Flop


*********** # 199 **************
PokerStars Hand #170015253076:  Hold'em No Limit ($0.01/$0.02 USD) - 20=
17/05/06 12:29:05 CUST [2017/05/05 22:29:05 ET]
Table 'Mathilde III' 9-max Seat #5 is the button
Seat 1: Kabit510 ($2.10 in chips)=20
Seat 2: zecateto ($1.07 in chips)=20
Seat 3: howata ($2 in chips)=20
Seat 4: manugar91 ($2.75 in chips)=20
Seat 5: VishegasM ($2.01 in chips)=20
Seat 6: drinkedfish ($2.26 in chips)=20
Seat 7: Da Newf ($1.10 in chips)=20
Seat 8: the_wickstar ($2.79 in chips)=20
Seat 9: Luks_Jr ($1.95 in chips)=20
drinkedfish: posts small blind $0.01
Da Newf: posts big blind $0.02
*** HOLE CARDS ***
Dealt to the_wickstar [Ac Kc]
the_wickstar: raises $0.02 to $0.04
Luks_Jr: folds=20
Kabit510: folds=20
zecateto: folds=20
howata: folds=20
manugar91: folds=20
VishegasM: folds=20
drinkedfish: folds=20
Da Newf: folds=20
Uncalled bet ($0.02) returned to the_wickstar
the_wickstar collected $0.05 from pot
*** SUMMARY ***
Total pot $0.05 | Rake $0=20
Seat 1: Kabit510 folded before Flop (didn't bet)
Seat 2: zecateto folded before Flop (didn't bet)
Seat 3: howata folded before Flop (didn't bet)
Seat 4: manugar91 folded before Flop (didn't bet)
Seat 5: VishegasM (button) folded before Flop (didn't bet)
Seat 6: drinkedfish (small blind) folded before Flop
Seat 7: Da Newf (big blind) folded before Flop
Seat 8: the_wickstar collected ($0.05)
Seat 9: Luks_Jr folded before Flop (didn't bet)


*********** # 200 **************
PokerStars Hand #170015248927:  Hold'em No Limit ($0.01/$0.02 USD) - 20=
17/05/06 12:28:54 CUST [2017/05/05 22:28:54 ET]
Table 'Wodan' 9-max Seat #7 is the button
Seat 2: JOSSEPH K ($2 in chips)=20
Seat 3: StarsEyeDee ($2.02 in chips)=20
Seat 4: Lanesra_90 ($2.08 in chips)=20
Seat 5: diment76 ($1.85 in chips)=20
Seat 6: Souljacker87 ($6.09 in chips)=20
Seat 7: the_wickstar ($1.13 in chips)=20
Seat 8: TiZheRad ($0.74 in chips)=20
Seat 9: rana3792 ($1.55 in chips)=20
TiZheRad: posts small blind $0.01
rana3792: posts big blind $0.02
H1JackH1gh: sits out=20
*** HOLE CARDS ***
Dealt to the_wickstar [Qc 2d]
JOSSEPH K: folds=20
StarsEyeDee: calls $0.02
Lanesra_90: folds=20
diment76: folds=20
Souljacker87: raises $0.07 to $0.09
the_wickstar: folds=20
TiZheRad: folds=20
rana3792: calls $0.07
StarsEyeDee: calls $0.07
*** FLOP *** [4h As 6s]
rana3792: bets $0.14
StarsEyeDee: folds=20
Souljacker87: raises $0.28 to $0.42
rana3792: folds=20
Uncalled bet ($0.28) returned to Souljacker87
Souljacker87 collected $0.54 from pot
Souljacker87: doesn't show hand=20
*** SUMMARY ***
Total pot $0.56 | Rake $0.02=20
Board [4h As 6s]
Seat 2: JOSSEPH K folded before Flop (didn't bet)
Seat 3: StarsEyeDee folded on the Flop
Seat 4: Lanesra_90 folded before Flop (didn't bet)
Seat 5: diment76 folded before Flop (didn't bet)
Seat 6: Souljacker87 collected ($0.54)
Seat 7: the_wickstar (button) folded before Flop (didn't bet)
Seat 8: TiZheRad (small blind) folded before Flop
Seat 9: rana3792 (big blind) folded on the Flop



If you have any questions, please contact us at "PokerStars Support" <s=
upport@pokerstars.com>


