Delivered-To: sherhan.wicky@gmail.com
Received: by 10.79.162.140 with SMTP id k12csp104628ivh;
        Tue, 25 Apr 2017 18:21:28 -0700 (PDT)
X-Received: by 10.80.184.51 with SMTP id j48mr7315685ede.165.1493169688082;
        Tue, 25 Apr 2017 18:21:28 -0700 (PDT)
Return-Path: <support@pokerstars.com>
Received: from mx13.pokerstars.eu (mx13.pokerstars.eu. [77.87.179.125])
        by mx.google.com with ESMTPS id n57si1824015edd.38.2017.04.25.18.21.27
        for <sherhan.wicky@gmail.com>
        (version=TLS1_2 cipher=ECDHE-RSA-AES128-GCM-SHA256 bits=128/128);
        Tue, 25 Apr 2017 18:21:28 -0700 (PDT)
Received-SPF: pass (google.com: domain of support@pokerstars.com designates 77.87.179.125 as permitted sender) client-ip=77.87.179.125;
Authentication-Results: mx.google.com;
       dkim=pass (test mode) header.i=@pokerstars.com;
       spf=pass (google.com: domain of support@pokerstars.com designates 77.87.179.125 as permitted sender) smtp.mailfrom=support@pokerstars.com
Received: by mx13.pokerstars.eu (mailer, from userid 503)
	id 2A3641FE763C; Tue, 25 Apr 2017 21:21:27 -0400 (EDT)
DKIM-Signature: v=1; a=rsa-sha1; c=relaxed; d=pokerstars.com; h=date
	:from:to:subject:message-id:mime-version:content-type
	:content-transfer-encoding; s=s1024; bh=fzzU8mwQBVyymx+Cafsd2Ck/
	tzM=; b=DJw1AkmNXQH9AkyYnF+BjxH5Qt13RLWY5CuYP5+qcUrsSH67Lo0G0IS6
	6dMIAbxuLPiLb2U1FCUt+M3dBt7Po8y+4L+eKc8SWDlvMlwLhiXfo/HjoqF6CvHZ
	lck6dqpJtoDvYC8VVB1MIIekWo/qyfoOdAO8FcVnYtZ5VtLnC3s=
X-PS-ID: c2hlcmhhbi53aWNreUBnbWFpbC5jb20=
Received: from pokerstars.com (IOM-20-81 [192.168.8.81])
	by mx13.pokerstars.eu (mailer) with SMTP id 11ABE1FE7629
	for <sherhan.wicky@gmail.com>; Tue, 25 Apr 2017 21:21:27 -0400 (EDT)
Date: Tue, 25 Apr 2017 21:21:26 -0400
From: "PokerStars Support" <support@pokerstars.com>
To: sherhan.wicky@gmail.com
Subject: PokerStars Hand History Request - last 1 day of play
Message-Id: <58FFF616.84A66487DE870A@pokerstars.com>
MIME-Version: 1.0
Content-Type: text/plain;
 charset="windows-1252"
Content-Transfer-Encoding: quoted-printable


Transcript for last 1 day of play requested by the_wickstar (sherhan.wi=
cky@gmail.com)

*********** # 1 **************
PokerStars Hand #169565499660:  Hold'em No Limit ($0.01/$0.02 USD) - 20=
17/04/26 11:20:11 CUST [2017/04/25 21:20:11 ET]
Table 'Baumeia II' 9-max Seat #2 is the button
Seat 2: picky_1993 ($2.24 in chips)=20
Seat 4: L3m0nN@tion ($1.85 in chips)=20
Seat 5: the_wickstar ($1.26 in chips)=20
Seat 6: wernergaming ($3 in chips)=20
Seat 7: nemkefull ($3.09 in chips)=20
Seat 9: Dusch799 ($2.53 in chips)=20
PepitaDeAji will be allowed to play after the button
L3m0nN@tion: posts small blind $0.01
the_wickstar: posts big blind $0.02
yjqian23: sits out=20
*** HOLE CARDS ***
Dealt to the_wickstar [4s Tc]
wernergaming: calls $0.02
nemkefull: folds=20
Dusch799: raises $0.10 to $0.12
picky_1993: folds=20
L3m0nN@tion: folds=20
the_wickstar: folds=20
wernergaming: folds=20
Uncalled bet ($0.10) returned to Dusch799
Dusch799 collected $0.07 from pot
*** SUMMARY ***
Total pot $0.07 | Rake $0=20
Seat 2: picky_1993 (button) folded before Flop (didn't bet)
Seat 4: L3m0nN@tion (small blind) folded before Flop
Seat 5: the_wickstar (big blind) folded before Flop
Seat 6: wernergaming folded before Flop
Seat 7: nemkefull folded before Flop (didn't bet)
Seat 9: Dusch799 collected ($0.07)


*********** # 2 **************
PokerStars Hand #169565491879:  Hold'em No Limit ($0.01/$0.02 USD) - 20=
17/04/26 11:19:53 CUST [2017/04/25 21:19:53 ET]
Table 'Ehrdni' 9-max Seat #5 is the button
Seat 1: Veraz147 ($2 in chips)=20
Seat 2: the_wickstar ($1.87 in chips)=20
Seat 3: saunter ($0.75 in chips)=20
Seat 4: 11CarlBluesy ($1.48 in chips)=20
Seat 5: Dusch799 ($1.89 in chips)=20
Seat 7: Mekanisis ($2 in chips)=20
Seat 8: voltes5588 ($1.83 in chips)=20
Seat 9: nemkefull ($2.57 in chips)=20
Crage79 will be allowed to play after the button
Mekanisis: posts small blind $0.01
voltes5588: posts big blind $0.02
*** HOLE CARDS ***
Dealt to the_wickstar [3h 5s]
nemkefull: folds=20
Veraz147: folds=20
the_wickstar: folds=20
saunter: calls $0.02
11CarlBluesy: folds=20
Dusch799: folds=20
Mekanisis: folds=20
voltes5588: checks=20
*** FLOP *** [7h 9s 4d]
voltes5588: checks=20
saunter: checks=20
*** TURN *** [7h 9s 4d] [2d]
voltes5588: checks=20
saunter: checks=20
*** RIVER *** [7h 9s 4d 2d] [4c]
voltes5588: bets $0.02
saunter: calls $0.02
*** SHOW DOWN ***
voltes5588: shows [5c 7c] (two pair, Sevens and Fours)
saunter: mucks hand=20
voltes5588 collected $0.09 from pot
*** SUMMARY ***
Total pot $0.09 | Rake $0=20
Board [7h 9s 4d 2d 4c]
Seat 1: Veraz147 folded before Flop (didn't bet)
Seat 2: the_wickstar folded before Flop (didn't bet)
Seat 3: saunter mucked [6c 6d]
Seat 4: 11CarlBluesy folded before Flop (didn't bet)
Seat 5: Dusch799 (button) folded before Flop (didn't bet)
Seat 7: Mekanisis (small blind) folded before Flop
Seat 8: voltes5588 (big blind) showed [5c 7c] and won ($0.09) with two =
pair, Sevens and Fours
Seat 9: nemkefull folded before Flop (didn't bet)


*********** # 3 **************
PokerStars Hand #169565459045:  Hold'em No Limit ($0.01/$0.02 USD) - 20=
17/04/26 11:18:49 CUST [2017/04/25 21:18:49 ET]
Table 'Baumeia II' 9-max Seat #9 is the button
Seat 2: picky_1993 ($2.25 in chips)=20
Seat 4: L3m0nN@tion ($1.56 in chips)=20
Seat 5: the_wickstar ($1.28 in chips)=20
Seat 6: wernergaming ($3.28 in chips)=20
Seat 7: nemkefull ($3.09 in chips)=20
Seat 8: Demonidze31 ($2.03 in chips)=20
Seat 9: Dusch799 ($2.53 in chips)=20
yjqian23 will be allowed to play after the button
picky_1993: posts small blind $0.01
L3m0nN@tion: posts big blind $0.02
*** HOLE CARDS ***
Dealt to the_wickstar [Jh Ac]
the_wickstar: calls $0.02
wernergaming: calls $0.02
nemkefull: folds=20
switalsky leaves the table
PepitaDeAji joins the table at seat #3=20
Demonidze31 is disconnected=20
Demonidze31 has timed out while disconnected
Demonidze31: folds=20
Dusch799: folds=20
picky_1993: folds=20
L3m0nN@tion: raises $0.26 to $0.28
the_wickstar: folds=20
wernergaming: calls $0.26
*** FLOP *** [9h 5h Jd]
L3m0nN@tion: checks=20
wernergaming: checks=20
*** TURN *** [9h 5h Jd] [6d]
L3m0nN@tion: checks=20
wernergaming: checks=20
*** RIVER *** [9h 5h Jd 6d] [5s]
L3m0nN@tion: bets $1.28 and is all-in
Demonidze31 is disconnected=20
wernergaming: folds=20
Uncalled bet ($1.28) returned to L3m0nN@tion
L3m0nN@tion collected $0.57 from pot
L3m0nN@tion: doesn't show hand=20
*** SUMMARY ***
Total pot $0.59 | Rake $0.02=20
Board [9h 5h Jd 6d 5s]
Seat 2: picky_1993 (small blind) folded before Flop
Seat 4: L3m0nN@tion (big blind) collected ($0.57)
Seat 5: the_wickstar folded before Flop
Seat 6: wernergaming folded on the River
Seat 7: nemkefull folded before Flop (didn't bet)
Seat 8: Demonidze31 folded before Flop (didn't bet)
Seat 9: Dusch799 (button) folded before Flop (didn't bet)


*********** # 4 **************
PokerStars Hand #169565458125:  Hold'em No Limit ($0.01/$0.02 USD) - 20=
17/04/26 11:18:47 CUST [2017/04/25 21:18:47 ET]
Table 'Ehrdni' 9-max Seat #4 is the button
Seat 1: Veraz147 ($2 in chips)=20
Seat 2: the_wickstar ($1.87 in chips)=20
Seat 3: saunter ($0.78 in chips)=20
Seat 4: 11CarlBluesy ($1.48 in chips)=20
Seat 5: Dusch799 ($1.90 in chips)=20
Seat 7: Mekanisis ($2 in chips)=20
Seat 8: voltes5588 ($1.83 in chips)=20
Seat 9: nemkefull ($2.51 in chips)=20
Dusch799: posts small blind $0.01
Mekanisis: posts big blind $0.02
pastarmaa leaves the table
Crage79 joins the table at seat #6=20
saunter: posts small & big blinds $0.03
*** HOLE CARDS ***
Dealt to the_wickstar [Ad 3d]
voltes5588: folds=20
nemkefull: raises $0.06 to $0.08
Veraz147: folds=20
the_wickstar: folds=20
saunter: folds=20
11CarlBluesy: folds=20
Dusch799: folds=20
Mekanisis: folds=20
Uncalled bet ($0.06) returned to nemkefull
nemkefull collected $0.08 from pot
nemkefull: doesn't show hand=20
*** SUMMARY ***
Total pot $0.08 | Rake $0=20
Seat 1: Veraz147 folded before Flop (didn't bet)
Seat 2: the_wickstar folded before Flop (didn't bet)
Seat 3: saunter folded before Flop
Seat 4: 11CarlBluesy (button) folded before Flop (didn't bet)
Seat 5: Dusch799 (small blind) folded before Flop
Seat 7: Mekanisis (big blind) folded before Flop
Seat 8: voltes5588 folded before Flop (didn't bet)
Seat 9: nemkefull collected ($0.08)


*********** # 5 **************
PokerStars Hand #169565430935:  Hold'em No Limit ($0.01/$0.02 USD) - 20=
17/04/26 11:17:45 CUST [2017/04/25 21:17:45 ET]
Table 'Baumeia II' 9-max Seat #8 is the button
Seat 2: picky_1993 ($2.27 in chips)=20
Seat 3: switalsky ($2.12 in chips)=20
Seat 4: L3m0nN@tion ($1.56 in chips)=20
Seat 5: the_wickstar ($1.28 in chips)=20
Seat 6: wernergaming ($3.28 in chips)=20
Seat 7: nemkefull ($3.09 in chips)=20
Seat 8: Demonidze31 ($2 in chips)=20
Seat 9: Dusch799 ($2.54 in chips)=20
Dusch799: posts small blind $0.01
picky_1993: posts big blind $0.02
*** HOLE CARDS ***
Dealt to the_wickstar [Kc 8s]
Buxixo101 leaves the table
yjqian23 joins the table at seat #1=20
switalsky has timed out
switalsky: folds=20
L3m0nN@tion: folds=20
the_wickstar: folds=20
wernergaming: folds=20
nemkefull: folds=20
Demonidze31: raises $0.02 to $0.04
Dusch799: folds=20
picky_1993: folds=20
Uncalled bet ($0.02) returned to Demonidze31
Demonidze31 collected $0.05 from pot
Demonidze31: doesn't show hand=20
*** SUMMARY ***
Total pot $0.05 | Rake $0=20
Seat 2: picky_1993 (big blind) folded before Flop
Seat 3: switalsky folded before Flop (didn't bet)
Seat 4: L3m0nN@tion folded before Flop (didn't bet)
Seat 5: the_wickstar folded before Flop (didn't bet)
Seat 6: wernergaming folded before Flop (didn't bet)
Seat 7: nemkefull folded before Flop (didn't bet)
Seat 8: Demonidze31 (button) collected ($0.05)
Seat 9: Dusch799 (small blind) folded before Flop


*********** # 6 **************
PokerStars Hand #169565420473:  Hold'em No Limit ($0.01/$0.02 USD) - 20=
17/04/26 11:17:21 CUST [2017/04/25 21:17:21 ET]
Table 'Ehrdni' 9-max Seat #2 is the button
Seat 1: Veraz147 ($2 in chips)=20
Seat 2: the_wickstar ($0.98 in chips)=20
Seat 4: 11CarlBluesy ($1.49 in chips)=20
Seat 5: Dusch799 ($1.92 in chips)=20
Seat 6: pastarmaa ($0.91 in chips)=20
Seat 7: Mekanisis ($2 in chips)=20
Seat 8: voltes5588 ($1.83 in chips)=20
Seat 9: nemkefull ($2.53 in chips)=20
saunter will be allowed to play after the button
11CarlBluesy: posts small blind $0.01
Dusch799: posts big blind $0.02
*** HOLE CARDS ***
Dealt to the_wickstar [Qc Qs]
pastarmaa: calls $0.02
Mekanisis: folds=20
voltes5588: folds=20
nemkefull: calls $0.02
Veraz147: folds=20
the_wickstar: raises $0.04 to $0.06
11CarlBluesy: folds=20
Dusch799: folds=20
pastarmaa: calls $0.04
nemkefull: folds=20
*** FLOP *** [7d 6s 4s]
pastarmaa: bets $0.04
the_wickstar: raises $0.12 to $0.16
pastarmaa: calls $0.12
*** TURN *** [7d 6s 4s] [6c]
pastarmaa: bets $0.24
the_wickstar: calls $0.24
*** RIVER *** [7d 6s 4s 6c] [Qd]
pastarmaa: bets $0.45 and is all-in
the_wickstar: calls $0.45
*** SHOW DOWN ***
pastarmaa: shows [5s 7h] (two pair, Sevens and Sixes)
the_wickstar: shows [Qc Qs] (a full house, Queens full of Sixes)
the_wickstar collected $1.80 from pot
*** SUMMARY ***
Total pot $1.87 | Rake $0.07=20
Board [7d 6s 4s 6c Qd]
Seat 1: Veraz147 folded before Flop (didn't bet)
Seat 2: the_wickstar (button) showed [Qc Qs] and won ($1.80) with a ful=
l house, Queens full of Sixes
Seat 4: 11CarlBluesy (small blind) folded before Flop
Seat 5: Dusch799 (big blind) folded before Flop
Seat 6: pastarmaa showed [5s 7h] and lost with two pair, Sevens and Six=
es
Seat 7: Mekanisis folded before Flop (didn't bet)
Seat 8: voltes5588 folded before Flop (didn't bet)
Seat 9: nemkefull folded before Flop


*********** # 7 **************
PokerStars Hand #169565394436:  Hold'em No Limit ($0.01/$0.02 USD) - 20=
17/04/26 11:16:24 CUST [2017/04/25 21:16:24 ET]
Table 'Baumeia II' 9-max Seat #7 is the button
Seat 1: Buxixo101 ($0.46 in chips)=20
Seat 2: picky_1993 ($2.27 in chips)=20
Seat 3: switalsky ($2.12 in chips)=20
Seat 4: L3m0nN@tion ($2.10 in chips)=20
Seat 5: the_wickstar ($1.28 in chips)=20
Seat 6: wernergaming ($2.27 in chips)=20
Seat 7: nemkefull ($3.09 in chips)=20
Seat 8: Demonidze31 ($2 in chips)=20
Seat 9: Dusch799 ($2.60 in chips)=20
Demonidze31: posts small blind $0.01
Dusch799: posts big blind $0.02
*** HOLE CARDS ***
Dealt to the_wickstar [6h Th]
Buxixo101: calls $0.02
picky_1993: folds=20
switalsky: folds=20
L3m0nN@tion: raises $0.04 to $0.06
the_wickstar: folds=20
wernergaming: calls $0.06
nemkefull: folds=20
Demonidze31: folds=20
Dusch799: calls $0.04
Buxixo101: raises $0.40 to $0.46 and is all-in
L3m0nN@tion: calls $0.40
wernergaming: calls $0.40
Dusch799: folds=20
*** FLOP *** [5s Ah 4d]
L3m0nN@tion: checks=20
wernergaming: checks=20
*** TURN *** [5s Ah 4d] [7s]
L3m0nN@tion: checks=20
wernergaming: bets $0.08
L3m0nN@tion: calls $0.08
*** RIVER *** [5s Ah 4d 7s] [3d]
L3m0nN@tion: checks=20
wernergaming: checks=20
*** SHOW DOWN ***
L3m0nN@tion: shows [Qd Qc] (a pair of Queens)
wernergaming: shows [4h 5c] (two pair, Fives and Fours)
wernergaming collected $0.15 from side pot
Buxixo101: mucks hand=20
wernergaming collected $1.40 from main pot
*** SUMMARY ***
Total pot $1.61 Main pot $1.40. Side pot $0.15. | Rake $0.06=20
Board [5s Ah 4d 7s 3d]
Seat 1: Buxixo101 mucked [Js Ad]
Seat 2: picky_1993 folded before Flop (didn't bet)
Seat 3: switalsky folded before Flop (didn't bet)
Seat 4: L3m0nN@tion showed [Qd Qc] and lost with a pair of Queens
Seat 5: the_wickstar folded before Flop (didn't bet)
Seat 6: wernergaming showed [4h 5c] and won ($1.55) with two pair, Five=
s and Fours
Seat 7: nemkefull (button) folded before Flop (didn't bet)
Seat 8: Demonidze31 (small blind) folded before Flop
Seat 9: Dusch799 (big blind) folded before Flop


*********** # 8 **************
PokerStars Hand #169565372997:  Hold'em No Limit ($0.01/$0.02 USD) - 20=
17/04/26 11:15:35 CUST [2017/04/25 21:15:35 ET]
Table 'Baumeia II' 9-max Seat #6 is the button
Seat 1: Buxixo101 ($0.46 in chips)=20
Seat 2: picky_1993 ($2.24 in chips)=20
Seat 3: switalsky ($2.12 in chips)=20
Seat 4: L3m0nN@tion ($2.10 in chips)=20
Seat 5: the_wickstar ($1.28 in chips)=20
Seat 6: wernergaming ($2.27 in chips)=20
Seat 7: nemkefull ($3.10 in chips)=20
Seat 8: Demonidze31 ($2 in chips)=20
Seat 9: Dusch799 ($2.60 in chips)=20
nemkefull: posts small blind $0.01
Demonidze31: posts big blind $0.02
*** HOLE CARDS ***
Dealt to the_wickstar [3s 7c]
Dusch799: folds=20
Buxixo101: folds=20
picky_1993: raises $0.04 to $0.06
switalsky: folds=20
L3m0nN@tion: folds=20
the_wickstar: folds=20
wernergaming: folds=20
nemkefull: folds=20
Demonidze31: folds=20
Uncalled bet ($0.04) returned to picky_1993
picky_1993 collected $0.05 from pot
picky_1993: doesn't show hand=20
*** SUMMARY ***
Total pot $0.05 | Rake $0=20
Seat 1: Buxixo101 folded before Flop (didn't bet)
Seat 2: picky_1993 collected ($0.05)
Seat 3: switalsky folded before Flop (didn't bet)
Seat 4: L3m0nN@tion folded before Flop (didn't bet)
Seat 5: the_wickstar folded before Flop (didn't bet)
Seat 6: wernergaming (button) folded before Flop (didn't bet)
Seat 7: nemkefull (small blind) folded before Flop
Seat 8: Demonidze31 (big blind) folded before Flop
Seat 9: Dusch799 folded before Flop (didn't bet)


*********** # 9 **************
PokerStars Hand #169565365087:  Hold'em No Limit ($0.01/$0.02 USD) - 20=
17/04/26 11:15:17 CUST [2017/04/25 21:15:17 ET]
Table 'Ehrdni' 9-max Seat #1 is the button
Seat 1: Veraz147 ($2 in chips)=20
Seat 2: the_wickstar ($0.99 in chips)=20
Seat 4: 11CarlBluesy ($1.51 in chips)=20
Seat 5: Dusch799 ($1.92 in chips)=20
Seat 6: pastarmaa ($0.71 in chips)=20
Seat 7: Mekanisis ($2 in chips)=20
Seat 8: voltes5588 ($1.87 in chips)=20
Seat 9: nemkefull ($2.53 in chips)=20
the_wickstar: posts small blind $0.01
saunter has timed out while being disconnected
saunter: is sitting out=20
11CarlBluesy: posts big blind $0.02
*** HOLE CARDS ***
Dealt to the_wickstar [6s 3c]
saunter is disconnected=20
Dusch799 has timed out
Dusch799: folds=20
pastarmaa: raises $0.02 to $0.04
Mekanisis: calls $0.04
voltes5588: calls $0.04
nemkefull: folds=20
Veraz147: folds=20
the_wickstar: folds=20
11CarlBluesy: folds=20
*** FLOP *** [6h 4h 6d]
pastarmaa: bets $0.04
Mekanisis: calls $0.04
voltes5588: folds=20
*** TURN *** [6h 4h 6d] [8c]
pastarmaa: bets $0.06
Mekanisis: calls $0.06
*** RIVER *** [6h 4h 6d 8c] [Qd]
pastarmaa: bets $0.17
Mekanisis: folds=20
Uncalled bet ($0.17) returned to pastarmaa
pastarmaa collected $0.34 from pot
pastarmaa: doesn't show hand=20
*** SUMMARY ***
Total pot $0.35 | Rake $0.01=20
Board [6h 4h 6d 8c Qd]
Seat 1: Veraz147 (button) folded before Flop (didn't bet)
Seat 2: the_wickstar (small blind) folded before Flop
Seat 4: 11CarlBluesy (big blind) folded before Flop
Seat 5: Dusch799 folded before Flop (didn't bet)
Seat 6: pastarmaa collected ($0.34)
Seat 7: Mekanisis folded on the River
Seat 8: voltes5588 folded on the Flop
Seat 9: nemkefull folded before Flop (didn't bet)


*********** # 10 **************
PokerStars Hand #169565346174:  Hold'em No Limit ($0.01/$0.02 USD) - 20=
17/04/26 11:14:33 CUST [2017/04/25 21:14:33 ET]
Table 'Baumeia II' 9-max Seat #5 is the button
Seat 1: Buxixo101 ($0.46 in chips)=20
Seat 2: picky_1993 ($2.24 in chips)=20
Seat 3: switalsky ($2.12 in chips)=20
Seat 4: L3m0nN@tion ($1.95 in chips)=20
Seat 5: the_wickstar ($1.28 in chips)=20
Seat 6: wernergaming ($2.41 in chips)=20
Seat 7: nemkefull ($3.12 in chips)=20
Seat 8: Demonidze31 ($2 in chips)=20
Seat 9: Dusch799 ($2.60 in chips)=20
wernergaming: posts small blind $0.01
nemkefull: posts big blind $0.02
*** HOLE CARDS ***
Dealt to the_wickstar [7c Qd]
Demonidze31: folds=20
Dusch799: folds=20
Buxixo101: folds=20
picky_1993: folds=20
switalsky: folds=20
L3m0nN@tion: raises $0.04 to $0.06
the_wickstar: folds=20
wernergaming: calls $0.05
nemkefull: folds=20
*** FLOP *** [7h 2h 9h]
wernergaming: checks=20
L3m0nN@tion: bets $0.08
wernergaming: calls $0.08
*** TURN *** [7h 2h 9h] [7s]
wernergaming: checks=20
L3m0nN@tion: checks=20
*** RIVER *** [7h 2h 9h 7s] [Jd]
wernergaming: checks=20
L3m0nN@tion: checks=20
*** SHOW DOWN ***
wernergaming: shows [2d 8d] (two pair, Sevens and Deuces)
L3m0nN@tion: shows [Th Tc] (two pair, Tens and Sevens)
L3m0nN@tion collected $0.29 from pot
*** SUMMARY ***
Total pot $0.30 | Rake $0.01=20
Board [7h 2h 9h 7s Jd]
Seat 1: Buxixo101 folded before Flop (didn't bet)
Seat 2: picky_1993 folded before Flop (didn't bet)
Seat 3: switalsky folded before Flop (didn't bet)
Seat 4: L3m0nN@tion showed [Th Tc] and won ($0.29) with two pair, Tens =
and Sevens
Seat 5: the_wickstar (button) folded before Flop (didn't bet)
Seat 6: wernergaming (small blind) showed [2d 8d] and lost with two pai=
r, Sevens and Deuces
Seat 7: nemkefull (big blind) folded before Flop
Seat 8: Demonidze31 folded before Flop (didn't bet)
Seat 9: Dusch799 folded before Flop (didn't bet)


*********** # 11 **************
PokerStars Hand #169565342457:  Hold'em No Limit ($0.01/$0.02 USD) - 20=
17/04/26 11:14:25 CUST [2017/04/25 21:14:25 ET]
Table 'Ehrdni' 9-max Seat #9 is the button
Seat 1: Veraz147 ($2 in chips)=20
Seat 2: the_wickstar ($1.01 in chips)=20
Seat 3: saunter ($0.78 in chips)=20
Seat 4: 11CarlBluesy ($1.51 in chips)=20
Seat 5: Dusch799 ($1.92 in chips)=20
Seat 6: pastarmaa ($0.68 in chips)=20
Seat 7: Mekanisis ($2 in chips)=20
Seat 8: voltes5588 ($1.87 in chips)=20
Seat 9: nemkefull ($2.53 in chips)=20
Veraz147: posts small blind $0.01
the_wickstar: posts big blind $0.02
*** HOLE CARDS ***
Dealt to the_wickstar [Jh Ts]
saunter has timed out
saunter: folds=20
11CarlBluesy: folds=20
Dusch799: folds=20
pastarmaa: raises $0.02 to $0.04
Mekanisis: folds=20
voltes5588: folds=20
nemkefull: folds=20
Veraz147: folds=20
the_wickstar: folds=20
Uncalled bet ($0.02) returned to pastarmaa
pastarmaa collected $0.05 from pot
pastarmaa: doesn't show hand=20
*** SUMMARY ***
Total pot $0.05 | Rake $0=20
Seat 1: Veraz147 (small blind) folded before Flop
Seat 2: the_wickstar (big blind) folded before Flop
Seat 3: saunter folded before Flop (didn't bet)
Seat 4: 11CarlBluesy folded before Flop (didn't bet)
Seat 5: Dusch799 folded before Flop (didn't bet)
Seat 6: pastarmaa collected ($0.05)
Seat 7: Mekanisis folded before Flop (didn't bet)
Seat 8: voltes5588 folded before Flop (didn't bet)
Seat 9: nemkefull (button) folded before Flop (didn't bet)


*********** # 12 **************
PokerStars Hand #169565324634:  Hold'em No Limit ($0.01/$0.02 USD) - 20=
17/04/26 11:13:44 CUST [2017/04/25 21:13:44 ET]
Table 'Ehrdni' 9-max Seat #8 is the button
Seat 1: Veraz147 ($2 in chips)=20
Seat 2: the_wickstar ($0.96 in chips)=20
Seat 3: saunter ($0.78 in chips)=20
Seat 4: 11CarlBluesy ($1.51 in chips)=20
Seat 5: Dusch799 ($1.92 in chips)=20
Seat 6: pastarmaa ($0.70 in chips)=20
Seat 7: Mekanisis ($2 in chips)=20
Seat 8: voltes5588 ($1.87 in chips)=20
Seat 9: nemkefull ($2.54 in chips)=20
nemkefull: posts small blind $0.01
Veraz147: posts big blind $0.02
*** HOLE CARDS ***
Dealt to the_wickstar [Jh Ks]
the_wickstar: calls $0.02
saunter: folds=20
11CarlBluesy: folds=20
Dusch799: folds=20
pastarmaa: calls $0.02
Mekanisis: folds=20
voltes5588: folds=20
nemkefull: folds=20
Veraz147: checks=20
*** FLOP *** [5c 3c Js]
Veraz147: checks=20
the_wickstar: bets $0.05
pastarmaa: folds=20
Veraz147: folds=20
Uncalled bet ($0.05) returned to the_wickstar
the_wickstar collected $0.07 from pot
*** SUMMARY ***
Total pot $0.07 | Rake $0=20
Board [5c 3c Js]
Seat 1: Veraz147 (big blind) folded on the Flop
Seat 2: the_wickstar collected ($0.07)
Seat 3: saunter folded before Flop (didn't bet)
Seat 4: 11CarlBluesy folded before Flop (didn't bet)
Seat 5: Dusch799 folded before Flop (didn't bet)
Seat 6: pastarmaa folded on the Flop
Seat 7: Mekanisis folded before Flop (didn't bet)
Seat 8: voltes5588 (button) folded before Flop (didn't bet)
Seat 9: nemkefull (small blind) folded before Flop


*********** # 13 **************
PokerStars Hand #169565319029:  Hold'em No Limit ($0.01/$0.02 USD) - 20=
17/04/26 11:13:31 CUST [2017/04/25 21:13:31 ET]
Table 'Baumeia II' 9-max Seat #4 is the button
Seat 1: Buxixo101 ($1.68 in chips)=20
Seat 2: picky_1993 ($2.24 in chips)=20
Seat 3: switalsky ($2.12 in chips)=20
Seat 4: L3m0nN@tion ($1.95 in chips)=20
Seat 5: the_wickstar ($1.29 in chips)=20
Seat 6: wernergaming ($1.22 in chips)=20
Seat 7: nemkefull ($3.17 in chips)=20
Seat 8: Demonidze31 ($2 in chips)=20
Seat 9: Dusch799 ($2.60 in chips)=20
the_wickstar: posts small blind $0.01
wernergaming: posts big blind $0.02
*** HOLE CARDS ***
Dealt to the_wickstar [Js 5c]
nemkefull: raises $0.03 to $0.05
Demonidze31: folds=20
Dusch799: folds=20
Buxixo101: calls $0.05
picky_1993: folds=20
switalsky: folds=20
L3m0nN@tion: folds=20
the_wickstar: folds=20
wernergaming: calls $0.03
*** FLOP *** [7s Ks 6c]
wernergaming: checks=20
nemkefull: checks=20
Buxixo101: bets $0.15
wernergaming: calls $0.15
nemkefull: folds=20
*** TURN *** [7s Ks 6c] [7d]
wernergaming: checks=20
Buxixo101: bets $0.44
wernergaming: raises $0.58 to $1.02 and is all-in
Buxixo101: calls $0.58
*** RIVER *** [7s Ks 6c 7d] [As]
*** SHOW DOWN ***
wernergaming: shows [9h 7h] (three of a kind, Sevens)
Buxixo101: shows [Qc Kd] (two pair, Kings and Sevens)
wernergaming collected $2.41 from pot
*** SUMMARY ***
Total pot $2.50 | Rake $0.09=20
Board [7s Ks 6c 7d As]
Seat 1: Buxixo101 showed [Qc Kd] and lost with two pair, Kings and Seve=
ns
Seat 2: picky_1993 folded before Flop (didn't bet)
Seat 3: switalsky folded before Flop (didn't bet)
Seat 4: L3m0nN@tion (button) folded before Flop (didn't bet)
Seat 5: the_wickstar (small blind) folded before Flop
Seat 6: wernergaming (big blind) showed [9h 7h] and won ($2.41) with th=
ree of a kind, Sevens
Seat 7: nemkefull folded on the Flop
Seat 8: Demonidze31 folded before Flop (didn't bet)
Seat 9: Dusch799 folded before Flop (didn't bet)


*********** # 14 **************
PokerStars Hand #169565292575:  Hold'em No Limit ($0.01/$0.02 USD) - 20=
17/04/26 11:12:31 CUST [2017/04/25 21:12:31 ET]
Table 'Ehrdni' 9-max Seat #7 is the button
Seat 2: the_wickstar ($0.78 in chips)=20
Seat 3: saunter ($0.78 in chips)=20
Seat 4: 11CarlBluesy ($1.51 in chips)=20
Seat 5: Dusch799 ($1.98 in chips)=20
Seat 6: pastarmaa ($0.80 in chips)=20
Seat 7: Mekanisis ($2 in chips)=20
Seat 8: voltes5588 ($1.88 in chips)=20
Seat 9: nemkefull ($2.56 in chips)=20
voltes5588: posts small blind $0.01
nemkefull: posts big blind $0.02
Veraz147: sits out=20
pastarmaa: posts big blind $0.02
*** HOLE CARDS ***
Dealt to the_wickstar [Ah Th]
the_wickstar: calls $0.02
saunter: folds=20
11CarlBluesy: folds=20
Dusch799: raises $0.04 to $0.06
pastarmaa: calls $0.04
Mekanisis: folds=20
voltes5588: folds=20
nemkefull: folds=20
the_wickstar: calls $0.04
*** FLOP *** [Jd Jh 8d]
the_wickstar: checks=20
Dusch799: checks=20
pastarmaa: bets $0.04
the_wickstar: calls $0.04
Dusch799: folds=20
*** TURN *** [Jd Jh 8d] [3h]
the_wickstar: checks=20
pastarmaa: checks=20
*** RIVER *** [Jd Jh 8d 3h] [4s]
the_wickstar: bets $0.20
pastarmaa: folds=20
Uncalled bet ($0.20) returned to the_wickstar
the_wickstar collected $0.28 from pot
*** SUMMARY ***
Total pot $0.29 | Rake $0.01=20
Board [Jd Jh 8d 3h 4s]
Seat 2: the_wickstar collected ($0.28)
Seat 3: saunter folded before Flop (didn't bet)
Seat 4: 11CarlBluesy folded before Flop (didn't bet)
Seat 5: Dusch799 folded on the Flop
Seat 6: pastarmaa folded on the River
Seat 7: Mekanisis (button) folded before Flop (didn't bet)
Seat 8: voltes5588 (small blind) folded before Flop
Seat 9: nemkefull (big blind) folded before Flop


*********** # 15 **************
PokerStars Hand #169565284484:  Hold'em No Limit ($0.01/$0.02 USD) - 20=
17/04/26 11:12:13 CUST [2017/04/25 21:12:13 ET]
Table 'Baumeia II' 9-max Seat #3 is the button
Seat 1: Buxixo101 ($1.68 in chips)=20
Seat 2: picky_1993 ($2.24 in chips)=20
Seat 3: switalsky ($2.12 in chips)=20
Seat 4: L3m0nN@tion ($2.01 in chips)=20
Seat 5: the_wickstar ($1.31 in chips)=20
Seat 6: wernergaming ($1.58 in chips)=20
Seat 7: nemkefull ($2.76 in chips)=20
Seat 8: Demonidze31 ($2 in chips)=20
Seat 9: Dusch799 ($2.60 in chips)=20
L3m0nN@tion: posts small blind $0.01
the_wickstar: posts big blind $0.02
*** HOLE CARDS ***
Dealt to the_wickstar [5d Jd]
wernergaming: raises $0.04 to $0.06
nemkefull: calls $0.06
Demonidze31: folds=20
Dusch799: folds=20
Buxixo101: folds=20
picky_1993: folds=20
switalsky: folds=20
L3m0nN@tion: calls $0.05
the_wickstar: folds=20
*** FLOP *** [3d Ac Js]
L3m0nN@tion: checks=20
wernergaming: bets $0.10
nemkefull: calls $0.10
L3m0nN@tion: folds=20
*** TURN *** [3d Ac Js] [8d]
wernergaming: checks=20
nemkefull: bets $0.20
wernergaming: calls $0.20
*** RIVER *** [3d Ac Js 8d] [7h]
wernergaming: checks=20
nemkefull: bets $0.40
wernergaming: folds=20
Uncalled bet ($0.40) returned to nemkefull
nemkefull collected $0.77 from pot
nemkefull: doesn't show hand=20
*** SUMMARY ***
Total pot $0.80 | Rake $0.03=20
Board [3d Ac Js 8d 7h]
Seat 1: Buxixo101 folded before Flop (didn't bet)
Seat 2: picky_1993 folded before Flop (didn't bet)
Seat 3: switalsky (button) folded before Flop (didn't bet)
Seat 4: L3m0nN@tion (small blind) folded on the Flop
Seat 5: the_wickstar (big blind) folded before Flop
Seat 6: wernergaming folded on the River
Seat 7: nemkefull collected ($0.77)
Seat 8: Demonidze31 folded before Flop (didn't bet)
Seat 9: Dusch799 folded before Flop (didn't bet)


*********** # 16 **************
PokerStars Hand #169565269455:  Hold'em No Limit ($0.01/$0.02 USD) - 20=
17/04/26 11:11:39 CUST [2017/04/25 21:11:39 ET]
Table 'Ehrdni' 9-max Seat #5 is the button
Seat 2: the_wickstar ($0.78 in chips)=20
Seat 3: saunter ($0.80 in chips)=20
Seat 4: 11CarlBluesy ($1.51 in chips)=20
Seat 5: Dusch799 ($1.98 in chips)=20
Seat 7: Mekanisis ($2 in chips)=20
Seat 8: voltes5588 ($1.85 in chips)=20
Seat 9: nemkefull ($2.56 in chips)=20
pastarmaa will be allowed to play after the button
Mekanisis: posts small blind $0.01
voltes5588: posts big blind $0.02
Veraz147: sits out=20
saunter: posts big blind $0.02
*** HOLE CARDS ***
Dealt to the_wickstar [2d Jd]
nemkefull: folds=20
the_wickstar: folds=20
saunter: checks=20
11CarlBluesy: folds=20
Dusch799: folds=20
Mekanisis: folds=20
voltes5588: checks=20
*** FLOP *** [2s Jc 8h]
voltes5588: checks=20
saunter: checks=20
*** TURN *** [2s Jc 8h] [6c]
voltes5588: checks=20
saunter: checks=20
*** RIVER *** [2s Jc 8h 6c] [Ad]
voltes5588: checks=20
saunter: checks=20
*** SHOW DOWN ***
voltes5588: shows [7c Kd] (high card Ace)
saunter: mucks hand=20
voltes5588 collected $0.05 from pot
*** SUMMARY ***
Total pot $0.05 | Rake $0=20
Board [2s Jc 8h 6c Ad]
Seat 2: the_wickstar folded before Flop (didn't bet)
Seat 3: saunter mucked [Kc 3h]
Seat 4: 11CarlBluesy folded before Flop (didn't bet)
Seat 5: Dusch799 (button) folded before Flop (didn't bet)
Seat 7: Mekanisis (small blind) folded before Flop
Seat 8: voltes5588 (big blind) showed [7c Kd] and won ($0.05) with high=
 card Ace
Seat 9: nemkefull folded before Flop (didn't bet)


*********** # 17 **************
PokerStars Hand #169565258025:  Hold'em No Limit ($0.01/$0.02 USD) - 20=
17/04/26 11:11:13 CUST [2017/04/25 21:11:13 ET]
Table 'Baumeia II' 9-max Seat #2 is the button
Seat 1: Buxixo101 ($1.68 in chips)=20
Seat 2: picky_1993 ($2.12 in chips)=20
Seat 3: switalsky ($2.13 in chips)=20
Seat 4: L3m0nN@tion ($2.13 in chips)=20
Seat 5: the_wickstar ($1.31 in chips)=20
Seat 6: wernergaming ($1.58 in chips)=20
Seat 7: nemkefull ($2.76 in chips)=20
Seat 8: Demonidze31 ($2 in chips)=20
Seat 9: Dusch799 ($2.60 in chips)=20
switalsky: posts small blind $0.01
L3m0nN@tion: posts big blind $0.02
*** HOLE CARDS ***
Dealt to the_wickstar [7h 8s]
the_wickstar: folds=20
wernergaming: folds=20
nemkefull: folds=20
Demonidze31: folds=20
Dusch799: folds=20
Buxixo101: folds=20
picky_1993: raises $0.04 to $0.06
switalsky: folds=20
L3m0nN@tion: raises $0.04 to $0.10
picky_1993: calls $0.04
*** FLOP *** [8c Kd 7c]
L3m0nN@tion: bets $0.02
picky_1993: raises $0.11 to $0.13
L3m0nN@tion: folds=20
Uncalled bet ($0.11) returned to picky_1993
picky_1993 collected $0.24 from pot
picky_1993: doesn't show hand=20
*** SUMMARY ***
Total pot $0.25 | Rake $0.01=20
Board [8c Kd 7c]
Seat 1: Buxixo101 folded before Flop (didn't bet)
Seat 2: picky_1993 (button) collected ($0.24)
Seat 3: switalsky (small blind) folded before Flop
Seat 4: L3m0nN@tion (big blind) folded on the Flop
Seat 5: the_wickstar folded before Flop (didn't bet)
Seat 6: wernergaming folded before Flop (didn't bet)
Seat 7: nemkefull folded before Flop (didn't bet)
Seat 8: Demonidze31 folded before Flop (didn't bet)
Seat 9: Dusch799 folded before Flop (didn't bet)


*********** # 18 **************
PokerStars Hand #169565242005:  Hold'em No Limit ($0.01/$0.02 USD) - 20=
17/04/26 11:10:36 CUST [2017/04/25 21:10:36 ET]
Table 'Ehrdni' 9-max Seat #4 is the button
Seat 2: the_wickstar ($1.11 in chips)=20
Seat 4: 11CarlBluesy ($1.17 in chips)=20
Seat 5: Dusch799 ($1.99 in chips)=20
Seat 7: Mekanisis ($2 in chips)=20
Seat 8: voltes5588 ($1.85 in chips)=20
Seat 9: nemkefull ($2.56 in chips)=20
Dusch799: posts small blind $0.01
Mekanisis: posts big blind $0.02
Veraz147: sits out=20
*** HOLE CARDS ***
Dealt to the_wickstar [Kd Jc]
voltes5588: folds=20
nemkefull: folds=20
the_wickstar: raises $0.04 to $0.06
11CarlBluesy: calls $0.06
Dusch799: folds=20
Mekanisis: folds=20
*** FLOP *** [5s Jh 7s]
the_wickstar: checks=20
pastarmaa joins the table at seat #6=20
11CarlBluesy: checks=20
*** TURN *** [5s Jh 7s] [4d]
saunter joins the table at seat #3=20
the_wickstar: bets $0.10
11CarlBluesy: calls $0.10
*** RIVER *** [5s Jh 7s 4d] [8s]
the_wickstar: checks=20
11CarlBluesy: bets $0.17
the_wickstar: calls $0.17
*** SHOW DOWN ***
11CarlBluesy: shows [8h 8c] (three of a kind, Eights)
the_wickstar: mucks hand=20
11CarlBluesy collected $0.67 from pot
*** SUMMARY ***
Total pot $0.69 | Rake $0.02=20
Board [5s Jh 7s 4d 8s]
Seat 2: the_wickstar mucked [Kd Jc]
Seat 4: 11CarlBluesy (button) showed [8h 8c] and won ($0.67) with three=
 of a kind, Eights
Seat 5: Dusch799 (small blind) folded before Flop
Seat 7: Mekanisis (big blind) folded before Flop
Seat 8: voltes5588 folded before Flop (didn't bet)
Seat 9: nemkefull folded before Flop (didn't bet)


*********** # 19 **************
PokerStars Hand #169565228339:  Hold'em No Limit ($0.01/$0.02 USD) - 20=
17/04/26 11:10:06 CUST [2017/04/25 21:10:06 ET]
Table 'Ehrdni' 9-max Seat #3 is the button
Seat 2: the_wickstar ($1.13 in chips)=20
Seat 3: wrb1011 ($1.50 in chips)=20
Seat 4: 11CarlBluesy ($1.18 in chips)=20
Seat 5: Dusch799 ($1.96 in chips)=20
Seat 6: yjqian23 ($1.93 in chips)=20
Seat 7: Mekanisis ($2 in chips)=20
Seat 8: voltes5588 ($1.85 in chips)=20
Seat 9: nemkefull ($2.56 in chips)=20
11CarlBluesy: posts small blind $0.01
Dusch799: posts big blind $0.02
Veraz147: sits out=20
*** HOLE CARDS ***
Dealt to the_wickstar [4d 4s]
yjqian23: folds=20
yjqian23 leaves the table
Mekanisis: folds=20
voltes5588: folds=20
nemkefull: folds=20
the_wickstar: calls $0.02
wrb1011: folds=20
wrb1011 leaves the table
11CarlBluesy: folds=20
Dusch799: raises $0.06 to $0.08
the_wickstar: folds=20
Uncalled bet ($0.06) returned to Dusch799
Dusch799 collected $0.05 from pot
*** SUMMARY ***
Total pot $0.05 | Rake $0=20
Seat 2: the_wickstar folded before Flop
Seat 3: wrb1011 (button) folded before Flop (didn't bet)
Seat 4: 11CarlBluesy (small blind) folded before Flop
Seat 5: Dusch799 (big blind) collected ($0.05)
Seat 6: yjqian23 folded before Flop (didn't bet)
Seat 7: Mekanisis folded before Flop (didn't bet)
Seat 8: voltes5588 folded before Flop (didn't bet)
Seat 9: nemkefull folded before Flop (didn't bet)


*********** # 20 **************
PokerStars Hand #169565223625:  Hold'em No Limit ($0.01/$0.02 USD) - 20=
17/04/26 11:09:55 CUST [2017/04/25 21:09:55 ET]
Table 'Baumeia II' 9-max Seat #1 is the button
Seat 1: Buxixo101 ($1.68 in chips)=20
Seat 2: picky_1993 ($2.20 in chips)=20
Seat 3: switalsky ($2 in chips)=20
Seat 4: L3m0nN@tion ($2.13 in chips)=20
Seat 5: the_wickstar ($1.33 in chips)=20
Seat 6: wernergaming ($1.60 in chips)=20
Seat 7: nemkefull ($2.76 in chips)=20
Seat 8: Demonidze31 ($2 in chips)=20
Seat 9: Dusch799 ($2.62 in chips)=20
picky_1993: posts small blind $0.01
switalsky: posts big blind $0.02
*** HOLE CARDS ***
Dealt to the_wickstar [2c 2h]
L3m0nN@tion: folds=20
the_wickstar: calls $0.02
wernergaming: calls $0.02
nemkefull: folds=20
Demonidze31: folds=20
Dusch799: calls $0.02
Buxixo101: folds=20
picky_1993: calls $0.01
switalsky: checks=20
*** FLOP *** [Tc Td 3c]
picky_1993: checks=20
switalsky: checks=20
the_wickstar: checks=20
wernergaming: checks=20
Dusch799: checks=20
*** TURN *** [Tc Td 3c] [Kd]
picky_1993: checks=20
switalsky: bets $0.06
the_wickstar: folds=20
wernergaming: folds=20
Dusch799: folds=20
picky_1993: calls $0.06
*** RIVER *** [Tc Td 3c Kd] [As]
picky_1993: checks=20
switalsky: bets $0.21
picky_1993: folds=20
Uncalled bet ($0.21) returned to switalsky
switalsky collected $0.21 from pot
switalsky: doesn't show hand=20
*** SUMMARY ***
Total pot $0.22 | Rake $0.01=20
Board [Tc Td 3c Kd As]
Seat 1: Buxixo101 (button) folded before Flop (didn't bet)
Seat 2: picky_1993 (small blind) folded on the River
Seat 3: switalsky (big blind) collected ($0.21)
Seat 4: L3m0nN@tion folded before Flop (didn't bet)
Seat 5: the_wickstar folded on the Turn
Seat 6: wernergaming folded on the Turn
Seat 7: nemkefull folded before Flop (didn't bet)
Seat 8: Demonidze31 folded before Flop (didn't bet)
Seat 9: Dusch799 folded on the Turn


*********** # 21 **************
PokerStars Hand #169565212128:  Hold'em No Limit ($0.01/$0.02 USD) - 20=
17/04/26 11:09:29 CUST [2017/04/25 21:09:29 ET]
Table 'Ehrdni' 9-max Seat #2 is the button
Seat 2: the_wickstar ($1.13 in chips)=20
Seat 3: wrb1011 ($1.51 in chips)=20
Seat 4: 11CarlBluesy ($1.20 in chips)=20
Seat 5: Dusch799 ($1.93 in chips)=20
Seat 6: yjqian23 ($1.93 in chips)=20
Seat 7: Mekanisis ($2 in chips)=20
Seat 8: voltes5588 ($1.85 in chips)=20
Seat 9: nemkefull ($2.56 in chips)=20
wrb1011: posts small blind $0.01
11CarlBluesy: posts big blind $0.02
Veraz147: sits out=20
*** HOLE CARDS ***
Dealt to the_wickstar [Td 6c]
Dusch799: raises $0.05 to $0.07
yjqian23: folds=20
Mekanisis: folds=20
voltes5588: folds=20
nemkefull: folds=20
the_wickstar: folds=20
wrb1011: folds=20
11CarlBluesy: folds=20
Uncalled bet ($0.05) returned to Dusch799
Dusch799 collected $0.05 from pot
*** SUMMARY ***
Total pot $0.05 | Rake $0=20
Seat 2: the_wickstar (button) folded before Flop (didn't bet)
Seat 3: wrb1011 (small blind) folded before Flop
Seat 4: 11CarlBluesy (big blind) folded before Flop
Seat 5: Dusch799 collected ($0.05)
Seat 6: yjqian23 folded before Flop (didn't bet)
Seat 7: Mekanisis folded before Flop (didn't bet)
Seat 8: voltes5588 folded before Flop (didn't bet)
Seat 9: nemkefull folded before Flop (didn't bet)


*********** # 22 **************
PokerStars Hand #169565191182:  Hold'em No Limit ($0.01/$0.02 USD) - 20=
17/04/26 11:08:42 CUST [2017/04/25 21:08:42 ET]
Table 'Baumeia II' 9-max Seat #9 is the button
Seat 1: Buxixo101 ($1.90 in chips)=20
Seat 2: picky_1993 ($2 in chips)=20
Seat 4: L3m0nN@tion ($2.13 in chips)=20
Seat 5: the_wickstar ($1.33 in chips)=20
Seat 6: wernergaming ($1.60 in chips)=20
Seat 7: nemkefull ($2.76 in chips)=20
Seat 8: Demonidze31 ($2 in chips)=20
Seat 9: Dusch799 ($2.62 in chips)=20
Buxixo101: posts small blind $0.01
picky_1993: posts big blind $0.02
switalsky: sits out=20
*** HOLE CARDS ***
Dealt to the_wickstar [2h 3h]
L3m0nN@tion: folds=20
the_wickstar: folds=20
wernergaming: folds=20
nemkefull: folds=20
Demonidze31: folds=20
Dusch799: folds=20
Buxixo101: raises $0.04 to $0.06
picky_1993: calls $0.04
*** FLOP *** [Kc 5c 2d]
Buxixo101: checks=20
picky_1993: bets $0.08
Buxixo101: raises $0.08 to $0.16
picky_1993: raises $0.21 to $0.37
Buxixo101: folds=20
Uncalled bet ($0.21) returned to picky_1993
picky_1993 collected $0.42 from pot
picky_1993: doesn't show hand=20
*** SUMMARY ***
Total pot $0.44 | Rake $0.02=20
Board [Kc 5c 2d]
Seat 1: Buxixo101 (small blind) folded on the Flop
Seat 2: picky_1993 (big blind) collected ($0.42)
Seat 4: L3m0nN@tion folded before Flop (didn't bet)
Seat 5: the_wickstar folded before Flop (didn't bet)
Seat 6: wernergaming folded before Flop (didn't bet)
Seat 7: nemkefull folded before Flop (didn't bet)
Seat 8: Demonidze31 folded before Flop (didn't bet)
Seat 9: Dusch799 (button) folded before Flop (didn't bet)


*********** # 23 **************
PokerStars Hand #169565187112:  Hold'em No Limit ($0.01/$0.02 USD) - 20=
17/04/26 11:08:32 CUST [2017/04/25 21:08:32 ET]
Table 'Ehrdni' 9-max Seat #1 is the button
Seat 1: YoungWitt ($2.18 in chips)=20
Seat 2: the_wickstar ($1.15 in chips)=20
Seat 3: wrb1011 ($1.47 in chips)=20
Seat 4: 11CarlBluesy ($1.20 in chips)=20
Seat 5: Dusch799 ($1.93 in chips)=20
Seat 6: yjqian23 ($1.93 in chips)=20
Seat 7: Mekanisis ($2 in chips)=20
Seat 8: voltes5588 ($1.85 in chips)=20
Seat 9: nemkefull ($2.56 in chips)=20
the_wickstar: posts small blind $0.01
wrb1011: posts big blind $0.02
*** HOLE CARDS ***
Dealt to the_wickstar [7c 6h]
11CarlBluesy: folds=20
Dusch799: folds=20
yjqian23: folds=20
Mekanisis: folds=20
voltes5588: folds=20
nemkefull: folds=20
YoungWitt: calls $0.02
the_wickstar: calls $0.01
wrb1011: checks=20
*** FLOP *** [8s Qd 3c]
the_wickstar: checks=20
wrb1011: bets $0.02
YoungWitt: folds=20
YoungWitt leaves the table
the_wickstar: folds=20
Uncalled bet ($0.02) returned to wrb1011
Veraz147 joins the table at seat #1=20
wrb1011 collected $0.06 from pot
wrb1011: doesn't show hand=20
*** SUMMARY ***
Total pot $0.06 | Rake $0=20
Board [8s Qd 3c]
Seat 1: YoungWitt (button) folded on the Flop
Seat 2: the_wickstar (small blind) folded on the Flop
Seat 3: wrb1011 (big blind) collected ($0.06)
Seat 4: 11CarlBluesy folded before Flop (didn't bet)
Seat 5: Dusch799 folded before Flop (didn't bet)
Seat 6: yjqian23 folded before Flop (didn't bet)
Seat 7: Mekanisis folded before Flop (didn't bet)
Seat 8: voltes5588 folded before Flop (didn't bet)
Seat 9: nemkefull folded before Flop (didn't bet)


*********** # 24 **************
PokerStars Hand #169565167081:  Hold'em No Limit ($0.01/$0.02 USD) - 20=
17/04/26 11:07:47 CUST [2017/04/25 21:07:47 ET]
Table 'Ehrdni' 9-max Seat #9 is the button
Seat 1: YoungWitt ($2.19 in chips)=20
Seat 2: the_wickstar ($1.17 in chips)=20
Seat 3: wrb1011 ($1.47 in chips)=20
Seat 4: 11CarlBluesy ($1.20 in chips)=20
Seat 5: Dusch799 ($1.95 in chips)=20
Seat 6: yjqian23 ($1.93 in chips)=20
Seat 7: Mekanisis ($2 in chips)=20
Seat 8: voltes5588 ($1.85 in chips)=20
Seat 9: nemkefull ($2.49 in chips)=20
YoungWitt: posts small blind $0.01
the_wickstar: posts big blind $0.02
*** HOLE CARDS ***
Dealt to the_wickstar [Kc 2c]
wrb1011: folds=20
11CarlBluesy: folds=20
Dusch799: calls $0.02
yjqian23: folds=20
Mekanisis: calls $0.02
voltes5588: folds=20
nemkefull: raises $0.12 to $0.14
YoungWitt: folds=20
the_wickstar: folds=20
Dusch799: folds=20
Mekanisis: folds=20
Uncalled bet ($0.12) returned to nemkefull
nemkefull collected $0.09 from pot
nemkefull: doesn't show hand=20
*** SUMMARY ***
Total pot $0.09 | Rake $0=20
Seat 1: YoungWitt (small blind) folded before Flop
Seat 2: the_wickstar (big blind) folded before Flop
Seat 3: wrb1011 folded before Flop (didn't bet)
Seat 4: 11CarlBluesy folded before Flop (didn't bet)
Seat 5: Dusch799 folded before Flop
Seat 6: yjqian23 folded before Flop (didn't bet)
Seat 7: Mekanisis folded before Flop
Seat 8: voltes5588 folded before Flop (didn't bet)
Seat 9: nemkefull (button) collected ($0.09)


*********** # 25 **************
PokerStars Hand #169565137543:  Hold'em No Limit ($0.01/$0.02 USD) - 20=
17/04/26 11:06:41 CUST [2017/04/25 21:06:41 ET]
Table 'Baumeia II' 9-max Seat #8 is the button
Seat 1: Buxixo101 ($2.01 in chips)=20
Seat 2: picky_1993 ($2 in chips)=20
Seat 4: L3m0nN@tion ($1.75 in chips)=20
Seat 5: the_wickstar ($1.33 in chips)=20
Seat 6: wernergaming ($1.88 in chips)=20
Seat 7: nemkefull ($2.76 in chips)=20
Seat 8: Demonidze31 ($2 in chips)=20
Seat 9: Dusch799 ($2.63 in chips)=20
Dusch799: posts small blind $0.01
Buxixo101: posts big blind $0.02
switalsky: sits out=20
*** HOLE CARDS ***
Dealt to the_wickstar [9h 2c]
picky_1993: folds=20
L3m0nN@tion: raises $0.02 to $0.04
the_wickstar: folds=20
wernergaming: calls $0.04
nemkefull: folds=20
Demonidze31: folds=20
Dusch799: folds=20
Buxixo101: calls $0.02
*** FLOP *** [Qc As Jh]
Buxixo101: bets $0.07
L3m0nN@tion: calls $0.07
wernergaming: calls $0.07
*** TURN *** [Qc As Jh] [2s]
Buxixo101: checks=20
L3m0nN@tion: checks=20
wernergaming: checks=20
*** RIVER *** [Qc As Jh 2s] [Kh]
Buxixo101: checks=20
L3m0nN@tion: bets $0.17
wernergaming: calls $0.17
Buxixo101: folds=20
*** SHOW DOWN ***
L3m0nN@tion: shows [Tc Qs] (a straight, Ten to Ace)
wernergaming: mucks hand=20
L3m0nN@tion collected $0.66 from pot
*** SUMMARY ***
Total pot $0.68 | Rake $0.02=20
Board [Qc As Jh 2s Kh]
Seat 1: Buxixo101 (big blind) folded on the River
Seat 2: picky_1993 folded before Flop (didn't bet)
Seat 4: L3m0nN@tion showed [Tc Qs] and won ($0.66) with a straight, Ten=
 to Ace
Seat 5: the_wickstar folded before Flop (didn't bet)
Seat 6: wernergaming mucked [8d Kd]
Seat 7: nemkefull folded before Flop (didn't bet)
Seat 8: Demonidze31 (button) folded before Flop (didn't bet)
Seat 9: Dusch799 (small blind) folded before Flop


*********** # 26 **************
PokerStars Hand #169565133858:  Hold'em No Limit ($0.01/$0.02 USD) - 20=
17/04/26 11:06:32 CUST [2017/04/25 21:06:32 ET]
Table 'Ehrdni' 9-max Seat #8 is the button
Seat 1: YoungWitt ($2.14 in chips)=20
Seat 2: the_wickstar ($1.17 in chips)=20
Seat 3: wrb1011 ($1.47 in chips)=20
Seat 4: 11CarlBluesy ($1.20 in chips)=20
Seat 5: Dusch799 ($1.95 in chips)=20
Seat 6: yjqian23 ($1.97 in chips)=20
Seat 7: Mekanisis ($2 in chips)=20
Seat 8: voltes5588 ($1.85 in chips)=20
Seat 9: nemkefull ($2.50 in chips)=20
nemkefull: posts small blind $0.01
YoungWitt: posts big blind $0.02
*** HOLE CARDS ***
Dealt to the_wickstar [9d 4d]
the_wickstar: folds=20
wrb1011: folds=20
11CarlBluesy: folds=20
Dusch799: folds=20
yjqian23: calls $0.02
Mekanisis: folds=20
voltes5588: folds=20
nemkefull: folds=20
YoungWitt: checks=20
*** FLOP *** [2s 8s Kh]
YoungWitt: checks=20
yjqian23: bets $0.02
YoungWitt: calls $0.02
*** TURN *** [2s 8s Kh] [3d]
YoungWitt: checks=20
yjqian23: checks=20
*** RIVER *** [2s 8s Kh 3d] [7s]
YoungWitt: bets $0.04
yjqian23: folds=20
Uncalled bet ($0.04) returned to YoungWitt
YoungWitt collected $0.09 from pot
*** SUMMARY ***
Total pot $0.09 | Rake $0=20
Board [2s 8s Kh 3d 7s]
Seat 1: YoungWitt (big blind) collected ($0.09)
Seat 2: the_wickstar folded before Flop (didn't bet)
Seat 3: wrb1011 folded before Flop (didn't bet)
Seat 4: 11CarlBluesy folded before Flop (didn't bet)
Seat 5: Dusch799 folded before Flop (didn't bet)
Seat 6: yjqian23 folded on the River
Seat 7: Mekanisis folded before Flop (didn't bet)
Seat 8: voltes5588 (button) folded before Flop (didn't bet)
Seat 9: nemkefull (small blind) folded before Flop


*********** # 27 **************
PokerStars Hand #169565100643:  Hold'em No Limit ($0.01/$0.02 USD) - 20=
17/04/26 11:05:17 CUST [2017/04/25 21:05:17 ET]
Table 'Ehrdni' 9-max Seat #7 is the button
Seat 1: YoungWitt ($2.14 in chips)=20
Seat 2: the_wickstar ($1.17 in chips)=20
Seat 3: wrb1011 ($1.47 in chips)=20
Seat 4: 11CarlBluesy ($1.20 in chips)=20
Seat 5: Dusch799 ($1.95 in chips)=20
Seat 6: yjqian23 ($1.97 in chips)=20
Seat 7: Mekanisis ($2 in chips)=20
Seat 8: voltes5588 ($1.87 in chips)=20
Seat 9: nemkefull ($2.48 in chips)=20
voltes5588: posts small blind $0.01
nemkefull: posts big blind $0.02
*** HOLE CARDS ***
Dealt to the_wickstar [7c Th]
YoungWitt: folds=20
the_wickstar has timed out
the_wickstar: folds=20
wrb1011: folds=20
11CarlBluesy: folds=20
Dusch799: folds=20
yjqian23: folds=20
Mekanisis: folds=20
voltes5588: calls $0.01
nemkefull: checks=20
*** FLOP *** [Qh Qs 8h]
voltes5588: checks=20
nemkefull: checks=20
*** TURN *** [Qh Qs 8h] [6h]
voltes5588: checks=20
nemkefull: checks=20
*** RIVER *** [Qh Qs 8h 6h] [2h]
voltes5588: checks=20
nemkefull: checks=20
*** SHOW DOWN ***
voltes5588: shows [5d Td] (a pair of Queens)
nemkefull: shows [9h 5c] (a flush, Queen high)
nemkefull collected $0.04 from pot
*** SUMMARY ***
Total pot $0.04 | Rake $0=20
Board [Qh Qs 8h 6h 2h]
Seat 1: YoungWitt folded before Flop (didn't bet)
Seat 2: the_wickstar folded before Flop (didn't bet)
Seat 3: wrb1011 folded before Flop (didn't bet)
Seat 4: 11CarlBluesy folded before Flop (didn't bet)
Seat 5: Dusch799 folded before Flop (didn't bet)
Seat 6: yjqian23 folded before Flop (didn't bet)
Seat 7: Mekanisis (button) folded before Flop (didn't bet)
Seat 8: voltes5588 (small blind) showed [5d Td] and lost with a pair of=
 Queens
Seat 9: nemkefull (big blind) showed [9h 5c] and won ($0.04) with a flu=
sh, Queen high


*********** # 28 **************
PokerStars Hand #169565097895:  Hold'em No Limit ($0.01/$0.02 USD) - 20=
17/04/26 11:05:11 CUST [2017/04/25 21:05:11 ET]
Table 'Baumeia II' 9-max Seat #7 is the button
Seat 1: Buxixo101 ($2.01 in chips)=20
Seat 2: picky_1993 ($2 in chips)=20
Seat 4: L3m0nN@tion ($1.75 in chips)=20
Seat 5: the_wickstar ($1.20 in chips)=20
Seat 6: wernergaming ($1.94 in chips)=20
Seat 7: nemkefull ($2.76 in chips)=20
Seat 8: Demonidze31 ($2.03 in chips)=20
Seat 9: Dusch799 ($2.65 in chips)=20
Demonidze31: posts small blind $0.01
Dusch799: posts big blind $0.02
switalsky: sits out=20
*** HOLE CARDS ***
Dealt to the_wickstar [Tc Qc]
Buxixo101: folds=20
picky_1993: folds=20
L3m0nN@tion: folds=20
the_wickstar: raises $0.04 to $0.06
wernergaming: calls $0.06
nemkefull: folds=20
Demonidze31: calls $0.05
Dusch799: folds=20
*** FLOP *** [3c 3h 4c]
Demonidze31: checks=20
the_wickstar: checks=20
wernergaming: checks=20
*** TURN *** [3c 3h 4c] [Kh]
Demonidze31: checks=20
the_wickstar: checks=20
wernergaming: checks=20
*** RIVER *** [3c 3h 4c Kh] [5h]
Demonidze31: checks=20
the_wickstar: bets $0.12
wernergaming: folds=20
Demonidze31: folds=20
Uncalled bet ($0.12) returned to the_wickstar
the_wickstar collected $0.19 from pot
*** SUMMARY ***
Total pot $0.20 | Rake $0.01=20
Board [3c 3h 4c Kh 5h]
Seat 1: Buxixo101 folded before Flop (didn't bet)
Seat 2: picky_1993 folded before Flop (didn't bet)
Seat 4: L3m0nN@tion folded before Flop (didn't bet)
Seat 5: the_wickstar collected ($0.19)
Seat 6: wernergaming folded on the River
Seat 7: nemkefull (button) folded before Flop (didn't bet)
Seat 8: Demonidze31 (small blind) folded on the River
Seat 9: Dusch799 (big blind) folded before Flop


*********** # 29 **************
PokerStars Hand #169565075820:  Hold'em No Limit ($0.01/$0.02 USD) - 20=
17/04/26 11:04:21 CUST [2017/04/25 21:04:21 ET]
Table 'Baumeia II' 9-max Seat #6 is the button
Seat 1: Buxixo101 ($2.01 in chips)=20
Seat 2: picky_1993 ($2 in chips)=20
Seat 4: L3m0nN@tion ($1.79 in chips)=20
Seat 5: the_wickstar ($1.20 in chips)=20
Seat 6: wernergaming ($1.87 in chips)=20
Seat 7: nemkefull ($2.77 in chips)=20
Seat 8: Demonidze31 ($2.05 in chips)=20
Seat 9: Dusch799 ($2.65 in chips)=20
nemkefull: posts small blind $0.01
Demonidze31: posts big blind $0.02
switalsky: sits out=20
*** HOLE CARDS ***
Dealt to the_wickstar [9c 6d]
Dusch799: folds=20
Buxixo101: folds=20
picky_1993: folds=20
L3m0nN@tion: raises $0.02 to $0.04
the_wickstar: folds=20
wernergaming: calls $0.04
nemkefull: folds=20
Demonidze31: folds=20
*** FLOP *** [Ac Ks Ah]
L3m0nN@tion: checks=20
wernergaming: checks=20
*** TURN *** [Ac Ks Ah] [6s]
L3m0nN@tion: checks=20
wernergaming: checks=20
*** RIVER *** [Ac Ks Ah 6s] [Jh]
L3m0nN@tion: checks=20
wernergaming: checks=20
*** SHOW DOWN ***
L3m0nN@tion: shows [7c 5c] (a pair of Aces)
wernergaming: shows [Qs 9s] (a pair of Aces - King+Queen kicker)
wernergaming collected $0.11 from pot
*** SUMMARY ***
Total pot $0.11 | Rake $0=20
Board [Ac Ks Ah 6s Jh]
Seat 1: Buxixo101 folded before Flop (didn't bet)
Seat 2: picky_1993 folded before Flop (didn't bet)
Seat 4: L3m0nN@tion showed [7c 5c] and lost with a pair of Aces
Seat 5: the_wickstar folded before Flop (didn't bet)
Seat 6: wernergaming (button) showed [Qs 9s] and won ($0.11) with a pai=
r of Aces
Seat 7: nemkefull (small blind) folded before Flop
Seat 8: Demonidze31 (big blind) folded before Flop
Seat 9: Dusch799 folded before Flop (didn't bet)


*********** # 30 **************
PokerStars Hand #169565060684:  Hold'em No Limit ($0.01/$0.02 USD) - 20=
17/04/26 11:03:46 CUST [2017/04/25 21:03:46 ET]
Table 'Ehrdni' 9-max Seat #6 is the button
Seat 1: YoungWitt ($2.11 in chips)=20
Seat 2: the_wickstar ($1.17 in chips)=20
Seat 3: wrb1011 ($1.47 in chips)=20
Seat 4: 11CarlBluesy ($1.20 in chips)=20
Seat 5: Dusch799 ($1.95 in chips)=20
Seat 6: yjqian23 ($1.97 in chips)=20
Seat 7: Mekanisis ($2 in chips)=20
Seat 8: voltes5588 ($1.89 in chips)=20
Seat 9: nemkefull ($2.48 in chips)=20
Mekanisis: posts small blind $0.01
voltes5588: posts big blind $0.02
*** HOLE CARDS ***
Dealt to the_wickstar [Qd 6d]
nemkefull: folds=20
YoungWitt: raises $0.04 to $0.06
the_wickstar: folds=20
wrb1011 has timed out
wrb1011: folds=20
11CarlBluesy: folds=20
Dusch799: folds=20
yjqian23: folds=20
Mekanisis: folds=20
voltes5588: folds=20
Uncalled bet ($0.04) returned to YoungWitt
YoungWitt collected $0.05 from pot
*** SUMMARY ***
Total pot $0.05 | Rake $0=20
Seat 1: YoungWitt collected ($0.05)
Seat 2: the_wickstar folded before Flop (didn't bet)
Seat 3: wrb1011 folded before Flop (didn't bet)
Seat 4: 11CarlBluesy folded before Flop (didn't bet)
Seat 5: Dusch799 folded before Flop (didn't bet)
Seat 6: yjqian23 (button) folded before Flop (didn't bet)
Seat 7: Mekanisis (small blind) folded before Flop
Seat 8: voltes5588 (big blind) folded before Flop
Seat 9: nemkefull folded before Flop (didn't bet)


*********** # 31 **************
PokerStars Hand #169565055706:  Hold'em No Limit ($0.01/$0.02 USD) - 20=
17/04/26 11:03:34 CUST [2017/04/25 21:03:34 ET]
Table 'Baumeia II' 9-max Seat #5 is the button
Seat 1: Buxixo101 ($1.98 in chips)=20
Seat 2: picky_1993 ($2 in chips)=20
Seat 4: L3m0nN@tion ($1.79 in chips)=20
Seat 5: the_wickstar ($1.20 in chips)=20
Seat 6: wernergaming ($1.88 in chips)=20
Seat 7: nemkefull ($2.79 in chips)=20
Seat 8: Demonidze31 ($2.05 in chips)=20
Seat 9: Dusch799 ($2.65 in chips)=20
wernergaming: posts small blind $0.01
nemkefull: posts big blind $0.02
switalsky: sits out=20
*** HOLE CARDS ***
Dealt to the_wickstar [8d 5c]
Demonidze31: folds=20
Dusch799: folds=20
Buxixo101: raises $0.04 to $0.06
picky_1993: folds=20
L3m0nN@tion: folds=20
the_wickstar: folds=20
wernergaming: folds=20
nemkefull: folds=20
Uncalled bet ($0.04) returned to Buxixo101
Buxixo101 collected $0.05 from pot
*** SUMMARY ***
Total pot $0.05 | Rake $0=20
Seat 1: Buxixo101 collected ($0.05)
Seat 2: picky_1993 folded before Flop (didn't bet)
Seat 4: L3m0nN@tion folded before Flop (didn't bet)
Seat 5: the_wickstar (button) folded before Flop (didn't bet)
Seat 6: wernergaming (small blind) folded before Flop
Seat 7: nemkefull (big blind) folded before Flop
Seat 8: Demonidze31 folded before Flop (didn't bet)
Seat 9: Dusch799 folded before Flop (didn't bet)


*********** # 32 **************
PokerStars Hand #169565024890:  Hold'em No Limit ($0.01/$0.02 USD) - 20=
17/04/26 11:02:23 CUST [2017/04/25 21:02:23 ET]
Table 'Ehrdni' 9-max Seat #5 is the button
Seat 1: YoungWitt ($2.03 in chips)=20
Seat 2: the_wickstar ($1.17 in chips)=20
Seat 3: wrb1011 ($1.47 in chips)=20
Seat 4: 11CarlBluesy ($1.20 in chips)=20
Seat 5: Dusch799 ($2 in chips)=20
Seat 6: yjqian23 ($1.98 in chips)=20
Seat 7: Mekanisis ($2 in chips)=20
Seat 8: voltes5588 ($1.89 in chips)=20
Seat 9: nemkefull ($2.48 in chips)=20
yjqian23: posts small blind $0.01
Mekanisis: posts big blind $0.02
*** HOLE CARDS ***
Dealt to the_wickstar [Ah 8s]
voltes5588: folds=20
nemkefull: folds=20
YoungWitt: raises $0.03 to $0.05
the_wickstar: folds=20
wrb1011: folds=20
11CarlBluesy: folds=20
Dusch799: calls $0.05
yjqian23: folds=20
Mekanisis: folds=20
*** FLOP *** [Qd Td 7h]
YoungWitt: bets $0.08
Dusch799: folds=20
Uncalled bet ($0.08) returned to YoungWitt
YoungWitt collected $0.13 from pot
*** SUMMARY ***
Total pot $0.13 | Rake $0=20
Board [Qd Td 7h]
Seat 1: YoungWitt collected ($0.13)
Seat 2: the_wickstar folded before Flop (didn't bet)
Seat 3: wrb1011 folded before Flop (didn't bet)
Seat 4: 11CarlBluesy folded before Flop (didn't bet)
Seat 5: Dusch799 (button) folded on the Flop
Seat 6: yjqian23 (small blind) folded before Flop
Seat 7: Mekanisis (big blind) folded before Flop
Seat 8: voltes5588 folded before Flop (didn't bet)
Seat 9: nemkefull folded before Flop (didn't bet)


*********** # 33 **************
PokerStars Hand #169565024172:  Hold'em No Limit ($0.01/$0.02 USD) - 20=
17/04/26 11:02:21 CUST [2017/04/25 21:02:21 ET]
Table 'Baumeia II' 9-max Seat #4 is the button
Seat 1: Buxixo101 ($1.98 in chips)=20
Seat 2: picky_1993 ($2 in chips)=20
Seat 4: L3m0nN@tion ($1.79 in chips)=20
Seat 5: the_wickstar ($1.18 in chips)=20
Seat 6: wernergaming ($1.90 in chips)=20
Seat 7: nemkefull ($2.79 in chips)=20
Seat 8: Demonidze31 ($2.05 in chips)=20
Seat 9: Dusch799 ($2.65 in chips)=20
the_wickstar: posts small blind $0.01
wernergaming: posts big blind $0.02
switalsky: sits out=20
*** HOLE CARDS ***
Dealt to the_wickstar [7c Kc]
nemkefull: folds=20
Demonidze31: folds=20
Dusch799: folds=20
Buxixo101: folds=20
picky_1993: folds=20
L3m0nN@tion: folds=20
the_wickstar: calls $0.01
wernergaming: checks=20
*** FLOP *** [3c 6s 2c]
the_wickstar: checks=20
wernergaming: checks=20
*** TURN *** [3c 6s 2c] [Qs]
the_wickstar: checks=20
wernergaming: checks=20
*** RIVER *** [3c 6s 2c Qs] [Ah]
the_wickstar: bets $0.04
wernergaming: folds=20
Uncalled bet ($0.04) returned to the_wickstar
the_wickstar collected $0.04 from pot
*** SUMMARY ***
Total pot $0.04 | Rake $0=20
Board [3c 6s 2c Qs Ah]
Seat 1: Buxixo101 folded before Flop (didn't bet)
Seat 2: picky_1993 folded before Flop (didn't bet)
Seat 4: L3m0nN@tion (button) folded before Flop (didn't bet)
Seat 5: the_wickstar (small blind) collected ($0.04)
Seat 6: wernergaming (big blind) folded on the River
Seat 7: nemkefull folded before Flop (didn't bet)
Seat 8: Demonidze31 folded before Flop (didn't bet)
Seat 9: Dusch799 folded before Flop (didn't bet)


*********** # 34 **************
PokerStars Hand #169565004471:  Hold'em No Limit ($0.01/$0.02 USD) - 20=
17/04/26 11:01:35 CUST [2017/04/25 21:01:35 ET]
Table 'Ehrdni' 9-max Seat #4 is the button
Seat 1: YoungWitt ($1.98 in chips)=20
Seat 2: the_wickstar ($1.17 in chips)=20
Seat 3: wrb1011 ($1.47 in chips)=20
Seat 4: 11CarlBluesy ($1.20 in chips)=20
Seat 5: Dusch799 ($1.84 in chips)=20
Seat 6: yjqian23 ($2 in chips)=20
Seat 8: voltes5588 ($1.91 in chips)=20
Seat 9: nemkefull ($2.48 in chips)=20
Dusch799: posts small blind $0.01
yjqian23: posts big blind $0.02
Mekanisis: sits out=20
*** HOLE CARDS ***
Dealt to the_wickstar [6h Kc]
voltes5588: calls $0.02
nemkefull: folds=20
YoungWitt: raises $0.04 to $0.06
the_wickstar: folds=20
wrb1011: folds=20
11CarlBluesy: folds=20
Dusch799: folds=20
yjqian23: folds=20
voltes5588: folds=20
Uncalled bet ($0.04) returned to YoungWitt
YoungWitt collected $0.07 from pot
*** SUMMARY ***
Total pot $0.07 | Rake $0=20
Seat 1: YoungWitt collected ($0.07)
Seat 2: the_wickstar folded before Flop (didn't bet)
Seat 3: wrb1011 folded before Flop (didn't bet)
Seat 4: 11CarlBluesy (button) folded before Flop (didn't bet)
Seat 5: Dusch799 (small blind) folded before Flop
Seat 6: yjqian23 (big blind) folded before Flop
Seat 8: voltes5588 folded before Flop
Seat 9: nemkefull folded before Flop (didn't bet)


*********** # 35 **************
PokerStars Hand #169564959674:  Hold'em No Limit ($0.01/$0.02 USD) - 20=
17/04/26 10:59:41 CUST [2017/04/25 20:59:41 ET]
Table 'Ehrdni' 9-max Seat #3 is the button
Seat 1: YoungWitt ($2 in chips)=20
Seat 2: the_wickstar ($1.43 in chips)=20
Seat 3: wrb1011 ($1.47 in chips)=20
Seat 4: 11CarlBluesy ($0.88 in chips)=20
Seat 5: Dusch799 ($1.86 in chips)=20
Seat 6: hanbw ($0.71 in chips)=20
Seat 8: voltes5588 ($1.93 in chips)=20
Seat 9: nemkefull ($2.50 in chips)=20
11CarlBluesy: posts small blind $0.01
Dusch799: posts big blind $0.02
Mekanisis: sits out=20
YoungWitt: posts big blind $0.02
*** HOLE CARDS ***
Dealt to the_wickstar [9c 8h]
hanbw: folds=20
voltes5588: calls $0.02
nemkefull: calls $0.02
YoungWitt: checks=20
the_wickstar: calls $0.02
wrb1011: folds=20
11CarlBluesy: calls $0.01
Dusch799: checks=20
*** FLOP *** [3s 3h 8d]
11CarlBluesy: checks=20
Dusch799: checks=20
voltes5588: checks=20
nemkefull: checks=20
YoungWitt: checks=20
the_wickstar: bets $0.09
11CarlBluesy: calls $0.09
Dusch799: folds=20
voltes5588: folds=20
nemkefull: folds=20
YoungWitt: folds=20
*** TURN *** [3s 3h 8d] [7s]
11CarlBluesy: checks=20
the_wickstar: checks=20
*** RIVER *** [3s 3h 8d 7s] [2d]
hanbw leaves the table
11CarlBluesy: bets $0.15
the_wickstar: calls $0.15
*** SHOW DOWN ***
11CarlBluesy: shows [Kd 8c] (two pair, Eights and Threes)
the_wickstar: mucks hand=20
11CarlBluesy collected $0.58 from pot
yjqian23 joins the table at seat #6=20
*** SUMMARY ***
Total pot $0.60 | Rake $0.02=20
Board [3s 3h 8d 7s 2d]
Seat 1: YoungWitt folded on the Flop
Seat 2: the_wickstar mucked [9c 8h]
Seat 3: wrb1011 (button) folded before Flop (didn't bet)
Seat 4: 11CarlBluesy (small blind) showed [Kd 8c] and won ($0.58) with =
two pair, Eights and Threes
Seat 5: Dusch799 (big blind) folded on the Flop
Seat 6: hanbw folded before Flop (didn't bet)
Seat 8: voltes5588 folded on the Flop
Seat 9: nemkefull folded on the Flop


*********** # 36 **************
PokerStars Hand #169564943366:  Hold'em No Limit ($0.01/$0.02 USD) - 20=
17/04/26 10:58:58 CUST [2017/04/25 20:58:58 ET]
Table 'Baumeia II' 9-max Seat #2 is the button
Seat 1: Buxixo101 ($2 in chips)=20
Seat 2: picky_1993 ($2 in chips)=20
Seat 4: L3m0nN@tion ($1.81 in chips)=20
Seat 5: the_wickstar ($1.14 in chips)=20
Seat 7: nemkefull ($2.79 in chips)=20
Seat 8: Demonidze31 ($2.05 in chips)=20
Seat 9: Dusch799 ($2.65 in chips)=20
L3m0nN@tion: posts small blind $0.01
the_wickstar: posts big blind $0.02
Buxixo101: posts big blind $0.02
*** HOLE CARDS ***
Dealt to the_wickstar [9d 5c]
nemkefull: folds=20
Demonidze31: folds=20
switalsky joins the table at seat #3=20
Dusch799 has timed out
Dusch799: folds=20
Buxixo101: checks=20
picky_1993: folds=20
L3m0nN@tion: calls $0.01
the_wickstar: checks=20
*** FLOP *** [Ks 8h 2h]
L3m0nN@tion: checks=20
the_wickstar: checks=20
Buxixo101: checks=20
*** TURN *** [Ks 8h 2h] [Qc]
L3m0nN@tion: checks=20
the_wickstar: checks=20
Buxixo101: checks=20
*** RIVER *** [Ks 8h 2h Qc] [4c]
L3m0nN@tion: checks=20
the_wickstar: bets $0.04
Buxixo101 has timed out
Buxixo101: folds=20
L3m0nN@tion: folds=20
Uncalled bet ($0.04) returned to the_wickstar
the_wickstar collected $0.06 from pot
*** SUMMARY ***
Total pot $0.06 | Rake $0=20
Board [Ks 8h 2h Qc 4c]
Seat 1: Buxixo101 folded on the River
Seat 2: picky_1993 (button) folded before Flop (didn't bet)
Seat 4: L3m0nN@tion (small blind) folded on the River
Seat 5: the_wickstar (big blind) collected ($0.06)
Seat 7: nemkefull folded before Flop (didn't bet)
Seat 8: Demonidze31 folded before Flop (didn't bet)
Seat 9: Dusch799 folded before Flop (didn't bet)


*********** # 37 **************
PokerStars Hand #169564925384:  Hold'em No Limit ($0.01/$0.02 USD) - 20=
17/04/26 10:58:10 CUST [2017/04/25 20:58:10 ET]
Table 'Ehrdni' 9-max Seat #2 is the button
Seat 2: the_wickstar ($1.43 in chips)=20
Seat 3: wrb1011 ($1.48 in chips)=20
Seat 4: 11CarlBluesy ($0.90 in chips)=20
Seat 5: Dusch799 ($1.92 in chips)=20
Seat 6: hanbw ($0.71 in chips)=20
Seat 8: voltes5588 ($1.85 in chips)=20
Seat 9: nemkefull ($2.50 in chips)=20
wrb1011: posts small blind $0.01
11CarlBluesy: posts big blind $0.02
Mekanisis: sits out=20
*** HOLE CARDS ***
Dealt to the_wickstar [7h Ks]
YoungWitt joins the table at seat #1=20
Dusch799: raises $0.04 to $0.06
hanbw: folds=20
voltes5588: calls $0.06
nemkefull: folds=20
the_wickstar: folds=20
wrb1011: folds=20
11CarlBluesy: folds=20
*** FLOP *** [6s 3s Tc]
Dusch799: checks=20
voltes5588: bets $0.07
Dusch799: folds=20
Uncalled bet ($0.07) returned to voltes5588
voltes5588 collected $0.14 from pot
voltes5588: doesn't show hand=20
*** SUMMARY ***
Total pot $0.15 | Rake $0.01=20
Board [6s 3s Tc]
Seat 2: the_wickstar (button) folded before Flop (didn't bet)
Seat 3: wrb1011 (small blind) folded before Flop
Seat 4: 11CarlBluesy (big blind) folded before Flop
Seat 5: Dusch799 folded on the Flop
Seat 6: hanbw folded before Flop (didn't bet)
Seat 8: voltes5588 collected ($0.14)
Seat 9: nemkefull folded before Flop (didn't bet)


*********** # 38 **************
PokerStars Hand #169564918642:  Hold'em No Limit ($0.01/$0.02 USD) - 20=
17/04/26 10:57:52 CUST [2017/04/25 20:57:52 ET]
Table 'Ehrdni' 9-max Seat #9 is the button
Seat 2: the_wickstar ($1.44 in chips)=20
Seat 3: wrb1011 ($1.47 in chips)=20
Seat 4: 11CarlBluesy ($0.90 in chips)=20
Seat 5: Dusch799 ($1.92 in chips)=20
Seat 6: hanbw ($0.71 in chips)=20
Seat 8: voltes5588 ($1.85 in chips)=20
Seat 9: nemkefull ($2.50 in chips)=20
the_wickstar: posts small blind $0.01
wrb1011: posts big blind $0.02
Mekanisis: sits out=20
*** HOLE CARDS ***
Dealt to the_wickstar [9c Th]
11CarlBluesy: folds=20
Dusch799: folds=20
hanbw: folds=20
voltes5588: folds=20
nemkefull: folds=20
the_wickstar: folds=20
Uncalled bet ($0.01) returned to wrb1011
wrb1011 collected $0.02 from pot
wrb1011: doesn't show hand=20
*** SUMMARY ***
Total pot $0.02 | Rake $0=20
Seat 2: the_wickstar (small blind) folded before Flop
Seat 3: wrb1011 (big blind) collected ($0.02)
Seat 4: 11CarlBluesy folded before Flop (didn't bet)
Seat 5: Dusch799 folded before Flop (didn't bet)
Seat 6: hanbw folded before Flop (didn't bet)
Seat 8: voltes5588 folded before Flop (didn't bet)
Seat 9: nemkefull (button) folded before Flop (didn't bet)


*********** # 39 **************
PokerStars Hand #169564917631:  Hold'em No Limit ($0.01/$0.02 USD) - 20=
17/04/26 10:57:49 CUST [2017/04/25 20:57:49 ET]
Table 'Baumeia II' 9-max Seat #9 is the button
Seat 2: picky_1993 ($2.01 in chips)=20
Seat 4: L3m0nN@tion ($1.85 in chips)=20
Seat 5: the_wickstar ($1.14 in chips)=20
Seat 6: wernergaming ($1.90 in chips)=20
Seat 7: nemkefull ($2.79 in chips)=20
Seat 8: Demonidze31 ($2 in chips)=20
Seat 9: Dusch799 ($2.65 in chips)=20
Buxixo101 will be allowed to play after the button
picky_1993: posts small blind $0.01
K0rsar11: is sitting out=20
L3m0nN@tion: posts big blind $0.02
*** HOLE CARDS ***
Dealt to the_wickstar [4d Jh]
K0rsar11 leaves the table
the_wickstar: folds=20
wernergaming: folds=20
nemkefull: folds=20
Demonidze31: raises $0.02 to $0.04
Dusch799: folds=20
picky_1993: folds=20
L3m0nN@tion: calls $0.02
*** FLOP *** [Ts 6d 8s]
L3m0nN@tion: checks=20
Demonidze31: bets $0.05
L3m0nN@tion: folds=20
Uncalled bet ($0.05) returned to Demonidze31
Demonidze31 collected $0.09 from pot
Demonidze31: doesn't show hand=20
*** SUMMARY ***
Total pot $0.09 | Rake $0=20
Board [Ts 6d 8s]
Seat 2: picky_1993 (small blind) folded before Flop
Seat 4: L3m0nN@tion (big blind) folded on the Flop
Seat 5: the_wickstar folded before Flop (didn't bet)
Seat 6: wernergaming folded before Flop (didn't bet)
Seat 7: nemkefull folded before Flop (didn't bet)
Seat 8: Demonidze31 collected ($0.09)
Seat 9: Dusch799 (button) folded before Flop (didn't bet)


*********** # 40 **************
PokerStars Hand #169564898938:  Hold'em No Limit ($0.01/$0.02 USD) - 20=
17/04/26 10:57:00 CUST [2017/04/25 20:57:00 ET]
Table 'Ehrdni' 9-max Seat #8 is the button
Seat 2: the_wickstar ($1.46 in chips)=20
Seat 3: wrb1011 ($1.44 in chips)=20
Seat 4: 11CarlBluesy ($0.90 in chips)=20
Seat 5: Dusch799 ($1.92 in chips)=20
Seat 6: hanbw ($0.71 in chips)=20
Seat 8: voltes5588 ($1.85 in chips)=20
Seat 9: nemkefull ($2.51 in chips)=20
nemkefull: posts small blind $0.01
Comra1d: is sitting out=20
Comra1d leaves the table
the_wickstar: posts big blind $0.02
Mekanisis: sits out=20
*** HOLE CARDS ***
Dealt to the_wickstar [9d 5c]
wrb1011: calls $0.02
11CarlBluesy: folds=20
Dusch799: folds=20
hanbw: folds=20
voltes5588: folds=20
nemkefull: folds=20
the_wickstar: checks=20
*** FLOP *** [Ks 8d Qh]
the_wickstar: checks=20
wrb1011: bets $0.02
the_wickstar: folds=20
Uncalled bet ($0.02) returned to wrb1011
wrb1011 collected $0.05 from pot
wrb1011: doesn't show hand=20
*** SUMMARY ***
Total pot $0.05 | Rake $0=20
Board [Ks 8d Qh]
Seat 2: the_wickstar (big blind) folded on the Flop
Seat 3: wrb1011 collected ($0.05)
Seat 4: 11CarlBluesy folded before Flop (didn't bet)
Seat 5: Dusch799 folded before Flop (didn't bet)
Seat 6: hanbw folded before Flop (didn't bet)
Seat 8: voltes5588 (button) folded before Flop (didn't bet)
Seat 9: nemkefull (small blind) folded before Flop


*********** # 41 **************
PokerStars Hand #169564893379:  Hold'em No Limit ($0.01/$0.02 USD) - 20=
17/04/26 10:56:45 CUST [2017/04/25 20:56:45 ET]
Table 'Baumeia II' 9-max Seat #8 is the button
Seat 2: picky_1993 ($2.03 in chips)=20
Seat 3: K0rsar11 ($2.87 in chips)=20
Seat 4: L3m0nN@tion ($1.94 in chips)=20
Seat 5: the_wickstar ($1.14 in chips)=20
Seat 6: wernergaming ($1.79 in chips)=20
Seat 7: nemkefull ($2.79 in chips)=20
Seat 8: Demonidze31 ($2 in chips)=20
Seat 9: Dusch799 ($2.66 in chips)=20
Dusch799: posts small blind $0.01
picky_1993: posts big blind $0.02
*** HOLE CARDS ***
Dealt to the_wickstar [6d 4s]
K0rsar11: folds=20
L3m0nN@tion: raises $0.05 to $0.07
the_wickstar: folds=20
wernergaming: calls $0.07
nemkefull: folds=20
Demonidze31: folds=20
Dusch799: folds=20
picky_1993: folds=20
*** FLOP *** [5s 3h 8c]
Buxixo101 joins the table at seat #1=20
L3m0nN@tion: checks=20
wernergaming: checks=20
*** TURN *** [5s 3h 8c] [9d]
L3m0nN@tion: bets $0.02
wernergaming: raises $0.10 to $0.12
L3m0nN@tion: folds [Js Ad]
Uncalled bet ($0.10) returned to wernergaming
wernergaming collected $0.20 from pot
wernergaming: shows [Ts 4c] (high card Ten)
*** SUMMARY ***
Total pot $0.21 | Rake $0.01=20
Board [5s 3h 8c 9d]
Seat 2: picky_1993 (big blind) folded before Flop
Seat 3: K0rsar11 folded before Flop (didn't bet)
Seat 4: L3m0nN@tion folded on the Turn
Seat 5: the_wickstar folded before Flop (didn't bet)
Seat 6: wernergaming collected ($0.20)
Seat 7: nemkefull folded before Flop (didn't bet)
Seat 8: Demonidze31 (button) folded before Flop (didn't bet)
Seat 9: Dusch799 (small blind) folded before Flop


*********** # 42 **************
PokerStars Hand #169564883822:  Hold'em No Limit ($0.01/$0.02 USD) - 20=
17/04/26 10:56:20 CUST [2017/04/25 20:56:20 ET]
Table 'Ehrdni' 9-max Seat #6 is the button
Seat 1: Comra1d ($2.09 in chips)=20
Seat 2: the_wickstar ($1.46 in chips)=20
Seat 3: wrb1011 ($1.44 in chips)=20
Seat 4: 11CarlBluesy ($0.90 in chips)=20
Seat 5: Dusch799 ($1.92 in chips)=20
Seat 6: hanbw ($0.68 in chips)=20
Seat 8: voltes5588 ($1.86 in chips)=20
Seat 9: nemkefull ($2.53 in chips)=20
voltes5588: posts small blind $0.01
nemkefull: posts big blind $0.02
*** HOLE CARDS ***
Dealt to the_wickstar [4c 5d]
Mekanisis joins the table at seat #7=20
Comra1d: folds=20
the_wickstar: folds=20
wrb1011: folds=20
11CarlBluesy: folds=20
Dusch799: folds=20
hanbw: raises $0.02 to $0.04
voltes5588: folds=20
nemkefull: folds=20
Uncalled bet ($0.02) returned to hanbw
hanbw collected $0.05 from pot
*** SUMMARY ***
Total pot $0.05 | Rake $0=20
Seat 1: Comra1d folded before Flop (didn't bet)
Seat 2: the_wickstar folded before Flop (didn't bet)
Seat 3: wrb1011 folded before Flop (didn't bet)
Seat 4: 11CarlBluesy folded before Flop (didn't bet)
Seat 5: Dusch799 folded before Flop (didn't bet)
Seat 6: hanbw (button) collected ($0.05)
Seat 8: voltes5588 (small blind) folded before Flop
Seat 9: nemkefull (big blind) folded before Flop


*********** # 43 **************
PokerStars Hand #169564882629:  Hold'em No Limit ($0.01/$0.02 USD) - 20=
17/04/26 10:56:17 CUST [2017/04/25 20:56:17 ET]
Table 'Baumeia II' 9-max Seat #7 is the button
Seat 2: picky_1993 ($2.03 in chips)=20
Seat 3: K0rsar11 ($2.84 in chips)=20
Seat 4: L3m0nN@tion ($1.94 in chips)=20
Seat 5: the_wickstar ($1.14 in chips)=20
Seat 6: wernergaming ($1.79 in chips)=20
Seat 7: nemkefull ($2.79 in chips)=20
Seat 8: Demonidze31 ($2.01 in chips)=20
Seat 9: Dusch799 ($2.68 in chips)=20
hugoluis1983 leaves the table
Demonidze31: posts small blind $0.01
Dusch799: posts big blind $0.02
*** HOLE CARDS ***
Dealt to the_wickstar [7h Kh]
picky_1993: folds=20
K0rsar11: raises $0.04 to $0.06
L3m0nN@tion: folds=20
the_wickstar: folds=20
wernergaming: folds=20
nemkefull: folds=20
Demonidze31: folds=20
Dusch799: folds=20
Uncalled bet ($0.04) returned to K0rsar11
K0rsar11 collected $0.05 from pot
K0rsar11: doesn't show hand=20
*** SUMMARY ***
Total pot $0.05 | Rake $0=20
Seat 2: picky_1993 folded before Flop (didn't bet)
Seat 3: K0rsar11 collected ($0.05)
Seat 4: L3m0nN@tion folded before Flop (didn't bet)
Seat 5: the_wickstar folded before Flop (didn't bet)
Seat 6: wernergaming folded before Flop (didn't bet)
Seat 7: nemkefull (button) folded before Flop (didn't bet)
Seat 8: Demonidze31 (small blind) folded before Flop
Seat 9: Dusch799 (big blind) folded before Flop


*********** # 44 **************
PokerStars Hand #169564859684:  Hold'em No Limit ($0.01/$0.02 USD) - 20=
17/04/26 10:55:16 CUST [2017/04/25 20:55:16 ET]
Table 'Ehrdni' 9-max Seat #5 is the button
Seat 1: Comra1d ($2.09 in chips)=20
Seat 2: the_wickstar ($1.46 in chips)=20
Seat 3: wrb1011 ($1.44 in chips)=20
Seat 4: 11CarlBluesy ($0.82 in chips)=20
Seat 5: Dusch799 ($1.92 in chips)=20
Seat 6: hanbw ($0.74 in chips)=20
Seat 8: voltes5588 ($1.88 in chips)=20
Seat 9: nemkefull ($2.53 in chips)=20
hanbw: posts small blind $0.01
IgaMoL: is sitting out=20
IgaMoL leaves the table
voltes5588: posts big blind $0.02
*** HOLE CARDS ***
Dealt to the_wickstar [5s Jc]
nemkefull: folds=20
Comra1d: folds=20
the_wickstar: folds=20
wrb1011: folds=20
11CarlBluesy: raises $0.04 to $0.06
Dusch799: folds=20
hanbw: calls $0.05
voltes5588: folds=20
*** FLOP *** [2c Ad 7h]
hanbw: checks=20
11CarlBluesy: bets $0.07
hanbw: folds=20
Uncalled bet ($0.07) returned to 11CarlBluesy
11CarlBluesy collected $0.14 from pot
11CarlBluesy: doesn't show hand=20
*** SUMMARY ***
Total pot $0.14 | Rake $0=20
Board [2c Ad 7h]
Seat 1: Comra1d folded before Flop (didn't bet)
Seat 2: the_wickstar folded before Flop (didn't bet)
Seat 3: wrb1011 folded before Flop (didn't bet)
Seat 4: 11CarlBluesy collected ($0.14)
Seat 5: Dusch799 (button) folded before Flop (didn't bet)
Seat 6: hanbw (small blind) folded on the Flop
Seat 8: voltes5588 (big blind) folded before Flop
Seat 9: nemkefull folded before Flop (didn't bet)


*********** # 45 **************
PokerStars Hand #169564837658:  Hold'em No Limit ($0.01/$0.02 USD) - 20=
17/04/26 10:54:27 CUST [2017/04/25 20:54:27 ET]
Table 'Ehrdni' 9-max Seat #4 is the button
Seat 1: Comra1d ($2.02 in chips)=20
Seat 2: the_wickstar ($1.46 in chips)=20
Seat 3: wrb1011 ($1.44 in chips)=20
Seat 4: 11CarlBluesy ($0.82 in chips)=20
Seat 5: Dusch799 ($1.93 in chips)=20
Seat 6: hanbw ($0.80 in chips)=20
Seat 7: IgaMoL ($2 in chips)=20
Seat 8: voltes5588 ($1.88 in chips)=20
Seat 9: nemkefull ($2.53 in chips)=20
Dusch799: posts small blind $0.01
hanbw: posts big blind $0.02
*** HOLE CARDS ***
Dealt to the_wickstar [4h 4c]
IgaMoL: folds=20
voltes5588: folds=20
nemkefull: folds=20
Comra1d: raises $0.04 to $0.06
the_wickstar: folds=20
wrb1011: folds=20
11CarlBluesy: folds=20
Dusch799: folds=20
hanbw: calls $0.04
*** FLOP *** [9d 3h Ks]
hanbw: checks=20
Comra1d: checks=20
*** TURN *** [9d 3h Ks] [Th]
hanbw: checks=20
Comra1d: bets $0.09
hanbw: folds=20
Uncalled bet ($0.09) returned to Comra1d
Comra1d collected $0.13 from pot
Comra1d: doesn't show hand=20
*** SUMMARY ***
Total pot $0.13 | Rake $0=20
Board [9d 3h Ks Th]
Seat 1: Comra1d collected ($0.13)
Seat 2: the_wickstar folded before Flop (didn't bet)
Seat 3: wrb1011 folded before Flop (didn't bet)
Seat 4: 11CarlBluesy (button) folded before Flop (didn't bet)
Seat 5: Dusch799 (small blind) folded before Flop
Seat 6: hanbw (big blind) folded on the Turn
Seat 7: IgaMoL folded before Flop (didn't bet)
Seat 8: voltes5588 folded before Flop (didn't bet)
Seat 9: nemkefull folded before Flop (didn't bet)


*********** # 46 **************
PokerStars Hand #169564831195:  Hold'em No Limit ($0.01/$0.02 USD) - 20=
17/04/26 10:54:12 CUST [2017/04/25 20:54:12 ET]
Table 'Baumeia II' 9-max Seat #6 is the button
Seat 1: hugoluis1983 ($2 in chips)=20
Seat 2: picky_1993 ($2.03 in chips)=20
Seat 3: K0rsar11 ($2.84 in chips)=20
Seat 4: L3m0nN@tion ($1.96 in chips)=20
Seat 5: the_wickstar ($1.14 in chips)=20
Seat 6: wernergaming ($2.56 in chips)=20
Seat 7: nemkefull ($2.80 in chips)=20
Seat 8: Demonidze31 ($2.03 in chips)=20
Seat 9: Dusch799 ($1.92 in chips)=20
nemkefull: posts small blind $0.01
Demonidze31: posts big blind $0.02
*** HOLE CARDS ***
Dealt to the_wickstar [Qh 3c]
Dusch799: calls $0.02
hugoluis1983: folds=20
picky_1993: folds=20
K0rsar11: folds=20
L3m0nN@tion: calls $0.02
the_wickstar: folds=20
wernergaming: raises $0.04 to $0.06
nemkefull: folds=20
Demonidze31: folds=20
Dusch799: calls $0.04
L3m0nN@tion: folds=20
*** FLOP *** [6c 2s Th]
Dusch799: bets $0.08
wernergaming: calls $0.08
*** TURN *** [6c 2s Th] [3d]
Dusch799: bets $0.16
wernergaming: calls $0.16
*** RIVER *** [6c 2s Th 3d] [Jc]
Dusch799: bets $0.47
wernergaming: calls $0.47
*** SHOW DOWN ***
Dusch799: shows [2d 2h] (three of a kind, Deuces)
wernergaming: mucks hand=20
Dusch799 collected $1.53 from pot
*** SUMMARY ***
Total pot $1.59 | Rake $0.06=20
Board [6c 2s Th 3d Jc]
Seat 1: hugoluis1983 folded before Flop (didn't bet)
Seat 2: picky_1993 folded before Flop (didn't bet)
Seat 3: K0rsar11 folded before Flop (didn't bet)
Seat 4: L3m0nN@tion folded before Flop
Seat 5: the_wickstar folded before Flop (didn't bet)
Seat 6: wernergaming (button) mucked [Tc Ad]
Seat 7: nemkefull (small blind) folded before Flop
Seat 8: Demonidze31 (big blind) folded before Flop
Seat 9: Dusch799 showed [2d 2h] and won ($1.53) with three of a kind, D=
euces


*********** # 47 **************
PokerStars Hand #169564814166:  Hold'em No Limit ($0.01/$0.02 USD) - 20=
17/04/26 10:53:34 CUST [2017/04/25 20:53:34 ET]
Table 'Ehrdni' 9-max Seat #3 is the button
Seat 1: Comra1d ($2.02 in chips)=20
Seat 2: the_wickstar ($1.46 in chips)=20
Seat 3: wrb1011 ($1.44 in chips)=20
Seat 4: 11CarlBluesy ($0.76 in chips)=20
Seat 5: Dusch799 ($1.99 in chips)=20
Seat 6: yjqian23 ($1.98 in chips)=20
Seat 7: IgaMoL ($2 in chips)=20
Seat 8: voltes5588 ($1.88 in chips)=20
Seat 9: nemkefull ($2.53 in chips)=20
11CarlBluesy: posts small blind $0.01
Dusch799: posts big blind $0.02
*** HOLE CARDS ***
Dealt to the_wickstar [5c 4c]
yjqian23: folds=20
yjqian23 leaves the table
IgaMoL: folds=20
voltes5588: folds=20
nemkefull: folds=20
Comra1d: folds=20
the_wickstar: folds=20
wrb1011: folds=20
11CarlBluesy: raises $0.04 to $0.06
Dusch799: calls $0.04
*** FLOP *** [2h 8h 6s]
11CarlBluesy: bets $0.06
Dusch799: folds=20
Uncalled bet ($0.06) returned to 11CarlBluesy
11CarlBluesy collected $0.12 from pot
11CarlBluesy: doesn't show hand=20
hanbw joins the table at seat #6=20
*** SUMMARY ***
Total pot $0.12 | Rake $0=20
Board [2h 8h 6s]
Seat 1: Comra1d folded before Flop (didn't bet)
Seat 2: the_wickstar folded before Flop (didn't bet)
Seat 3: wrb1011 (button) folded before Flop (didn't bet)
Seat 4: 11CarlBluesy (small blind) collected ($0.12)
Seat 5: Dusch799 (big blind) folded on the Flop
Seat 6: yjqian23 folded before Flop (didn't bet)
Seat 7: IgaMoL folded before Flop (didn't bet)
Seat 8: voltes5588 folded before Flop (didn't bet)
Seat 9: nemkefull folded before Flop (didn't bet)


*********** # 48 **************
PokerStars Hand #169564779270:  Hold'em No Limit ($0.01/$0.02 USD) - 20=
17/04/26 10:52:16 CUST [2017/04/25 20:52:16 ET]
Table 'Baumeia II' 9-max Seat #5 is the button
Seat 1: hugoluis1983 ($2 in chips)=20
Seat 2: picky_1993 ($2.03 in chips)=20
Seat 3: K0rsar11 ($2.84 in chips)=20
Seat 4: L3m0nN@tion ($2.04 in chips)=20
Seat 5: the_wickstar ($1.03 in chips)=20
Seat 6: wernergaming ($2.58 in chips)=20
Seat 7: nemkefull ($2.82 in chips)=20
Seat 9: Dusch799 ($1.92 in chips)=20
wernergaming: posts small blind $0.01
nemkefull: posts big blind $0.02
L3m0nN@tion: posts small & big blinds $0.03
*** HOLE CARDS ***
Dealt to the_wickstar [Ad 8c]
Dusch799: folds=20
hugoluis1983: folds=20
picky_1993: folds=20
K0rsar11: folds=20
L3m0nN@tion: checks=20
the_wickstar: calls $0.02
wernergaming: calls $0.01
nemkefull: checks=20
*** FLOP *** [3d 8h Ts]
wernergaming: checks=20
nemkefull: checks=20
Demonidze31 joins the table at seat #8=20
L3m0nN@tion: checks=20
the_wickstar: bets $0.05
wernergaming: folds=20
nemkefull: folds=20
L3m0nN@tion: calls $0.05
*** TURN *** [3d 8h Ts] [6c]
L3m0nN@tion: checks=20
the_wickstar: checks=20
*** RIVER *** [3d 8h Ts 6c] [6h]
L3m0nN@tion: checks=20
the_wickstar: bets $0.09
L3m0nN@tion: folds=20
Uncalled bet ($0.09) returned to the_wickstar
the_wickstar collected $0.18 from pot
*** SUMMARY ***
Total pot $0.19 | Rake $0.01=20
Board [3d 8h Ts 6c 6h]
Seat 1: hugoluis1983 folded before Flop (didn't bet)
Seat 2: picky_1993 folded before Flop (didn't bet)
Seat 3: K0rsar11 folded before Flop (didn't bet)
Seat 4: L3m0nN@tion folded on the River
Seat 5: the_wickstar (button) collected ($0.18)
Seat 6: wernergaming (small blind) folded on the Flop
Seat 7: nemkefull (big blind) folded on the Flop
Seat 9: Dusch799 folded before Flop (didn't bet)


*********** # 49 **************
PokerStars Hand #169564769217:  Hold'em No Limit ($0.01/$0.02 USD) - 20=
17/04/26 10:51:53 CUST [2017/04/25 20:51:53 ET]
Table 'Ehrdni' 9-max Seat #2 is the button
Seat 1: Comra1d ($2.02 in chips)=20
Seat 2: the_wickstar ($1.46 in chips)=20
Seat 3: wrb1011 ($1.46 in chips)=20
Seat 4: 11CarlBluesy ($0.78 in chips)=20
Seat 5: Dusch799 ($1.99 in chips)=20
Seat 6: yjqian23 ($1.90 in chips)=20
Seat 7: IgaMoL ($2 in chips)=20
Seat 8: voltes5588 ($1.88 in chips)=20
Seat 9: nemkefull ($2.42 in chips)=20
wrb1011: posts small blind $0.01
11CarlBluesy: posts big blind $0.02
*** HOLE CARDS ***
Dealt to the_wickstar [2h 3s]
Dusch799: folds=20
yjqian23: calls $0.02
IgaMoL: folds=20
voltes5588: folds=20
nemkefull: calls $0.02
Comra1d: folds=20
the_wickstar: folds=20
wrb1011: calls $0.01
11CarlBluesy: checks=20
*** FLOP *** [Qc Tc As]
wrb1011: checks=20
11CarlBluesy: checks=20
yjqian23: bets $0.02
nemkefull: calls $0.02
wrb1011: folds=20
11CarlBluesy: folds=20
*** TURN *** [Qc Tc As] [8c]
yjqian23: bets $0.02
nemkefull: calls $0.02
*** RIVER *** [Qc Tc As 8c] [7h]
yjqian23: bets $0.02
nemkefull: calls $0.02
*** SHOW DOWN ***
yjqian23: shows [Kh Qs] (a pair of Queens)
nemkefull: shows [Js Ad] (a pair of Aces)
nemkefull collected $0.19 from pot
*** SUMMARY ***
Total pot $0.20 | Rake $0.01=20
Board [Qc Tc As 8c 7h]
Seat 1: Comra1d folded before Flop (didn't bet)
Seat 2: the_wickstar (button) folded before Flop (didn't bet)
Seat 3: wrb1011 (small blind) folded on the Flop
Seat 4: 11CarlBluesy (big blind) folded on the Flop
Seat 5: Dusch799 folded before Flop (didn't bet)
Seat 6: yjqian23 showed [Kh Qs] and lost with a pair of Queens
Seat 7: IgaMoL folded before Flop (didn't bet)
Seat 8: voltes5588 folded before Flop (didn't bet)
Seat 9: nemkefull showed [Js Ad] and won ($0.19) with a pair of Aces


*********** # 50 **************
PokerStars Hand #169564761662:  Hold'em No Limit ($0.01/$0.02 USD) - 20=
17/04/26 10:51:36 CUST [2017/04/25 20:51:36 ET]
Table 'Baumeia II' 9-max Seat #3 is the button
Seat 1: hugoluis1983 ($2 in chips)=20
Seat 2: picky_1993 ($2.03 in chips)=20
Seat 3: K0rsar11 ($2.84 in chips)=20
Seat 5: the_wickstar ($1.04 in chips)=20
Seat 6: wernergaming ($2.51 in chips)=20
Seat 7: nemkefull ($2.82 in chips)=20
Seat 8: sirrender600 ($0.74 in chips)=20
Seat 9: Dusch799 ($1.98 in chips)=20
L3m0nN@tion will be allowed to play after the button
the_wickstar: posts small blind $0.01
wernergaming: posts big blind $0.02
*** HOLE CARDS ***
Dealt to the_wickstar [6d 7h]
nemkefull: folds=20
sirrender600: folds=20
sirrender600 leaves the table
Dusch799: raises $0.04 to $0.06
hugoluis1983: folds=20
picky_1993: folds=20
K0rsar11: folds=20
the_wickstar: folds=20
wernergaming: calls $0.04
*** FLOP *** [Ah Ks Jh]
wernergaming: checks=20
Dusch799: checks=20
*** TURN *** [Ah Ks Jh] [3h]
wernergaming: checks=20
Dusch799: checks=20
*** RIVER *** [Ah Ks Jh 3h] [Qc]
wernergaming: checks=20
Dusch799: checks=20
*** SHOW DOWN ***
wernergaming: shows [4s Ts] (a straight, Ten to Ace)
Dusch799: mucks hand=20
wernergaming collected $0.13 from pot
*** SUMMARY ***
Total pot $0.13 | Rake $0=20
Board [Ah Ks Jh 3h Qc]
Seat 1: hugoluis1983 folded before Flop (didn't bet)
Seat 2: picky_1993 folded before Flop (didn't bet)
Seat 3: K0rsar11 (button) folded before Flop (didn't bet)
Seat 5: the_wickstar (small blind) folded before Flop
Seat 6: wernergaming (big blind) showed [4s Ts] and won ($0.13) with a =
straight, Ten to Ace
Seat 7: nemkefull folded before Flop (didn't bet)
Seat 8: sirrender600 folded before Flop (didn't bet)
Seat 9: Dusch799 mucked [8h 8s]


*********** # 51 **************
PokerStars Hand #169564737518:  Hold'em No Limit ($0.01/$0.02 USD) - 20=
17/04/26 10:50:43 CUST [2017/04/25 20:50:43 ET]
Table 'Ehrdni' 9-max Seat #1 is the button
Seat 1: Comra1d ($2.02 in chips)=20
Seat 2: the_wickstar ($1.47 in chips)=20
Seat 3: wrb1011 ($1.48 in chips)=20
Seat 4: 11CarlBluesy ($0.78 in chips)=20
Seat 5: Dusch799 ($1.99 in chips)=20
Seat 6: yjqian23 ($1.87 in chips)=20
Seat 7: IgaMoL ($2 in chips)=20
Seat 8: voltes5588 ($1.88 in chips)=20
Seat 9: nemkefull ($2.42 in chips)=20
the_wickstar: posts small blind $0.01
wrb1011: posts big blind $0.02
*** HOLE CARDS ***
Dealt to the_wickstar [9s 3s]
11CarlBluesy: folds=20
Dusch799: folds=20
yjqian23: raises $0.04 to $0.06
IgaMoL: folds=20
voltes5588: folds=20
nemkefull: folds=20
Comra1d: folds=20
the_wickstar: folds=20
wrb1011: folds=20
Uncalled bet ($0.04) returned to yjqian23
yjqian23 collected $0.05 from pot
yjqian23: doesn't show hand=20
*** SUMMARY ***
Total pot $0.05 | Rake $0=20
Seat 1: Comra1d (button) folded before Flop (didn't bet)
Seat 2: the_wickstar (small blind) folded before Flop
Seat 3: wrb1011 (big blind) folded before Flop
Seat 4: 11CarlBluesy folded before Flop (didn't bet)
Seat 5: Dusch799 folded before Flop (didn't bet)
Seat 6: yjqian23 collected ($0.05)
Seat 7: IgaMoL folded before Flop (didn't bet)
Seat 8: voltes5588 folded before Flop (didn't bet)
Seat 9: nemkefull folded before Flop (didn't bet)


*********** # 52 **************
PokerStars Hand #169564721808:  Hold'em No Limit ($0.01/$0.02 USD) - 20=
17/04/26 10:50:07 CUST [2017/04/25 20:50:07 ET]
Table 'Baumeia II' 9-max Seat #2 is the button
Seat 1: hugoluis1983 ($2 in chips)=20
Seat 2: picky_1993 ($2.03 in chips)=20
Seat 3: K0rsar11 ($2.85 in chips)=20
Seat 5: the_wickstar ($1.06 in chips)=20
Seat 6: wernergaming ($2.51 in chips)=20
Seat 7: nemkefull ($2 in chips)=20
Seat 8: sirrender600 ($1.57 in chips)=20
Seat 9: Dusch799 ($2 in chips)=20
K0rsar11: posts small blind $0.01
the_wickstar: posts big blind $0.02
*** HOLE CARDS ***
Dealt to the_wickstar [Jd 7d]
wernergaming: folds=20
nemkefull: calls $0.02
sirrender600: calls $0.02
Dusch799: calls $0.02
hugoluis1983: folds=20
picky_1993: folds=20
K0rsar11: folds=20
the_wickstar: checks=20
*** FLOP *** [Th Ts 6s]
the_wickstar: checks=20
nemkefull: bets $0.06
sirrender600: calls $0.06
Dusch799: folds=20
the_wickstar: folds=20
*** TURN *** [Th Ts 6s] [5d]
nemkefull: bets $0.19
sirrender600: calls $0.19
*** RIVER *** [Th Ts 6s 5d] [Kd]
nemkefull: bets $0.56
sirrender600: calls $0.56
*** SHOW DOWN ***
nemkefull: shows [6d 6c] (a full house, Sixes full of Tens)
sirrender600: mucks hand=20
nemkefull collected $1.65 from pot
*** SUMMARY ***
Total pot $1.71 | Rake $0.06=20
Board [Th Ts 6s 5d Kd]
Seat 1: hugoluis1983 folded before Flop (didn't bet)
Seat 2: picky_1993 (button) folded before Flop (didn't bet)
Seat 3: K0rsar11 (small blind) folded before Flop
Seat 5: the_wickstar (big blind) folded on the Flop
Seat 6: wernergaming folded before Flop (didn't bet)
Seat 7: nemkefull showed [6d 6c] and won ($1.65) with a full house, Six=
es full of Tens
Seat 8: sirrender600 mucked [Ks Qs]
Seat 9: Dusch799 folded on the Flop


*********** # 53 **************
PokerStars Hand #169564702421:  Hold'em No Limit ($0.01/$0.02 USD) - 20=
17/04/26 10:49:25 CUST [2017/04/25 20:49:25 ET]
Table 'Ehrdni' 9-max Seat #9 is the button
Seat 1: Comra1d ($2.03 in chips)=20
Seat 2: the_wickstar ($1.35 in chips)=20
Seat 3: wrb1011 ($1.48 in chips)=20
Seat 4: 11CarlBluesy ($0.78 in chips)=20
Seat 5: Dusch799 ($1.99 in chips)=20
Seat 6: yjqian23 ($1.97 in chips)=20
Seat 7: IgaMoL ($2 in chips)=20
Seat 8: voltes5588 ($1.90 in chips)=20
Seat 9: nemkefull ($2.42 in chips)=20
Comra1d: posts small blind $0.01
the_wickstar: posts big blind $0.02
*** HOLE CARDS ***
Dealt to the_wickstar [8d Jc]
wrb1011: folds=20
11CarlBluesy: folds=20
Dusch799: folds=20
yjqian23: calls $0.02
IgaMoL: folds=20
voltes5588: calls $0.02
nemkefull: folds=20
Comra1d: folds=20
the_wickstar: checks=20
*** FLOP *** [3c 9h Qh]
the_wickstar: checks=20
yjqian23: checks=20
voltes5588: checks=20
*** TURN *** [3c 9h Qh] [Ts]
the_wickstar: bets $0.02
yjqian23: calls $0.02
voltes5588: folds=20
*** RIVER *** [3c 9h Qh Ts] [8c]
the_wickstar: bets $0.06
yjqian23: calls $0.06
*** SHOW DOWN ***
the_wickstar: shows [8d Jc] (a straight, Eight to Queen)
yjqian23: mucks hand=20
the_wickstar collected $0.22 from pot
*** SUMMARY ***
Total pot $0.23 | Rake $0.01=20
Board [3c 9h Qh Ts 8c]
Seat 1: Comra1d (small blind) folded before Flop
Seat 2: the_wickstar (big blind) showed [8d Jc] and won ($0.22) with a =
straight, Eight to Queen
Seat 3: wrb1011 folded before Flop (didn't bet)
Seat 4: 11CarlBluesy folded before Flop (didn't bet)
Seat 5: Dusch799 folded before Flop (didn't bet)
Seat 6: yjqian23 mucked [Ac Th]
Seat 7: IgaMoL folded before Flop (didn't bet)
Seat 8: voltes5588 folded on the Turn
Seat 9: nemkefull (button) folded before Flop (didn't bet)


*********** # 54 **************
PokerStars Hand #169564645312:  Hold'em No Limit ($0.01/$0.02 USD) - 20=
17/04/26 10:47:18 CUST [2017/04/25 20:47:18 ET]
Table 'Ehrdni' 9-max Seat #8 is the button
Seat 1: Comra1d ($2 in chips)=20
Seat 2: the_wickstar ($1.35 in chips)=20
Seat 3: wrb1011 ($1.48 in chips)=20
Seat 4: 11CarlBluesy ($0.80 in chips)=20
Seat 5: Dusch799 ($1.99 in chips)=20
Seat 6: yjqian23 ($1.97 in chips)=20
Seat 7: IgaMoL ($2 in chips)=20
Seat 8: voltes5588 ($1.90 in chips)=20
Seat 9: nemkefull ($2.43 in chips)=20
nemkefull: posts small blind $0.01
Comra1d: posts big blind $0.02
11CarlBluesy: posts big blind $0.02
*** HOLE CARDS ***
Dealt to the_wickstar [Kh 6s]
the_wickstar: folds=20
wrb1011: folds=20
11CarlBluesy: checks=20
Dusch799: folds=20
yjqian23: folds=20
IgaMoL: folds=20
voltes5588: folds=20
nemkefull: folds=20
Comra1d: checks=20
*** FLOP *** [9c 5c 9s]
Comra1d: checks=20
11CarlBluesy: checks=20
*** TURN *** [9c 5c 9s] [6c]
Comra1d: checks=20
11CarlBluesy: checks=20
*** RIVER *** [9c 5c 9s 6c] [Ad]
Comra1d: checks=20
11CarlBluesy: checks=20
*** SHOW DOWN ***
Comra1d: shows [7d 6h] (two pair, Nines and Sixes)
11CarlBluesy: mucks hand=20
Comra1d collected $0.05 from pot
*** SUMMARY ***
Total pot $0.05 | Rake $0=20
Board [9c 5c 9s 6c Ad]
Seat 1: Comra1d (big blind) showed [7d 6h] and won ($0.05) with two pai=
r, Nines and Sixes
Seat 2: the_wickstar folded before Flop (didn't bet)
Seat 3: wrb1011 folded before Flop (didn't bet)
Seat 4: 11CarlBluesy mucked [7c Jh]
Seat 5: Dusch799 folded before Flop (didn't bet)
Seat 6: yjqian23 folded before Flop (didn't bet)
Seat 7: IgaMoL folded before Flop (didn't bet)
Seat 8: voltes5588 (button) folded before Flop (didn't bet)
Seat 9: nemkefull (small blind) folded before Flop


*********** # 55 **************
PokerStars Hand #169564627470:  Hold'em No Limit ($0.01/$0.02 USD) - 20=
17/04/26 10:46:39 CUST [2017/04/25 20:46:39 ET]
Table 'Ehrdni' 9-max Seat #7 is the button
Seat 1: Comra1d ($2 in chips)=20
Seat 2: the_wickstar ($1.35 in chips)=20
Seat 3: wrb1011 ($1.48 in chips)=20
Seat 5: Dusch799 ($1.96 in chips)=20
Seat 6: yjqian23 ($1.97 in chips)=20
Seat 7: IgaMoL ($2 in chips)=20
Seat 8: voltes5588 ($1.91 in chips)=20
Seat 9: nemkefull ($2.45 in chips)=20
voltes5588: posts small blind $0.01
nemkefull: posts big blind $0.02
11CarlBluesy: sits out=20
*** HOLE CARDS ***
Dealt to the_wickstar [2h 7h]
Comra1d: folds=20
the_wickstar: folds=20
wrb1011: folds=20
Dusch799: raises $0.05 to $0.07
yjqian23: folds=20
IgaMoL: folds=20
voltes5588: folds=20
nemkefull: folds=20
Uncalled bet ($0.05) returned to Dusch799
Dusch799 collected $0.05 from pot
*** SUMMARY ***
Total pot $0.05 | Rake $0=20
Seat 1: Comra1d folded before Flop (didn't bet)
Seat 2: the_wickstar folded before Flop (didn't bet)
Seat 3: wrb1011 folded before Flop (didn't bet)
Seat 5: Dusch799 collected ($0.05)
Seat 6: yjqian23 folded before Flop (didn't bet)
Seat 7: IgaMoL (button) folded before Flop (didn't bet)
Seat 8: voltes5588 (small blind) folded before Flop
Seat 9: nemkefull (big blind) folded before Flop


*********** # 56 **************
PokerStars Hand #169564613118:  Hold'em No Limit ($0.01/$0.02 USD) - 20=
17/04/26 10:46:07 CUST [2017/04/25 20:46:07 ET]
Table 'Ehrdni' 9-max Seat #6 is the button
Seat 1: Comra1d ($2 in chips)=20
Seat 2: the_wickstar ($1.35 in chips)=20
Seat 3: wrb1011 ($1.48 in chips)=20
Seat 5: Dusch799 ($1.93 in chips)=20
Seat 6: yjqian23 ($1.97 in chips)=20
Seat 7: IgaMoL ($2 in chips)=20
Seat 8: voltes5588 ($1.93 in chips)=20
Seat 9: nemkefull ($2.45 in chips)=20
IgaMoL: posts small blind $0.01
voltes5588: posts big blind $0.02
11CarlBluesy: sits out=20
*** HOLE CARDS ***
Dealt to the_wickstar [6d 9c]
nemkefull: folds=20
Comra1d: folds=20
the_wickstar: folds=20
wrb1011: folds=20
Dusch799: raises $0.04 to $0.06
yjqian23: folds=20
IgaMoL: folds=20
voltes5588: folds=20
Uncalled bet ($0.04) returned to Dusch799
Dusch799 collected $0.05 from pot
*** SUMMARY ***
Total pot $0.05 | Rake $0=20
Seat 1: Comra1d folded before Flop (didn't bet)
Seat 2: the_wickstar folded before Flop (didn't bet)
Seat 3: wrb1011 folded before Flop (didn't bet)
Seat 5: Dusch799 collected ($0.05)
Seat 6: yjqian23 (button) folded before Flop (didn't bet)
Seat 7: IgaMoL (small blind) folded before Flop
Seat 8: voltes5588 (big blind) folded before Flop
Seat 9: nemkefull folded before Flop (didn't bet)


*********** # 57 **************
PokerStars Hand #169564570967:  Hold'em No Limit ($0.01/$0.02 USD) - 20=
17/04/26 10:44:55 CUST [2017/04/25 20:44:55 ET]
Table 'Ehrdni' 9-max Seat #5 is the button
Seat 1: Comra1d ($2 in chips)=20
Seat 2: the_wickstar ($1.30 in chips)=20
Seat 3: wrb1011 ($1.48 in chips)=20
Seat 5: Dusch799 ($1.95 in chips)=20
Seat 6: yjqian23 ($1.98 in chips)=20
Seat 7: IgaMoL ($2 in chips)=20
Seat 8: voltes5588 ($1.93 in chips)=20
Seat 9: nemkefull ($2.45 in chips)=20
yjqian23: posts small blind $0.01
IgaMoL: posts big blind $0.02
11CarlBluesy: sits out=20
*** HOLE CARDS ***
Dealt to the_wickstar [7h Kd]
voltes5588: folds=20
nemkefull: folds=20
Comra1d: folds=20
the_wickstar: calls $0.02
wrb1011: folds=20
Dusch799: calls $0.02
yjqian23: folds=20
IgaMoL: checks=20
*** FLOP *** [3s 9d As]
IgaMoL: checks=20
the_wickstar: bets $0.06
Dusch799: folds=20
IgaMoL: folds=20
Uncalled bet ($0.06) returned to the_wickstar
the_wickstar collected $0.07 from pot
*** SUMMARY ***
Total pot $0.07 | Rake $0=20
Board [3s 9d As]
Seat 1: Comra1d folded before Flop (didn't bet)
Seat 2: the_wickstar collected ($0.07)
Seat 3: wrb1011 folded before Flop (didn't bet)
Seat 5: Dusch799 (button) folded on the Flop
Seat 6: yjqian23 (small blind) folded before Flop
Seat 7: IgaMoL (big blind) folded on the Flop
Seat 8: voltes5588 folded before Flop (didn't bet)
Seat 9: nemkefull folded before Flop (didn't bet)


*********** # 58 **************
PokerStars Hand #169564547347:  Hold'em No Limit ($0.01/$0.02 USD) - 20=
17/04/26 10:44:04 CUST [2017/04/25 20:44:04 ET]
Table 'Ehrdni' 9-max Seat #3 is the button
Seat 1: Comra1d ($2 in chips)=20
Seat 2: the_wickstar ($1.30 in chips)=20
Seat 3: wrb1011 ($1.48 in chips)=20
Seat 5: Dusch799 ($1.96 in chips)=20
Seat 6: yjqian23 ($2 in chips)=20
Seat 7: IgaMoL ($2 in chips)=20
Seat 8: voltes5588 ($1.93 in chips)=20
Seat 9: nemkefull ($2.29 in chips)=20
11CarlBluesy will be allowed to play after the button
Dusch799: posts small blind $0.01
yjqian23: posts big blind $0.02
*** HOLE CARDS ***
Dealt to the_wickstar [Qd 7d]
IgaMoL: raises $0.04 to $0.06
voltes5588: folds=20
nemkefull: calls $0.06
Comra1d: folds=20
the_wickstar: folds=20
wrb1011: folds=20
Dusch799: folds=20
yjqian23: folds=20
*** FLOP *** [As Kd 5d]
IgaMoL: bets $0.08
nemkefull: calls $0.08
*** TURN *** [As Kd 5d] [Qh]
IgaMoL: checks=20
nemkefull: bets $0.16
IgaMoL: folds=20
Uncalled bet ($0.16) returned to nemkefull
nemkefull collected $0.30 from pot
nemkefull: doesn't show hand=20
*** SUMMARY ***
Total pot $0.31 | Rake $0.01=20
Board [As Kd 5d Qh]
Seat 1: Comra1d folded before Flop (didn't bet)
Seat 2: the_wickstar folded before Flop (didn't bet)
Seat 3: wrb1011 (button) folded before Flop (didn't bet)
Seat 5: Dusch799 (small blind) folded before Flop
Seat 6: yjqian23 (big blind) folded before Flop
Seat 7: IgaMoL folded on the Turn
Seat 8: voltes5588 folded before Flop (didn't bet)
Seat 9: nemkefull collected ($0.30)


*********** # 59 **************
PokerStars Hand #169564490937:  Hold'em No Limit ($0.01/$0.02 USD) - 20=
17/04/26 10:42:00 CUST [2017/04/25 20:42:00 ET]
Table 'Ehrdni' 9-max Seat #2 is the button
Seat 1: Comra1d ($2 in chips)=20
Seat 2: the_wickstar ($0.96 in chips)=20
Seat 3: wrb1011 ($1.56 in chips)=20
Seat 5: Dusch799 ($1.98 in chips)=20
Seat 7: IgaMoL ($2 in chips)=20
Seat 8: voltes5588 ($2.19 in chips)=20
Seat 9: nemkefull ($2.29 in chips)=20
wrb1011: posts small blind $0.01
Dusch799: posts big blind $0.02
yjqian23: sits out=20
*** HOLE CARDS ***
Dealt to the_wickstar [8s 9s]
IgaMoL: folds=20
voltes5588: calls $0.02
nemkefull: folds=20
Comra1d: folds=20
the_wickstar: calls $0.02
wrb1011: calls $0.01
Dusch799: checks=20
*** FLOP *** [5d Qh 9d]
wrb1011: bets $0.02
Dusch799: folds=20
voltes5588: calls $0.02
the_wickstar: raises $0.04 to $0.06
wrb1011: calls $0.04
voltes5588: calls $0.04
*** TURN *** [5d Qh 9d] [Js]
wrb1011: checks=20
voltes5588: checks=20
the_wickstar: bets $0.16
wrb1011: folds=20
voltes5588: calls $0.16
*** RIVER *** [5d Qh 9d Js] [9h]
11CarlBluesy joins the table at seat #4=20
voltes5588: bets $0.02
the_wickstar: raises $0.54 to $0.56
voltes5588: folds=20
Uncalled bet ($0.54) returned to the_wickstar
the_wickstar collected $0.60 from pot
*** SUMMARY ***
Total pot $0.62 | Rake $0.02=20
Board [5d Qh 9d Js 9h]
Seat 1: Comra1d folded before Flop (didn't bet)
Seat 2: the_wickstar (button) collected ($0.60)
Seat 3: wrb1011 (small blind) folded on the Turn
Seat 5: Dusch799 (big blind) folded on the Flop
Seat 7: IgaMoL folded before Flop (didn't bet)
Seat 8: voltes5588 folded on the River
Seat 9: nemkefull folded before Flop (didn't bet)


*********** # 60 **************
PokerStars Hand #169564466631:  Hold'em No Limit ($0.01/$0.02 USD) - 20=
17/04/26 10:41:10 CUST [2017/04/25 20:41:10 ET]
Table 'Ehrdni' 9-max Seat #1 is the button
Seat 1: Comra1d ($2 in chips)=20
Seat 2: the_wickstar ($0.90 in chips)=20
Seat 3: wrb1011 ($1.58 in chips)=20
Seat 4: picky_1993 ($0.65 in chips)=20
Seat 5: Dusch799 ($1.98 in chips)=20
Seat 7: IgaMoL ($2 in chips)=20
Seat 8: voltes5588 ($2.21 in chips)=20
Seat 9: nemkefull ($2.31 in chips)=20
the_wickstar: posts small blind $0.01
wrb1011: posts big blind $0.02
yjqian23: sits out=20
*** HOLE CARDS ***
Dealt to the_wickstar [6s 9s]
picky_1993: folds=20
Dusch799: folds=20
picky_1993 leaves the table
IgaMoL: folds=20
voltes5588: calls $0.02
nemkefull: calls $0.02
Comra1d: folds=20
the_wickstar: calls $0.01
wrb1011: checks=20
*** FLOP *** [9h 5d 4s]
the_wickstar: bets $0.06
wrb1011: folds=20
voltes5588: folds=20
nemkefull: folds=20
Uncalled bet ($0.06) returned to the_wickstar
the_wickstar collected $0.08 from pot
*** SUMMARY ***
Total pot $0.08 | Rake $0=20
Board [9h 5d 4s]
Seat 1: Comra1d (button) folded before Flop (didn't bet)
Seat 2: the_wickstar (small blind) collected ($0.08)
Seat 3: wrb1011 (big blind) folded on the Flop
Seat 4: picky_1993 folded before Flop (didn't bet)
Seat 5: Dusch799 folded before Flop (didn't bet)
Seat 7: IgaMoL folded before Flop (didn't bet)
Seat 8: voltes5588 folded on the Flop
Seat 9: nemkefull folded on the Flop


*********** # 61 **************
PokerStars Hand #169564417111:  Hold'em No Limit ($0.01/$0.02 USD) - 20=
17/04/26 10:39:24 CUST [2017/04/25 20:39:24 ET]
Table 'Ehrdni' 9-max Seat #9 is the button
Seat 1: Comra1d ($2 in chips)=20
Seat 2: the_wickstar ($1.06 in chips)=20
Seat 3: wrb1011 ($1.58 in chips)=20
Seat 4: picky_1993 ($0.65 in chips)=20
Seat 5: Dusch799 ($1.98 in chips)=20
Seat 6: winorwin333 ($1.07 in chips)=20
Seat 7: IgaMoL ($2.03 in chips)=20
Seat 8: voltes5588 ($2.21 in chips)=20
Seat 9: nemkefull ($2 in chips)=20
Comra1d: posts small blind $0.01
the_wickstar: posts big blind $0.02
*** HOLE CARDS ***
Dealt to the_wickstar [3s 3c]
wrb1011: folds=20
picky_1993: folds=20
Dusch799: folds=20
winorwin333: folds=20
IgaMoL: raises $0.04 to $0.06
voltes5588: folds=20
nemkefull: calls $0.06
winorwin333 leaves the table
Comra1d: folds=20
the_wickstar: calls $0.04
*** FLOP *** [9c 8s Jh]
yjqian23 joins the table at seat #6=20
the_wickstar: checks=20
IgaMoL: checks=20
nemkefull: checks=20
*** TURN *** [9c 8s Jh] [Ah]
the_wickstar: bets $0.10
IgaMoL: calls $0.10
nemkefull: raises $0.25 to $0.35
the_wickstar: folds=20
IgaMoL: folds=20
Uncalled bet ($0.25) returned to nemkefull
nemkefull collected $0.47 from pot
nemkefull: doesn't show hand=20
*** SUMMARY ***
Total pot $0.49 | Rake $0.02=20
Board [9c 8s Jh Ah]
Seat 1: Comra1d (small blind) folded before Flop
Seat 2: the_wickstar (big blind) folded on the Turn
Seat 3: wrb1011 folded before Flop (didn't bet)
Seat 4: picky_1993 folded before Flop (didn't bet)
Seat 5: Dusch799 folded before Flop (didn't bet)
Seat 6: winorwin333 folded before Flop (didn't bet)
Seat 7: IgaMoL folded on the Turn
Seat 8: voltes5588 folded before Flop (didn't bet)
Seat 9: nemkefull (button) collected ($0.47)


*********** # 62 **************
PokerStars Hand #169564193459:  Hold'em No Limit ($0.01/$0.02 USD) - 20=
17/04/26 10:31:26 CUST [2017/04/25 20:31:26 ET]
Table 'Ulrike' 9-max Seat #2 is the button
Seat 2: the_wickstar ($0.42 in chips)=20
Seat 5: Gabeleleu_np ($2.33 in chips)=20
Seat 9: MDS17 ($4.63 in chips)=20
oleg2783852 will be allowed to play after the button
Gabeleleu_np: posts small blind $0.01
MDS17: posts big blind $0.02
ELECTROZOR: sits out=20
*** HOLE CARDS ***
Dealt to the_wickstar [8d 4d]
the_wickstar: folds=20
the_wickstar leaves the table
Gabeleleu_np: calls $0.01
konex joins the table at seat #6=20
MDS17: checks=20
*** FLOP *** [7h Ks 5h]
Gabeleleu_np: bets $0.03
MDS17: folds=20
Uncalled bet ($0.03) returned to Gabeleleu_np
Gabeleleu_np collected $0.04 from pot
Gabeleleu_np: doesn't show hand=20
*** SUMMARY ***
Total pot $0.04 | Rake $0=20
Board [7h Ks 5h]
Seat 2: the_wickstar (button) folded before Flop (didn't bet)
Seat 5: Gabeleleu_np (small blind) collected ($0.04)
Seat 9: MDS17 (big blind) folded on the Flop


*********** # 63 **************
PokerStars Hand #169564172625:  Hold'em No Limit ($0.01/$0.02 USD) - 20=
17/04/26 10:30:41 CUST [2017/04/25 20:30:41 ET]
Table 'Ulrike' 9-max Seat #9 is the button
Seat 2: the_wickstar ($0.40 in chips)=20
Seat 5: Gabeleleu_np ($2.35 in chips)=20
Seat 7: creezy.by ($1.70 in chips)=20
Seat 9: MDS17 ($4.63 in chips)=20
the_wickstar: posts small blind $0.01
Gabeleleu_np: posts big blind $0.02
*** HOLE CARDS ***
Dealt to the_wickstar [Ac 7c]
creezy.by: folds=20
creezy.by leaves the table
MDS17: folds=20
the_wickstar: calls $0.01
oleg2783852 joins the table at seat #4=20
Gabeleleu_np: checks=20
*** FLOP *** [Ad Ah Kh]
the_wickstar: checks=20
Gabeleleu_np: checks=20
*** TURN *** [Ad Ah Kh] [6s]
the_wickstar: bets $0.02
Gabeleleu_np: folds=20
Uncalled bet ($0.02) returned to the_wickstar
the_wickstar collected $0.04 from pot
*** SUMMARY ***
Total pot $0.04 | Rake $0=20
Board [Ad Ah Kh 6s]
Seat 2: the_wickstar (small blind) collected ($0.04)
Seat 5: Gabeleleu_np (big blind) folded on the Turn
Seat 7: creezy.by folded before Flop (didn't bet)
Seat 9: MDS17 (button) folded before Flop (didn't bet)


*********** # 64 **************
PokerStars Hand #169564154421:  Hold'em No Limit ($0.01/$0.02 USD) - 20=
17/04/26 10:30:03 CUST [2017/04/25 20:30:03 ET]
Table 'Irus' 9-max Seat #5 is the button
Seat 3: papin1988 ($2.03 in chips)=20
Seat 4: the_wickstar ($1.35 in chips)=20
Seat 5: Adashko#1 ($2.37 in chips)=20
Seat 9: reivaj491 ($2 in chips)=20
reivaj491: posts small blind $0.01
hard nutss: is sitting out=20
papin1988: posts big blind $0.02
*** HOLE CARDS ***
Dealt to the_wickstar [Qc 2c]
hard nutss leaves the table
the_wickstar: folds=20
Adashko#1: folds=20
the_wickstar leaves the table
reivaj491: raises $0.03 to $0.05
papin1988: folds=20
Uncalled bet ($0.03) returned to reivaj491
reivaj491 collected $0.04 from pot
reivaj491: doesn't show hand=20
*** SUMMARY ***
Total pot $0.04 | Rake $0=20
Seat 3: papin1988 (big blind) folded before Flop
Seat 4: the_wickstar folded before Flop (didn't bet)
Seat 5: Adashko#1 (button) folded before Flop (didn't bet)
Seat 9: reivaj491 (small blind) collected ($0.04)


*********** # 65 **************
PokerStars Hand #169564143227:  Hold'em No Limit ($0.01/$0.02 USD) - 20=
17/04/26 10:29:40 CUST [2017/04/25 20:29:40 ET]
Table 'Irus' 9-max Seat #4 is the button
Seat 1: hard nutss ($2.28 in chips)=20
Seat 3: papin1988 ($2 in chips)=20
Seat 4: the_wickstar ($1.35 in chips)=20
Seat 5: Adashko#1 ($2.38 in chips)=20
Seat 6: konex ($1.61 in chips)=20
Seat 9: reivaj491 ($2 in chips)=20
Adashko#1: posts small blind $0.01
konex: posts big blind $0.02
*** HOLE CARDS ***
Dealt to the_wickstar [3h Jd]
reivaj491: folds=20
hard nutss: folds=20
papin1988: raises $0.04 to $0.06
the_wickstar: folds=20
Adashko#1: folds=20
konex: folds=20
Uncalled bet ($0.04) returned to papin1988
konex leaves the table
papin1988 collected $0.05 from pot
*** SUMMARY ***
Total pot $0.05 | Rake $0=20
Seat 1: hard nutss folded before Flop (didn't bet)
Seat 3: papin1988 collected ($0.05)
Seat 4: the_wickstar (button) folded before Flop (didn't bet)
Seat 5: Adashko#1 (small blind) folded before Flop
Seat 6: konex (big blind) folded before Flop
Seat 9: reivaj491 folded before Flop (didn't bet)


*********** # 66 **************
PokerStars Hand #169564138235:  Hold'em No Limit ($0.01/$0.02 USD) - 20=
17/04/26 10:29:29 CUST [2017/04/25 20:29:29 ET]
Table 'Ulrike' 9-max Seat #7 is the button
Seat 2: the_wickstar ($0.45 in chips)=20
Seat 3: Comra1d ($2 in chips)=20
Seat 5: Gabeleleu_np ($2.20 in chips)=20
Seat 7: creezy.by ($1.75 in chips)=20
Seat 9: MDS17 ($4.64 in chips)=20
TJAbram has timed out while being disconnected
TJAbram: is sitting out=20
MDS17: posts small blind $0.01
the_wickstar: posts big blind $0.02
*** HOLE CARDS ***
Dealt to the_wickstar [Tc 5d]
Comra1d: raises $0.03 to $0.05
Gabeleleu_np: calls $0.05
creezy.by: calls $0.05
MDS17: folds=20
TJAbram leaves the table
the_wickstar: calls $0.03
*** FLOP *** [3d 7c 4s]
the_wickstar: checks=20
Comra1d: checks=20
Gabeleleu_np: bets $0.16
creezy.by: folds=20
the_wickstar: folds=20
Comra1d: folds=20
Uncalled bet ($0.16) returned to Gabeleleu_np
Comra1d leaves the table
Gabeleleu_np collected $0.20 from pot
*** SUMMARY ***
Total pot $0.21 | Rake $0.01=20
Board [3d 7c 4s]
Seat 2: the_wickstar (big blind) folded on the Flop
Seat 3: Comra1d folded on the Flop
Seat 5: Gabeleleu_np collected ($0.20)
Seat 7: creezy.by (button) folded on the Flop
Seat 9: MDS17 (small blind) folded before Flop


*********** # 67 **************
PokerStars Hand #169564121141:  Hold'em No Limit ($0.01/$0.02 USD) - 20=
17/04/26 10:28:54 CUST [2017/04/25 20:28:54 ET]
Table 'Ulrike' 9-max Seat #5 is the button
Seat 2: the_wickstar ($0.45 in chips)=20
Seat 3: Comra1d ($2 in chips)=20
Seat 5: Gabeleleu_np ($2.17 in chips)=20
Seat 7: creezy.by ($1.76 in chips)=20
Seat 8: TJAbram ($0.75 in chips)=20
Seat 9: MDS17 ($4.64 in chips)=20
creezy.by: posts small blind $0.01
TJAbram: posts big blind $0.02
*** HOLE CARDS ***
Dealt to the_wickstar [Jh 5s]
MDS17: folds=20
the_wickstar: folds=20
Comra1d: folds=20
Gabeleleu_np: raises $0.04 to $0.06
creezy.by: folds=20
TJAbram: folds=20
Uncalled bet ($0.04) returned to Gabeleleu_np
Gabeleleu_np collected $0.05 from pot
Gabeleleu_np: doesn't show hand=20
*** SUMMARY ***
Total pot $0.05 | Rake $0=20
Seat 2: the_wickstar folded before Flop (didn't bet)
Seat 3: Comra1d folded before Flop (didn't bet)
Seat 5: Gabeleleu_np (button) collected ($0.05)
Seat 7: creezy.by (small blind) folded before Flop
Seat 8: TJAbram (big blind) folded before Flop
Seat 9: MDS17 folded before Flop (didn't bet)


*********** # 68 **************
PokerStars Hand #169564113078:  Hold'em No Limit ($0.01/$0.02 USD) - 20=
17/04/26 10:28:37 CUST [2017/04/25 20:28:37 ET]
Table 'Irus' 9-max Seat #3 is the button
Seat 1: hard nutss ($2.28 in chips)=20
Seat 2: FuriousCards ($0.54 in chips)=20
Seat 3: papin1988 ($2 in chips)=20
Seat 4: the_wickstar ($1.36 in chips)=20
Seat 5: Adashko#1 ($2.40 in chips)=20
Seat 6: konex ($1.58 in chips)=20
Seat 9: reivaj491 ($2 in chips)=20
the_wickstar: posts small blind $0.01
Adashko#1: posts big blind $0.02
*** HOLE CARDS ***
Dealt to the_wickstar [9h 4h]
konex: raises $0.05 to $0.07
reivaj491: folds=20
hard nutss: folds=20
FuriousCards: folds=20
FuriousCards leaves the table
papin1988: folds=20
the_wickstar: folds=20
Adashko#1: folds=20
Uncalled bet ($0.05) returned to konex
konex collected $0.05 from pot
*** SUMMARY ***
Total pot $0.05 | Rake $0=20
Seat 1: hard nutss folded before Flop (didn't bet)
Seat 2: FuriousCards folded before Flop (didn't bet)
Seat 3: papin1988 (button) folded before Flop (didn't bet)
Seat 4: the_wickstar (small blind) folded before Flop
Seat 5: Adashko#1 (big blind) folded before Flop
Seat 6: konex collected ($0.05)
Seat 9: reivaj491 folded before Flop (didn't bet)


*********** # 69 **************
PokerStars Hand #169564068443:  Hold'em No Limit ($0.01/$0.02 USD) - 20=
17/04/26 10:27:03 CUST [2017/04/25 20:27:03 ET]
Table 'Ulrike' 9-max Seat #3 is the button
Seat 2: the_wickstar ($0.93 in chips)=20
Seat 3: Comra1d ($2 in chips)=20
Seat 5: Gabeleleu_np ($1.26 in chips)=20
Seat 7: creezy.by ($2.24 in chips)=20
Seat 8: TJAbram ($0.75 in chips)=20
Seat 9: MDS17 ($4.64 in chips)=20
Gabeleleu_np: posts small blind $0.01
creezy.by: posts big blind $0.02
*** HOLE CARDS ***
Dealt to the_wickstar [Ad 5d]
TJAbram is disconnected=20
TJAbram has timed out while disconnected
TJAbram: folds=20
MDS17: folds=20
the_wickstar: calls $0.02
Comra1d: folds=20
Gabeleleu_np: calls $0.01
creezy.by: checks=20
*** FLOP *** [5h 3c 4c]
Gabeleleu_np: checks=20
creezy.by: checks=20
the_wickstar: bets $0.03
Gabeleleu_np: calls $0.03
creezy.by: calls $0.03
*** TURN *** [5h 3c 4c] [2d]
Gabeleleu_np: checks=20
creezy.by: checks=20
TJAbram is disconnected=20
the_wickstar: bets $0.07
Gabeleleu_np: calls $0.07
creezy.by: calls $0.07
*** RIVER *** [5h 3c 4c 2d] [5s]
Gabeleleu_np: checks=20
creezy.by: bets $0.18
the_wickstar: raises $0.18 to $0.36
Gabeleleu_np: calls $0.36
creezy.by: calls $0.18
*** SHOW DOWN ***
the_wickstar: shows [Ad 5d] (a straight, Ace to Five)
Gabeleleu_np: shows [6s 4d] (a straight, Deuce to Six)
creezy.by: mucks hand=20
Gabeleleu_np collected $1.39 from pot
*** SUMMARY ***
Total pot $1.44 | Rake $0.05=20
Board [5h 3c 4c 2d 5s]
Seat 2: the_wickstar showed [Ad 5d] and lost with a straight, Ace to Fi=
ve
Seat 3: Comra1d (button) folded before Flop (didn't bet)
Seat 5: Gabeleleu_np (small blind) showed [6s 4d] and won ($1.39) with =
a straight, Deuce to Six
Seat 7: creezy.by (big blind) mucked [4s As]
Seat 8: TJAbram folded before Flop (didn't bet)
Seat 9: MDS17 folded before Flop (didn't bet)


*********** # 70 **************
PokerStars Hand #169564055722:  Hold'em No Limit ($0.01/$0.02 USD) - 20=
17/04/26 10:26:37 CUST [2017/04/25 20:26:37 ET]
Table 'Irus' 9-max Seat #2 is the button
Seat 1: hard nutss ($2.28 in chips)=20
Seat 2: FuriousCards ($0.54 in chips)=20
Seat 3: papin1988 ($2 in chips)=20
Seat 4: the_wickstar ($1.38 in chips)=20
Seat 5: Adashko#1 ($2 in chips)=20
Seat 6: konex ($1.98 in chips)=20
Seat 7: shunysun68 ($4.67 in chips)=20
Seat 9: reivaj491 ($2 in chips)=20
papin1988: posts small blind $0.01
the_wickstar: posts big blind $0.02
*** HOLE CARDS ***
Dealt to the_wickstar [Jc Tc]
Adashko#1: raises $0.04 to $0.06
konex: raises $0.10 to $0.16
shunysun68: folds=20
shunysun68 leaves the table
reivaj491: folds=20
hard nutss: folds=20
FuriousCards: folds=20
papin1988: folds=20
the_wickstar: folds=20
Adashko#1: raises $0.24 to $0.40
konex: calls $0.24
*** FLOP *** [As 4s 6h]
Adashko#1: checks=20
konex: checks=20
*** TURN *** [As 4s 6h] [9c]
Adashko#1: checks=20
konex: checks=20
*** RIVER *** [As 4s 6h 9c] [Jh]
Adashko#1: checks=20
konex: checks=20
*** SHOW DOWN ***
Adashko#1: shows [Th Ad] (a pair of Aces)
konex: mucks hand=20
Adashko#1 collected $0.80 from pot
*** SUMMARY ***
Total pot $0.83 | Rake $0.03=20
Board [As 4s 6h 9c Jh]
Seat 1: hard nutss folded before Flop (didn't bet)
Seat 2: FuriousCards (button) folded before Flop (didn't bet)
Seat 3: papin1988 (small blind) folded before Flop
Seat 4: the_wickstar (big blind) folded before Flop
Seat 5: Adashko#1 showed [Th Ad] and won ($0.80) with a pair of Aces
Seat 6: konex mucked [Qd Qs]
Seat 7: shunysun68 folded before Flop (didn't bet)
Seat 9: reivaj491 folded before Flop (didn't bet)


*********** # 71 **************
PokerStars Hand #169564047340:  Hold'em No Limit ($0.01/$0.02 USD) - 20=
17/04/26 10:26:19 CUST [2017/04/25 20:26:19 ET]
Table 'Ulrike' 9-max Seat #2 is the button
Seat 2: the_wickstar ($0.93 in chips)=20
Seat 3: Comra1d ($2 in chips)=20
Seat 5: Gabeleleu_np ($1.28 in chips)=20
Seat 6: hashex ($2 in chips)=20
Seat 7: creezy.by ($2.21 in chips)=20
Seat 8: TJAbram ($0.75 in chips)=20
Seat 9: MDS17 ($4.64 in chips)=20
Comra1d: posts small blind $0.01
Gabeleleu_np: posts big blind $0.02
*** HOLE CARDS ***
Dealt to the_wickstar [7h Ac]
hashex: folds=20
creezy.by: raises $0.04 to $0.06
TJAbram: folds=20
hashex leaves the table
MDS17: folds=20
the_wickstar: folds=20
Comra1d: folds=20
Gabeleleu_np: folds=20
Uncalled bet ($0.04) returned to creezy.by
creezy.by collected $0.05 from pot
*** SUMMARY ***
Total pot $0.05 | Rake $0=20
Seat 2: the_wickstar (button) folded before Flop (didn't bet)
Seat 3: Comra1d (small blind) folded before Flop
Seat 5: Gabeleleu_np (big blind) folded before Flop
Seat 6: hashex folded before Flop (didn't bet)
Seat 7: creezy.by collected ($0.05)
Seat 8: TJAbram folded before Flop (didn't bet)
Seat 9: MDS17 folded before Flop (didn't bet)


*********** # 72 **************
PokerStars Hand #169564026834:  Hold'em No Limit ($0.01/$0.02 USD) - 20=
17/04/26 10:25:36 CUST [2017/04/25 20:25:36 ET]
Table 'Irus' 9-max Seat #1 is the button
Seat 1: hard nutss ($2.28 in chips)=20
Seat 2: FuriousCards ($0.55 in chips)=20
Seat 3: papin1988 ($2 in chips)=20
Seat 4: the_wickstar ($1.51 in chips)=20
Seat 5: Adashko#1 ($2 in chips)=20
Seat 6: konex ($1.98 in chips)=20
Seat 7: shunysun68 ($4.52 in chips)=20
Seat 9: reivaj491 ($2 in chips)=20
FuriousCards: posts small blind $0.01
papin1988: posts big blind $0.02
*** HOLE CARDS ***
Dealt to the_wickstar [Kh Kd]
the_wickstar: raises $0.04 to $0.06
Adashko#1: folds=20
konex: folds=20
shunysun68: calls $0.06
reivaj491: folds=20
yjqian23 leaves the table
hard nutss: folds=20
FuriousCards: folds=20
papin1988: folds=20
*** FLOP *** [Qc Ah 2h]
the_wickstar: bets $0.07
shunysun68: raises $0.28 to $0.35
the_wickstar: folds=20
Uncalled bet ($0.28) returned to shunysun68
shunysun68 collected $0.28 from pot
*** SUMMARY ***
Total pot $0.29 | Rake $0.01=20
Board [Qc Ah 2h]
Seat 1: hard nutss (button) folded before Flop (didn't bet)
Seat 2: FuriousCards (small blind) folded before Flop
Seat 3: papin1988 (big blind) folded before Flop
Seat 4: the_wickstar folded on the Flop
Seat 5: Adashko#1 folded before Flop (didn't bet)
Seat 6: konex folded before Flop (didn't bet)
Seat 7: shunysun68 collected ($0.28)
Seat 9: reivaj491 folded before Flop (didn't bet)


*********** # 73 **************
PokerStars Hand #169563998579:  Hold'em No Limit ($0.01/$0.02 USD) - 20=
17/04/26 10:24:37 CUST [2017/04/25 20:24:37 ET]
Table 'Irus' 9-max Seat #9 is the button
Seat 1: hard nutss ($2.29 in chips)=20
Seat 2: FuriousCards ($0.57 in chips)=20
Seat 3: papin1988 ($2.07 in chips)=20
Seat 4: the_wickstar ($1.51 in chips)=20
Seat 5: Adashko#1 ($2 in chips)=20
Seat 6: konex ($1.98 in chips)=20
Seat 7: shunysun68 ($1.48 in chips)=20
Seat 8: yjqian23 ($1.97 in chips)=20
Seat 9: reivaj491 ($2 in chips)=20
hard nutss: posts small blind $0.01
FuriousCards: posts big blind $0.02
*** HOLE CARDS ***
Dealt to the_wickstar [Jh 8s]
papin1988: calls $0.02
the_wickstar: folds=20
Adashko#1: calls $0.02
konex: folds=20
shunysun68: raises $0.02 to $0.04
yjqian23: calls $0.04
reivaj491: folds=20
hard nutss: folds=20
FuriousCards: folds=20
papin1988: raises $0.17 to $0.21
Adashko#1: calls $0.19
shunysun68: calls $0.17
yjqian23: calls $0.17
*** FLOP *** [Td Jd 3h]
papin1988: bets $1.86 and is all-in
Adashko#1: folds=20
shunysun68: calls $1.27 and is all-in
yjqian23: calls $1.76 and is all-in
Uncalled bet ($0.10) returned to papin1988
*** TURN *** [Td Jd 3h] [2d]
*** RIVER *** [Td Jd 3h 2d] [9c]
*** SHOW DOWN ***
papin1988: shows [Kh Ks] (a pair of Kings)
yjqian23: shows [Qd Qh] (a pair of Queens)
papin1988 collected $0.94 from side pot
shunysun68: shows [7d Ad] (a flush, Ace high)
shunysun68 collected $4.52 from main pot
*** SUMMARY ***
Total pot $5.66 Main pot $4.52. Side pot $0.94. | Rake $0.20=20
Board [Td Jd 3h 2d 9c]
Seat 1: hard nutss (small blind) folded before Flop
Seat 2: FuriousCards (big blind) folded before Flop
Seat 3: papin1988 showed [Kh Ks] and won ($0.94) with a pair of Kings
Seat 4: the_wickstar folded before Flop (didn't bet)
Seat 5: Adashko#1 folded on the Flop
Seat 6: konex folded before Flop (didn't bet)
Seat 7: shunysun68 showed [7d Ad] and won ($4.52) with a flush, Ace high
Seat 8: yjqian23 showed [Qd Qh] and lost with a pair of Queens
Seat 9: reivaj491 (button) folded before Flop (didn't bet)


*********** # 74 **************
PokerStars Hand #169563988546:  Hold'em No Limit ($0.01/$0.02 USD) - 20=
17/04/26 10:24:16 CUST [2017/04/25 20:24:16 ET]
Table 'Ulrike' 9-max Seat #9 is the button
Seat 1: ELECTROZOR ($2 in chips)=20
Seat 2: the_wickstar ($0.95 in chips)=20
Seat 3: Comra1d ($2 in chips)=20
Seat 5: Gabeleleu_np ($1.60 in chips)=20
Seat 6: hashex ($2 in chips)=20
Seat 7: creezy.by ($2.21 in chips)=20
Seat 8: TJAbram ($0.78 in chips)=20
Seat 9: MDS17 ($4.28 in chips)=20
ELECTROZOR: posts small blind $0.01
the_wickstar: posts big blind $0.02
bubamix: sits out=20
TJAbram: posts small & big blinds $0.03
*** HOLE CARDS ***
Dealt to the_wickstar [7d 3c]
Comra1d: folds=20
Gabeleleu_np: raises $0.04 to $0.06
hashex: folds=20
creezy.by: folds=20
TJAbram: folds=20
MDS17: calls $0.06
bubamix leaves the table
ELECTROZOR has timed out
ELECTROZOR: folds=20
the_wickstar: folds=20
*** FLOP *** [Ts 5c Ks]
Gabeleleu_np: bets $0.08
MDS17: calls $0.08
*** TURN *** [Ts 5c Ks] [9s]
Gabeleleu_np: bets $0.18
MDS17: raises $3.96 to $4.14 and is all-in
Gabeleleu_np: folds=20
Uncalled bet ($3.96) returned to MDS17
MDS17 collected $0.68 from pot
*** SUMMARY ***
Total pot $0.70 | Rake $0.02=20
Board [Ts 5c Ks 9s]
Seat 1: ELECTROZOR (small blind) folded before Flop
Seat 2: the_wickstar (big blind) folded before Flop
Seat 3: Comra1d folded before Flop (didn't bet)
Seat 5: Gabeleleu_np folded on the Turn
Seat 6: hashex folded before Flop (didn't bet)
Seat 7: creezy.by folded before Flop (didn't bet)
Seat 8: TJAbram folded before Flop
Seat 9: MDS17 (button) collected ($0.68)


*********** # 75 **************
PokerStars Hand #169563970339:  Hold'em No Limit ($0.01/$0.02 USD) - 20=
17/04/26 10:23:39 CUST [2017/04/25 20:23:39 ET]
Table 'Irus' 9-max Seat #8 is the button
Seat 1: hard nutss ($2.36 in chips)=20
Seat 2: FuriousCards ($0.57 in chips)=20
Seat 3: papin1988 ($2.07 in chips)=20
Seat 4: the_wickstar ($1.51 in chips)=20
Seat 5: Adashko#1 ($2 in chips)=20
Seat 6: konex ($1.98 in chips)=20
Seat 7: shunysun68 ($1.41 in chips)=20
Seat 8: yjqian23 ($1.97 in chips)=20
Seat 9: reivaj491 ($2 in chips)=20
reivaj491: posts small blind $0.01
hard nutss: posts big blind $0.02
*** HOLE CARDS ***
Dealt to the_wickstar [6h Ad]
FuriousCards: folds=20
papin1988: folds=20
the_wickstar: folds=20
Adashko#1: folds=20
konex: folds=20
shunysun68: raises $0.05 to $0.07
yjqian23: folds=20
reivaj491: folds=20
hard nutss: calls $0.05
*** FLOP *** [Ac 3s 2s]
hard nutss: checks=20
shunysun68: bets $0.06
hard nutss: folds=20
Uncalled bet ($0.06) returned to shunysun68
shunysun68 collected $0.14 from pot
*** SUMMARY ***
Total pot $0.15 | Rake $0.01=20
Board [Ac 3s 2s]
Seat 1: hard nutss (big blind) folded on the Flop
Seat 2: FuriousCards folded before Flop (didn't bet)
Seat 3: papin1988 folded before Flop (didn't bet)
Seat 4: the_wickstar folded before Flop (didn't bet)
Seat 5: Adashko#1 folded before Flop (didn't bet)
Seat 6: konex folded before Flop (didn't bet)
Seat 7: shunysun68 collected ($0.14)
Seat 8: yjqian23 (button) folded before Flop (didn't bet)
Seat 9: reivaj491 (small blind) folded before Flop


*********** # 76 **************
PokerStars Hand #169563958265:  Hold'em No Limit ($0.01/$0.02 USD) - 20=
17/04/26 10:23:14 CUST [2017/04/25 20:23:14 ET]
Table 'Ulrike' 9-max Seat #7 is the button
Seat 1: ELECTROZOR ($2 in chips)=20
Seat 2: the_wickstar ($0.97 in chips)=20
Seat 3: Comra1d ($2 in chips)=20
Seat 5: Gabeleleu_np ($1.60 in chips)=20
Seat 6: hashex ($2 in chips)=20
Seat 7: creezy.by ($2.21 in chips)=20
Seat 9: MDS17 ($4.24 in chips)=20
TJAbram will be allowed to play after the button
MDS17: posts small blind $0.01
ELECTROZOR: posts big blind $0.02
bubamix: sits out=20
*** HOLE CARDS ***
Dealt to the_wickstar [Ac Qs]
the_wickstar: calls $0.02
Comra1d: folds=20
Gabeleleu_np: folds=20
hashex: folds=20
creezy.by: folds=20
MDS17: calls $0.01
ELECTROZOR: checks=20
*** FLOP *** [Js 3d 6d]
MDS17: bets $0.06
ELECTROZOR: folds=20
the_wickstar: folds=20
Uncalled bet ($0.06) returned to MDS17
MDS17 collected $0.06 from pot
*** SUMMARY ***
Total pot $0.06 | Rake $0=20
Board [Js 3d 6d]
Seat 1: ELECTROZOR (big blind) folded on the Flop
Seat 2: the_wickstar folded on the Flop
Seat 3: Comra1d folded before Flop (didn't bet)
Seat 5: Gabeleleu_np folded before Flop (didn't bet)
Seat 6: hashex folded before Flop (didn't bet)
Seat 7: creezy.by (button) folded before Flop (didn't bet)
Seat 9: MDS17 (small blind) collected ($0.06)


*********** # 77 **************
PokerStars Hand #169563949184:  Hold'em No Limit ($0.01/$0.02 USD) - 20=
17/04/26 10:22:55 CUST [2017/04/25 20:22:55 ET]
Table 'Irus' 9-max Seat #7 is the button
Seat 1: hard nutss ($2.42 in chips)=20
Seat 2: FuriousCards ($0.57 in chips)=20
Seat 3: papin1988 ($2.07 in chips)=20
Seat 4: the_wickstar ($1.51 in chips)=20
Seat 5: Adashko#1 ($2 in chips)=20
Seat 6: konex ($1.98 in chips)=20
Seat 7: shunysun68 ($1.33 in chips)=20
Seat 8: yjqian23 ($1.98 in chips)=20
Seat 9: reivaj491 ($2 in chips)=20
yjqian23: posts small blind $0.01
reivaj491: posts big blind $0.02
*** HOLE CARDS ***
Dealt to the_wickstar [6s 3c]
hard nutss: raises $0.04 to $0.06
FuriousCards: folds=20
papin1988: folds=20
the_wickstar: folds=20
Adashko#1: folds=20
konex: folds=20
shunysun68: calls $0.06
yjqian23: folds=20
reivaj491: folds=20
*** FLOP *** [8c 9s 5c]
hard nutss: checks=20
shunysun68: bets $0.07
hard nutss: folds=20
Uncalled bet ($0.07) returned to shunysun68
shunysun68 collected $0.14 from pot
*** SUMMARY ***
Total pot $0.15 | Rake $0.01=20
Board [8c 9s 5c]
Seat 1: hard nutss folded on the Flop
Seat 2: FuriousCards folded before Flop (didn't bet)
Seat 3: papin1988 folded before Flop (didn't bet)
Seat 4: the_wickstar folded before Flop (didn't bet)
Seat 5: Adashko#1 folded before Flop (didn't bet)
Seat 6: konex folded before Flop (didn't bet)
Seat 7: shunysun68 (button) collected ($0.14)
Seat 8: yjqian23 (small blind) folded before Flop
Seat 9: reivaj491 (big blind) folded before Flop


*********** # 78 **************
PokerStars Hand #169563920673:  Hold'em No Limit ($0.01/$0.02 USD) - 20=
17/04/26 10:21:57 CUST [2017/04/25 20:21:57 ET]
Table 'Irus' 9-max Seat #6 is the button
Seat 1: hard nutss ($2.42 in chips)=20
Seat 2: FuriousCards ($0.59 in chips)=20
Seat 3: papin1988 ($2.07 in chips)=20
Seat 4: the_wickstar ($1.51 in chips)=20
Seat 5: Adashko#1 ($2 in chips)=20
Seat 6: konex ($2.06 in chips)=20
Seat 7: shunysun68 ($1.13 in chips)=20
Seat 8: yjqian23 ($2 in chips)=20
shunysun68: posts small blind $0.01
yjqian23: posts big blind $0.02
reivaj491: sits out=20
*** HOLE CARDS ***
Dealt to the_wickstar [Th 2c]
hard nutss: folds=20
FuriousCards: calls $0.02
papin1988: folds=20
the_wickstar: folds=20
Adashko#1: raises $0.06 to $0.08
konex: calls $0.08
shunysun68: raises $0.28 to $0.36
yjqian23: folds=20
FuriousCards: folds=20
Adashko#1: folds=20
konex: folds=20
Uncalled bet ($0.28) returned to shunysun68
shunysun68 collected $0.28 from pot
*** SUMMARY ***
Total pot $0.28 | Rake $0=20
Seat 1: hard nutss folded before Flop (didn't bet)
Seat 2: FuriousCards folded before Flop
Seat 3: papin1988 folded before Flop (didn't bet)
Seat 4: the_wickstar folded before Flop (didn't bet)
Seat 5: Adashko#1 folded before Flop
Seat 6: konex (button) folded before Flop
Seat 7: shunysun68 (small blind) collected ($0.28)
Seat 8: yjqian23 (big blind) folded before Flop


*********** # 79 **************
PokerStars Hand #169563910892:  Hold'em No Limit ($0.01/$0.02 USD) - 20=
17/04/26 10:21:36 CUST [2017/04/25 20:21:36 ET]
Table 'Ulrike' 9-max Seat #6 is the button
Seat 1: ELECTROZOR ($2.03 in chips)=20
Seat 2: the_wickstar ($0.97 in chips)=20
Seat 3: Comra1d ($2 in chips)=20
Seat 5: Gabeleleu_np ($1.94 in chips)=20
Seat 6: hashex ($2 in chips)=20
Seat 7: creezy.by ($1.78 in chips)=20
Seat 9: MDS17 ($4.30 in chips)=20
creezy.by: posts small blind $0.01
MDS17: posts big blind $0.02
bubamix: sits out=20
*** HOLE CARDS ***
Dealt to the_wickstar [Kd 4d]
ELECTROZOR: calls $0.02
the_wickstar: folds=20
Comra1d: folds=20
Gabeleleu_np: raises $0.04 to $0.06
hashex: folds=20
creezy.by: calls $0.05
MDS17: calls $0.04
ELECTROZOR: calls $0.04
*** FLOP *** [6h Qc 3d]
creezy.by: checks=20
MDS17: checks=20
ELECTROZOR: checks=20
Gabeleleu_np: bets $0.14
creezy.by: raises $0.14 to $0.28
MDS17: folds=20
ELECTROZOR: folds=20
Gabeleleu_np: calls $0.14
*** TURN *** [6h Qc 3d] [Js]
creezy.by: bets $0.38
Gabeleleu_np: folds=20
Uncalled bet ($0.38) returned to creezy.by
creezy.by collected $0.77 from pot
*** SUMMARY ***
Total pot $0.80 | Rake $0.03=20
Board [6h Qc 3d Js]
Seat 1: ELECTROZOR folded on the Flop
Seat 2: the_wickstar folded before Flop (didn't bet)
Seat 3: Comra1d folded before Flop (didn't bet)
Seat 5: Gabeleleu_np folded on the Turn
Seat 6: hashex (button) folded before Flop (didn't bet)
Seat 7: creezy.by (small blind) collected ($0.77)
Seat 9: MDS17 (big blind) folded on the Flop


*********** # 80 **************
PokerStars Hand #169563886195:  Hold'em No Limit ($0.01/$0.02 USD) - 20=
17/04/26 10:20:46 CUST [2017/04/25 20:20:46 ET]
Table 'Irus' 9-max Seat #5 is the button
Seat 1: hard nutss ($2.42 in chips)=20
Seat 2: FuriousCards ($0.59 in chips)=20
Seat 3: papin1988 ($2.07 in chips)=20
Seat 4: the_wickstar ($1.63 in chips)=20
Seat 5: Adashko#1 ($2 in chips)=20
Seat 6: konex ($2.08 in chips)=20
Seat 7: shunysun68 ($1 in chips)=20
konex: posts small blind $0.01
shunysun68: posts big blind $0.02
yjqian23: sits out=20
reivaj491: sits out=20
*** HOLE CARDS ***
Dealt to the_wickstar [Ts Qs]
hard nutss: folds=20
FuriousCards: folds=20
papin1988: folds=20
the_wickstar: calls $0.02
Adashko#1: folds=20
konex: calls $0.01
shunysun68: checks=20
*** FLOP *** [4d 2d 9h]
konex: checks=20
shunysun68: bets $0.02
the_wickstar: calls $0.02
konex: folds=20
*** TURN *** [4d 2d 9h] [4s]
shunysun68: checks=20
the_wickstar: bets $0.08
shunysun68: calls $0.08
*** RIVER *** [4d 2d 9h 4s] [4h]
shunysun68: bets $0.25
the_wickstar: folds=20
Uncalled bet ($0.25) returned to shunysun68
shunysun68 collected $0.25 from pot
*** SUMMARY ***
Total pot $0.26 | Rake $0.01=20
Board [4d 2d 9h 4s 4h]
Seat 1: hard nutss folded before Flop (didn't bet)
Seat 2: FuriousCards folded before Flop (didn't bet)
Seat 3: papin1988 folded before Flop (didn't bet)
Seat 4: the_wickstar folded on the River
Seat 5: Adashko#1 (button) folded before Flop (didn't bet)
Seat 6: konex (small blind) folded on the Flop
Seat 7: shunysun68 (big blind) collected ($0.25)


*********** # 81 **************
PokerStars Hand #169563868618:  Hold'em No Limit ($0.01/$0.02 USD) - 20=
17/04/26 10:20:10 CUST [2017/04/25 20:20:10 ET]
Table 'Ulrike' 9-max Seat #5 is the button
Seat 1: ELECTROZOR ($2.03 in chips)=20
Seat 2: the_wickstar ($0.97 in chips)=20
Seat 3: Comra1d ($2 in chips)=20
Seat 5: Gabeleleu_np ($1.94 in chips)=20
Seat 6: hashex ($2 in chips)=20
Seat 7: creezy.by ($1.75 in chips)=20
Seat 8: TJAbram ($0.78 in chips)=20
Seat 9: MDS17 ($4.32 in chips)=20
hashex: posts small blind $0.01
creezy.by: posts big blind $0.02
bubamix: sits out=20
*** HOLE CARDS ***
Dealt to the_wickstar [2s Qd]
TJAbram is disconnected=20
TJAbram has timed out while disconnected
TJAbram: folds=20
MDS17: calls $0.02
ELECTROZOR: folds=20
the_wickstar: folds=20
Comra1d: folds=20
Gabeleleu_np: folds=20
hashex: folds=20
creezy.by: checks=20
*** FLOP *** [3c 4h 9d]
creezy.by: bets $0.04
MDS17: folds=20
Uncalled bet ($0.04) returned to creezy.by
creezy.by collected $0.05 from pot
*** SUMMARY ***
Total pot $0.05 | Rake $0=20
Board [3c 4h 9d]
Seat 1: ELECTROZOR folded before Flop (didn't bet)
Seat 2: the_wickstar folded before Flop (didn't bet)
Seat 3: Comra1d folded before Flop (didn't bet)
Seat 5: Gabeleleu_np (button) folded before Flop (didn't bet)
Seat 6: hashex (small blind) folded before Flop
Seat 7: creezy.by (big blind) collected ($0.05)
Seat 8: TJAbram folded before Flop (didn't bet)
Seat 9: MDS17 folded on the Flop


*********** # 82 **************
PokerStars Hand #169563860826:  Hold'em No Limit ($0.01/$0.02 USD) - 20=
17/04/26 10:19:54 CUST [2017/04/25 20:19:54 ET]
Table 'Irus' 9-max Seat #4 is the button
Seat 1: hard nutss ($2.42 in chips)=20
Seat 2: FuriousCards ($0.59 in chips)=20
Seat 3: papin1988 ($2.07 in chips)=20
Seat 4: the_wickstar ($1.56 in chips)=20
Seat 5: Adashko#1 ($2 in chips)=20
Seat 6: konex ($2.14 in chips)=20
Seat 7: shunysun68 ($1 in chips)=20
Adashko#1: posts small blind $0.01
konex: posts big blind $0.02
yjqian23: sits out=20
reivaj491: sits out=20
*** HOLE CARDS ***
Dealt to the_wickstar [Td Kd]
shunysun68: folds=20
hard nutss: folds=20
FuriousCards: folds=20
papin1988: folds=20
the_wickstar: raises $0.04 to $0.06
Adashko#1: folds=20
konex: calls $0.04
*** FLOP *** [9c 4s 2h]
konex: checks=20
the_wickstar: bets $0.08
konex: folds=20
Uncalled bet ($0.08) returned to the_wickstar
the_wickstar collected $0.13 from pot
*** SUMMARY ***
Total pot $0.13 | Rake $0=20
Board [9c 4s 2h]
Seat 1: hard nutss folded before Flop (didn't bet)
Seat 2: FuriousCards folded before Flop (didn't bet)
Seat 3: papin1988 folded before Flop (didn't bet)
Seat 4: the_wickstar (button) collected ($0.13)
Seat 5: Adashko#1 (small blind) folded before Flop
Seat 6: konex (big blind) folded on the Flop
Seat 7: shunysun68 folded before Flop (didn't bet)


*********** # 83 **************
PokerStars Hand #169563816909:  Hold'em No Limit ($0.01/$0.02 USD) - 20=
17/04/26 10:18:25 CUST [2017/04/25 20:18:25 ET]
Table 'Ulrike' 9-max Seat #3 is the button
Seat 1: ELECTROZOR ($2.03 in chips)=20
Seat 2: the_wickstar ($1.05 in chips)=20
Seat 3: Comra1d ($2 in chips)=20
Seat 5: Gabeleleu_np ($1.96 in chips)=20
Seat 6: hashex ($2 in chips)=20
Seat 7: creezy.by ($1.75 in chips)=20
Seat 8: TJAbram ($0.78 in chips)=20
Seat 9: MDS17 ($4.21 in chips)=20
bubamix will be allowed to play after the button
Gabeleleu_np: posts small blind $0.01
hashex: posts big blind $0.02
*** HOLE CARDS ***
Dealt to the_wickstar [Ad 6h]
creezy.by: folds=20
TJAbram: folds=20
MDS17: calls $0.02
ELECTROZOR: folds=20
the_wickstar: calls $0.02
Comra1d: folds=20
Gabeleleu_np: calls $0.01
hashex: checks=20
*** FLOP *** [8h Js Th]
Gabeleleu_np: checks=20
hashex: checks=20
MDS17: checks=20
the_wickstar: bets $0.06
Gabeleleu_np: folds=20
hashex: folds=20
MDS17: calls $0.06
*** TURN *** [8h Js Th] [Qh]
MDS17: bets $0.19
the_wickstar: folds=20
Uncalled bet ($0.19) returned to MDS17
MDS17 collected $0.19 from pot
*** SUMMARY ***
Total pot $0.20 | Rake $0.01=20
Board [8h Js Th Qh]
Seat 1: ELECTROZOR folded before Flop (didn't bet)
Seat 2: the_wickstar folded on the Turn
Seat 3: Comra1d (button) folded before Flop (didn't bet)
Seat 5: Gabeleleu_np (small blind) folded on the Flop
Seat 6: hashex (big blind) folded on the Flop
Seat 7: creezy.by folded before Flop (didn't bet)
Seat 8: TJAbram folded before Flop (didn't bet)
Seat 9: MDS17 collected ($0.19)


*********** # 84 **************
PokerStars Hand #169563801895:  Hold'em No Limit ($0.01/$0.02 USD) - 20=
17/04/26 10:17:54 CUST [2017/04/25 20:17:54 ET]
Table 'Irus' 9-max Seat #3 is the button
Seat 1: hard nutss ($2.42 in chips)=20
Seat 2: FuriousCards ($0.59 in chips)=20
Seat 3: papin1988 ($2.07 in chips)=20
Seat 4: the_wickstar ($1.57 in chips)=20
Seat 5: Adashko#1 ($2.03 in chips)=20
Seat 6: konex ($1.92 in chips)=20
Seat 7: shunysun68 ($1.06 in chips)=20
the_wickstar: posts small blind $0.01
Adashko#1: posts big blind $0.02
yjqian23: sits out=20
reivaj491: sits out=20
*** HOLE CARDS ***
Dealt to the_wickstar [6h Ks]
konex: raises $0.04 to $0.06
shunysun68: calls $0.06
hard nutss: folds=20
FuriousCards: folds=20
papin1988: folds=20
the_wickstar: folds=20
Adashko#1: calls $0.04
*** FLOP *** [Qs Qc 3d]
Adashko#1: checks=20
konex: checks=20
shunysun68: checks=20
*** TURN *** [Qs Qc 3d] [8d]
Adashko#1: checks=20
konex: bets $0.10
shunysun68: folds=20
Adashko#1: calls $0.10
*** RIVER *** [Qs Qc 3d 8d] [3s]
Adashko#1: checks=20
konex: checks=20
*** SHOW DOWN ***
Adashko#1: shows [Jd Td] (two pair, Queens and Threes)
konex: shows [Ts Qd] (a full house, Queens full of Threes)
konex collected $0.38 from pot
*** SUMMARY ***
Total pot $0.39 | Rake $0.01=20
Board [Qs Qc 3d 8d 3s]
Seat 1: hard nutss folded before Flop (didn't bet)
Seat 2: FuriousCards folded before Flop (didn't bet)
Seat 3: papin1988 (button) folded before Flop (didn't bet)
Seat 4: the_wickstar (small blind) folded before Flop
Seat 5: Adashko#1 (big blind) showed [Jd Td] and lost with two pair, Qu=
eens and Threes
Seat 6: konex showed [Ts Qd] and won ($0.38) with a full house, Queens =
full of Threes
Seat 7: shunysun68 folded on the Turn


*********** # 85 **************
PokerStars Hand #169563781355:  Hold'em No Limit ($0.01/$0.02 USD) - 20=
17/04/26 10:17:13 CUST [2017/04/25 20:17:13 ET]
Table 'Irus' 9-max Seat #2 is the button
Seat 1: hard nutss ($2.42 in chips)=20
Seat 2: FuriousCards ($0.59 in chips)=20
Seat 3: papin1988 ($2.08 in chips)=20
Seat 4: the_wickstar ($1.59 in chips)=20
Seat 5: Adashko#1 ($2 in chips)=20
Seat 6: konex ($1.92 in chips)=20
Seat 7: shunysun68 ($1.06 in chips)=20
papin1988: posts small blind $0.01
the_wickstar: posts big blind $0.02
yjqian23: sits out=20
reivaj491: sits out=20
*** HOLE CARDS ***
Dealt to the_wickstar [6h 3c]
Adashko#1: raises $0.04 to $0.06
konex: folds=20
shunysun68: folds=20
hard nutss: folds=20
FuriousCards: folds=20
papin1988: folds=20
the_wickstar: folds=20
Uncalled bet ($0.04) returned to Adashko#1
Adashko#1 collected $0.05 from pot
Adashko#1: doesn't show hand=20
*** SUMMARY ***
Total pot $0.05 | Rake $0=20
Seat 1: hard nutss folded before Flop (didn't bet)
Seat 2: FuriousCards (button) folded before Flop (didn't bet)
Seat 3: papin1988 (small blind) folded before Flop
Seat 4: the_wickstar (big blind) folded before Flop
Seat 5: Adashko#1 collected ($0.05)
Seat 6: konex folded before Flop (didn't bet)
Seat 7: shunysun68 folded before Flop (didn't bet)


*********** # 86 **************
PokerStars Hand #169563771253:  Hold'em No Limit ($0.01/$0.02 USD) - 20=
17/04/26 10:16:52 CUST [2017/04/25 20:16:52 ET]
Table 'Ulrike' 9-max Seat #2 is the button
Seat 1: ELECTROZOR ($2.03 in chips)=20
Seat 2: the_wickstar ($1.07 in chips)=20
Seat 3: Comra1d ($2.10 in chips)=20
Seat 5: Gabeleleu_np ($1.79 in chips)=20
Seat 6: hashex ($2 in chips)=20
Seat 7: creezy.by ($1.75 in chips)=20
Seat 8: TJAbram ($0.78 in chips)=20
Seat 9: MDS17 ($4.23 in chips)=20
Comra1d: posts small blind $0.01
Gabeleleu_np: posts big blind $0.02
*** HOLE CARDS ***
Dealt to the_wickstar [7d Jd]
hashex: folds=20
creezy.by: folds=20
TJAbram: folds=20
MDS17: calls $0.02
ELECTROZOR: folds=20
the_wickstar: calls $0.02
Comra1d: calls $0.01
Gabeleleu_np: checks=20
*** FLOP *** [4d Ks 3s]
Comra1d: checks=20
Gabeleleu_np: checks=20
MDS17: checks=20
Irvade leaves the table
the_wickstar: checks=20
*** TURN *** [4d Ks 3s] [6h]
Comra1d: bets $0.05
Gabeleleu_np: raises $0.07 to $0.12
MDS17: folds=20
the_wickstar: folds=20
TJAbram is disconnected=20
Comra1d: calls $0.07
*** RIVER *** [4d Ks 3s 6h] [Qs]
bubamix joins the table at seat #4=20
Comra1d: checks=20
Gabeleleu_np: bets $0.26
Comra1d: folds=20
Uncalled bet ($0.26) returned to Gabeleleu_np
Gabeleleu_np collected $0.31 from pot
Gabeleleu_np: doesn't show hand=20
*** SUMMARY ***
Total pot $0.32 | Rake $0.01=20
Board [4d Ks 3s 6h Qs]
Seat 1: ELECTROZOR folded before Flop (didn't bet)
Seat 2: the_wickstar (button) folded on the Turn
Seat 3: Comra1d (small blind) folded on the River
Seat 5: Gabeleleu_np (big blind) collected ($0.31)
Seat 6: hashex folded before Flop (didn't bet)
Seat 7: creezy.by folded before Flop (didn't bet)
Seat 8: TJAbram folded before Flop (didn't bet)
Seat 9: MDS17 folded on the Turn


*********** # 87 **************
PokerStars Hand #169563743883:  Hold'em No Limit ($0.01/$0.02 USD) - 20=
17/04/26 10:15:57 CUST [2017/04/25 20:15:57 ET]
Table 'Ulrike' 9-max Seat #1 is the button
Seat 1: ELECTROZOR ($2 in chips)=20
Seat 2: the_wickstar ($1.08 in chips)=20
Seat 3: Comra1d ($2.12 in chips)=20
Seat 5: Gabeleleu_np ($1.79 in chips)=20
Seat 6: hashex ($2 in chips)=20
Seat 7: creezy.by ($1.75 in chips)=20
Seat 8: TJAbram ($0.78 in chips)=20
Seat 9: MDS17 ($4.23 in chips)=20
the_wickstar: posts small blind $0.01
Comra1d: posts big blind $0.02
*** HOLE CARDS ***
Dealt to the_wickstar [Tc 2s]
Gabeleleu_np: folds=20
hashex: folds=20
creezy.by: folds=20
TJAbram: folds=20
MDS17: folds=20
ELECTROZOR: raises $0.06 to $0.08
the_wickstar: folds=20
Comra1d: folds=20
Uncalled bet ($0.06) returned to ELECTROZOR
ELECTROZOR collected $0.05 from pot
ELECTROZOR: doesn't show hand=20
*** SUMMARY ***
Total pot $0.05 | Rake $0=20
Seat 1: ELECTROZOR (button) collected ($0.05)
Seat 2: the_wickstar (small blind) folded before Flop
Seat 3: Comra1d (big blind) folded before Flop
Seat 5: Gabeleleu_np folded before Flop (didn't bet)
Seat 6: hashex folded before Flop (didn't bet)
Seat 7: creezy.by folded before Flop (didn't bet)
Seat 8: TJAbram folded before Flop (didn't bet)
Seat 9: MDS17 folded before Flop (didn't bet)


*********** # 88 **************
PokerStars Hand #169563739836:  Hold'em No Limit ($0.01/$0.02 USD) - 20=
17/04/26 10:15:48 CUST [2017/04/25 20:15:48 ET]
Table 'Irus' 9-max Seat #1 is the button
Seat 1: hard nutss ($2.30 in chips)=20
Seat 2: FuriousCards ($0.60 in chips)=20
Seat 3: papin1988 ($2.14 in chips)=20
Seat 4: the_wickstar ($1.59 in chips)=20
Seat 5: Adashko#1 ($2 in chips)=20
Seat 6: konex ($1.98 in chips)=20
Seat 7: shunysun68 ($1.06 in chips)=20
FuriousCards: posts small blind $0.01
papin1988: posts big blind $0.02
yjqian23: sits out=20
*** HOLE CARDS ***
Dealt to the_wickstar [6s 3c]
the_wickstar: folds=20
duulemes leaves the table
Adashko#1: folds=20
reivaj491 joins the table at seat #9=20
konex: raises $0.04 to $0.06
shunysun68: folds=20
hard nutss: calls $0.06
FuriousCards: folds=20
papin1988: calls $0.04
*** FLOP *** [9h 2d Ac]
papin1988: checks=20
konex is disconnected=20
konex is connected=20
konex: checks=20
hard nutss: bets $0.11
papin1988: folds=20
konex: folds=20
Uncalled bet ($0.11) returned to hard nutss
hard nutss collected $0.18 from pot
hard nutss: doesn't show hand=20
*** SUMMARY ***
Total pot $0.19 | Rake $0.01=20
Board [9h 2d Ac]
Seat 1: hard nutss (button) collected ($0.18)
Seat 2: FuriousCards (small blind) folded before Flop
Seat 3: papin1988 (big blind) folded on the Flop
Seat 4: the_wickstar folded before Flop (didn't bet)
Seat 5: Adashko#1 folded before Flop (didn't bet)
Seat 6: konex folded on the Flop
Seat 7: shunysun68 folded before Flop (didn't bet)


*********** # 89 **************
PokerStars Hand #169563729576:  Hold'em No Limit ($0.01/$0.02 USD) - 20=
17/04/26 10:15:28 CUST [2017/04/25 20:15:28 ET]
Table 'Ulrike' 9-max Seat #9 is the button
Seat 1: ELECTROZOR ($2 in chips)=20
Seat 2: the_wickstar ($1.07 in chips)=20
Seat 3: Comra1d ($2.12 in chips)=20
Seat 4: Irvade ($2.43 in chips)=20
Seat 5: Gabeleleu_np ($1.79 in chips)=20
Seat 6: hashex ($2 in chips)=20
Seat 7: creezy.by ($1.75 in chips)=20
Seat 8: TJAbram ($0.78 in chips)=20
Seat 9: MDS17 ($4.23 in chips)=20
ELECTROZOR: posts small blind $0.01
the_wickstar: posts big blind $0.02
*** HOLE CARDS ***
Dealt to the_wickstar [2s As]
Comra1d: folds=20
Irvade: folds=20
Gabeleleu_np: folds=20
hashex: folds=20
creezy.by: folds=20
TJAbram: folds=20
MDS17: folds=20
ELECTROZOR: folds=20
Uncalled bet ($0.01) returned to the_wickstar
the_wickstar collected $0.02 from pot
*** SUMMARY ***
Total pot $0.02 | Rake $0=20
Seat 1: ELECTROZOR (small blind) folded before Flop
Seat 2: the_wickstar (big blind) collected ($0.02)
Seat 3: Comra1d folded before Flop (didn't bet)
Seat 4: Irvade folded before Flop (didn't bet)
Seat 5: Gabeleleu_np folded before Flop (didn't bet)
Seat 6: hashex folded before Flop (didn't bet)
Seat 7: creezy.by folded before Flop (didn't bet)
Seat 8: TJAbram folded before Flop (didn't bet)
Seat 9: MDS17 (button) folded before Flop (didn't bet)


*********** # 90 **************
PokerStars Hand #169563709981:  Hold'em No Limit ($0.01/$0.02 USD) - 20=
17/04/26 10:14:48 CUST [2017/04/25 20:14:48 ET]
Table 'Irus' 9-max Seat #7 is the button
Seat 1: hard nutss ($2.32 in chips)=20
Seat 2: FuriousCards ($0.60 in chips)=20
Seat 3: papin1988 ($2.14 in chips)=20
Seat 4: the_wickstar ($1.32 in chips)=20
Seat 5: Adashko#1 ($2 in chips)=20
Seat 6: konex ($1.98 in chips)=20
Seat 7: shunysun68 ($1.06 in chips)=20
Seat 9: duulemes ($0.27 in chips)=20
yjqian23 will be allowed to play after the button
duulemes: posts small blind $0.01
hard nutss: posts big blind $0.02
*** HOLE CARDS ***
Dealt to the_wickstar [Kh Jc]
FuriousCards: folds=20
papin1988: folds=20
the_wickstar: calls $0.02
Adashko#1: folds=20
konex: folds=20
shunysun68: folds=20
duulemes: calls $0.01
hard nutss: checks=20
*** FLOP *** [4c Js 8c]
duulemes: bets $0.06
hard nutss: folds=20
the_wickstar: calls $0.06
*** TURN *** [4c Js 8c] [Ad]
duulemes: bets $0.17
the_wickstar: calls $0.17
*** RIVER *** [4c Js 8c Ad] [6c]
duulemes: bets $0.02 and is all-in
the_wickstar: calls $0.02
*** SHOW DOWN ***
duulemes: shows [8d 7c] (a pair of Eights)
the_wickstar: shows [Kh Jc] (a pair of Jacks)
the_wickstar collected $0.54 from pot
*** SUMMARY ***
Total pot $0.56 | Rake $0.02=20
Board [4c Js 8c Ad 6c]
Seat 1: hard nutss (big blind) folded on the Flop
Seat 2: FuriousCards folded before Flop (didn't bet)
Seat 3: papin1988 folded before Flop (didn't bet)
Seat 4: the_wickstar showed [Kh Jc] and won ($0.54) with a pair of Jacks
Seat 5: Adashko#1 folded before Flop (didn't bet)
Seat 6: konex folded before Flop (didn't bet)
Seat 7: shunysun68 (button) folded before Flop (didn't bet)
Seat 9: duulemes (small blind) showed [8d 7c] and lost with a pair of E=
ights


*********** # 91 **************
PokerStars Hand #169563708828:  Hold'em No Limit ($0.01/$0.02 USD) - 20=
17/04/26 10:14:46 CUST [2017/04/25 20:14:46 ET]
Table 'Ulrike' 9-max Seat #8 is the button
Seat 1: ELECTROZOR ($2 in chips)=20
Seat 2: the_wickstar ($1.07 in chips)=20
Seat 3: Comra1d ($2.12 in chips)=20
Seat 4: Irvade ($2.40 in chips)=20
Seat 5: Gabeleleu_np ($1.79 in chips)=20
Seat 6: hashex ($2 in chips)=20
Seat 7: creezy.by ($1.75 in chips)=20
Seat 8: TJAbram ($0.78 in chips)=20
Seat 9: MDS17 ($4.24 in chips)=20
MDS17: posts small blind $0.01
ELECTROZOR: posts big blind $0.02
*** HOLE CARDS ***
Dealt to the_wickstar [7s 9h]
the_wickstar: folds=20
Comra1d: folds=20
Irvade: raises $0.04 to $0.06
Gabeleleu_np: folds=20
hashex: folds=20
creezy.by: folds=20
TJAbram: folds=20
MDS17: folds=20
ELECTROZOR: folds=20
Uncalled bet ($0.04) returned to Irvade
Irvade collected $0.05 from pot
Irvade: doesn't show hand=20
*** SUMMARY ***
Total pot $0.05 | Rake $0=20
Seat 1: ELECTROZOR (big blind) folded before Flop
Seat 2: the_wickstar folded before Flop (didn't bet)
Seat 3: Comra1d folded before Flop (didn't bet)
Seat 4: Irvade collected ($0.05)
Seat 5: Gabeleleu_np folded before Flop (didn't bet)
Seat 6: hashex folded before Flop (didn't bet)
Seat 7: creezy.by folded before Flop (didn't bet)
Seat 8: TJAbram (button) folded before Flop (didn't bet)
Seat 9: MDS17 (small blind) folded before Flop


*********** # 92 **************
PokerStars Hand #169563685650:  Hold'em No Limit ($0.01/$0.02 USD) - 20=
17/04/26 10:13:59 CUST [2017/04/25 20:13:59 ET]
Table 'Irus' 9-max Seat #6 is the button
Seat 1: hard nutss ($1.95 in chips)=20
Seat 2: FuriousCards ($0.60 in chips)=20
Seat 3: papin1988 ($2.14 in chips)=20
Seat 4: the_wickstar ($1.32 in chips)=20
Seat 5: Adashko#1 ($2 in chips)=20
Seat 6: konex ($1.98 in chips)=20
Seat 7: shunysun68 ($1.07 in chips)=20
Seat 9: duulemes ($0.66 in chips)=20
shunysun68: posts small blind $0.01
duulemes: posts big blind $0.02
*** HOLE CARDS ***
Dealt to the_wickstar [Td 6c]
hard nutss: raises $0.04 to $0.06
yjqian23 joins the table at seat #8=20
FuriousCards: folds=20
papin1988: folds=20
the_wickstar: folds=20
Adashko#1: folds=20
konex: folds=20
shunysun68: folds=20
duulemes: calls $0.04
*** FLOP *** [2c 2s 5s]
duulemes: bets $0.02
hard nutss: raises $0.11 to $0.13
duulemes: calls $0.11
*** TURN *** [2c 2s 5s] [Kc]
duulemes: checks=20
hard nutss: bets $0.20
duulemes: calls $0.20
*** RIVER *** [2c 2s 5s Kc] [7h]
duulemes: checks=20
hard nutss: checks=20
*** SHOW DOWN ***
duulemes: shows [8s 7s] (two pair, Sevens and Deuces)
hard nutss: shows [8c 8h] (two pair, Eights and Deuces)
hard nutss collected $0.76 from pot
*** SUMMARY ***
Total pot $0.79 | Rake $0.03=20
Board [2c 2s 5s Kc 7h]
Seat 1: hard nutss showed [8c 8h] and won ($0.76) with two pair, Eights=
 and Deuces
Seat 2: FuriousCards folded before Flop (didn't bet)
Seat 3: papin1988 folded before Flop (didn't bet)
Seat 4: the_wickstar folded before Flop (didn't bet)
Seat 5: Adashko#1 folded before Flop (didn't bet)
Seat 6: konex (button) folded before Flop (didn't bet)
Seat 7: shunysun68 (small blind) folded before Flop
Seat 9: duulemes (big blind) showed [8s 7s] and lost with two pair, Sev=
ens and Deuces


*********** # 93 **************
PokerStars Hand #169563685300:  Hold'em No Limit ($0.01/$0.02 USD) - 20=
17/04/26 10:13:59 CUST [2017/04/25 20:13:59 ET]
Table 'Ulrike' 9-max Seat #7 is the button
Seat 2: the_wickstar ($1.07 in chips)=20
Seat 3: Comra1d ($2.12 in chips)=20
Seat 4: Irvade ($2.40 in chips)=20
Seat 5: Gabeleleu_np ($1.79 in chips)=20
Seat 6: hashex ($2 in chips)=20
Seat 7: creezy.by ($1.72 in chips)=20
Seat 8: TJAbram ($0.79 in chips)=20
Seat 9: MDS17 ($4.26 in chips)=20
TJAbram: posts small blind $0.01
MDS17: posts big blind $0.02
ELECTROZOR: sits out=20
*** HOLE CARDS ***
Dealt to the_wickstar [4d Jh]
the_wickstar: folds=20
Comra1d: folds=20
Irvade: folds=20
Gabeleleu_np: folds=20
hashex: folds=20
creezy.by: raises $0.10 to $0.12
TJAbram: folds=20
MDS17: folds=20
Uncalled bet ($0.10) returned to creezy.by
creezy.by collected $0.05 from pot
*** SUMMARY ***
Total pot $0.05 | Rake $0=20
Seat 2: the_wickstar folded before Flop (didn't bet)
Seat 3: Comra1d folded before Flop (didn't bet)
Seat 4: Irvade folded before Flop (didn't bet)
Seat 5: Gabeleleu_np folded before Flop (didn't bet)
Seat 6: hashex folded before Flop (didn't bet)
Seat 7: creezy.by (button) collected ($0.05)
Seat 8: TJAbram (small blind) folded before Flop
Seat 9: MDS17 (big blind) folded before Flop


*********** # 94 **************
PokerStars Hand #169563665680:  Hold'em No Limit ($0.01/$0.02 USD) - 20=
17/04/26 10:13:19 CUST [2017/04/25 20:13:19 ET]
Table 'Irus' 9-max Seat #5 is the button
Seat 1: hard nutss ($2.01 in chips)=20
Seat 2: FuriousCards ($0.60 in chips)=20
Seat 3: papin1988 ($2.14 in chips)=20
Seat 4: the_wickstar ($1.32 in chips)=20
Seat 5: Adashko#1 ($2 in chips)=20
Seat 6: konex ($1.99 in chips)=20
Seat 7: shunysun68 ($1 in chips)=20
Seat 8: bubamix ($4.44 in chips)=20
Seat 9: duulemes ($0.66 in chips)=20
konex: posts small blind $0.01
shunysun68: posts big blind $0.02
*** HOLE CARDS ***
Dealt to the_wickstar [3h Qh]
bubamix: folds=20
duulemes: folds=20
hard nutss: raises $0.04 to $0.06
FuriousCards: folds=20
papin1988: folds=20
the_wickstar: folds=20
Adashko#1: folds=20
konex: folds=20
shunysun68: calls $0.04
*** FLOP *** [Qc Kd 8c]
shunysun68: checks=20
hard nutss: checks=20
*** TURN *** [Qc Kd 8c] [2c]
bubamix leaves the table
shunysun68: bets $0.04
hard nutss: folds=20
Uncalled bet ($0.04) returned to shunysun68
shunysun68 collected $0.13 from pot
*** SUMMARY ***
Total pot $0.13 | Rake $0=20
Board [Qc Kd 8c 2c]
Seat 1: hard nutss folded on the Turn
Seat 2: FuriousCards folded before Flop (didn't bet)
Seat 3: papin1988 folded before Flop (didn't bet)
Seat 4: the_wickstar folded before Flop (didn't bet)
Seat 5: Adashko#1 (button) folded before Flop (didn't bet)
Seat 6: konex (small blind) folded before Flop
Seat 7: shunysun68 (big blind) collected ($0.13)
Seat 8: bubamix folded before Flop (didn't bet)
Seat 9: duulemes folded before Flop (didn't bet)


*********** # 95 **************
PokerStars Hand #169563653719:  Hold'em No Limit ($0.01/$0.02 USD) - 20=
17/04/26 10:12:55 CUST [2017/04/25 20:12:55 ET]
Table 'Irus' 9-max Seat #4 is the button
Seat 1: hard nutss ($2.01 in chips)=20
Seat 2: FuriousCards ($0.60 in chips)=20
Seat 3: papin1988 ($2.14 in chips)=20
Seat 4: the_wickstar ($1.32 in chips)=20
Seat 5: Adashko#1 ($2 in chips)=20
Seat 6: konex ($1.98 in chips)=20
Seat 7: shunysun68 ($1 in chips)=20
Seat 8: bubamix ($4.44 in chips)=20
Seat 9: duulemes ($0.66 in chips)=20
Adashko#1: posts small blind $0.01
konex: posts big blind $0.02
*** HOLE CARDS ***
Dealt to the_wickstar [2d 6d]
shunysun68: folds=20
bubamix: folds=20
duulemes: folds=20
hard nutss: folds=20
FuriousCards: folds=20
papin1988: folds=20
the_wickstar: folds=20
Adashko#1: folds=20
Uncalled bet ($0.01) returned to konex
konex collected $0.02 from pot
*** SUMMARY ***
Total pot $0.02 | Rake $0=20
Seat 1: hard nutss folded before Flop (didn't bet)
Seat 2: FuriousCards folded before Flop (didn't bet)
Seat 3: papin1988 folded before Flop (didn't bet)
Seat 4: the_wickstar (button) folded before Flop (didn't bet)
Seat 5: Adashko#1 (small blind) folded before Flop
Seat 6: konex (big blind) collected ($0.02)
Seat 7: shunysun68 folded before Flop (didn't bet)
Seat 8: bubamix folded before Flop (didn't bet)
Seat 9: duulemes folded before Flop (didn't bet)


*********** # 96 **************
PokerStars Hand #169563648139:  Hold'em No Limit ($0.01/$0.02 USD) - 20=
17/04/26 10:12:44 CUST [2017/04/25 20:12:44 ET]
Table 'Ulrike' 9-max Seat #6 is the button
Seat 2: the_wickstar ($1.13 in chips)=20
Seat 3: Comra1d ($2.12 in chips)=20
Seat 4: Irvade ($2.40 in chips)=20
Seat 5: Gabeleleu_np ($1.79 in chips)=20
Seat 6: hashex ($2 in chips)=20
Seat 7: creezy.by ($1.73 in chips)=20
Seat 8: TJAbram ($0.81 in chips)=20
Seat 9: MDS17 ($4.18 in chips)=20
creezy.by: posts small blind $0.01
TJAbram: posts big blind $0.02
ELECTROZOR: sits out=20
*** HOLE CARDS ***
Dealt to the_wickstar [Jd Qd]
MDS17: calls $0.02
the_wickstar: raises $0.04 to $0.06
Comra1d: folds=20
Irvade: folds=20
Gabeleleu_np: folds=20
hashex: folds=20
creezy.by: folds=20
TJAbram is disconnected=20
TJAbram is connected=20
TJAbram: folds=20
MDS17: calls $0.04
*** FLOP *** [4d 6c 2c]
MDS17: bets $0.14
the_wickstar: folds=20
Uncalled bet ($0.14) returned to MDS17
MDS17 collected $0.14 from pot
*** SUMMARY ***
Total pot $0.15 | Rake $0.01=20
Board [4d 6c 2c]
Seat 2: the_wickstar folded on the Flop
Seat 3: Comra1d folded before Flop (didn't bet)
Seat 4: Irvade folded before Flop (didn't bet)
Seat 5: Gabeleleu_np folded before Flop (didn't bet)
Seat 6: hashex (button) folded before Flop (didn't bet)
Seat 7: creezy.by (small blind) folded before Flop
Seat 8: TJAbram (big blind) folded before Flop
Seat 9: MDS17 collected ($0.14)


*********** # 97 **************
PokerStars Hand #169563615062:  Hold'em No Limit ($0.01/$0.02 USD) - 20=
17/04/26 10:11:38 CUST [2017/04/25 20:11:38 ET]
Table 'Irus' 9-max Seat #3 is the button
Seat 1: hard nutss ($2.01 in chips)=20
Seat 2: FuriousCards ($0.60 in chips)=20
Seat 3: papin1988 ($2 in chips)=20
Seat 4: the_wickstar ($1.33 in chips)=20
Seat 5: Adashko#1 ($2.12 in chips)=20
Seat 6: konex ($1.98 in chips)=20
Seat 7: shunysun68 ($1 in chips)=20
Seat 8: bubamix ($4.46 in chips)=20
Seat 9: duulemes ($0.66 in chips)=20
the_wickstar: posts small blind $0.01
Adashko#1: posts big blind $0.02
*** HOLE CARDS ***
Dealt to the_wickstar [7c 9c]
konex: folds=20
shunysun68: folds=20
bubamix: calls $0.02
duulemes: folds=20
hard nutss: folds=20
FuriousCards: folds=20
papin1988: raises $0.10 to $0.12
the_wickstar: folds=20
Adashko#1: calls $0.10
bubamix: folds=20
*** FLOP *** [5h Ah 8c]
Adashko#1: checks=20
papin1988: bets $0.16
Adashko#1: folds=20
Uncalled bet ($0.16) returned to papin1988
papin1988 collected $0.26 from pot
*** SUMMARY ***
Total pot $0.27 | Rake $0.01=20
Board [5h Ah 8c]
Seat 1: hard nutss folded before Flop (didn't bet)
Seat 2: FuriousCards folded before Flop (didn't bet)
Seat 3: papin1988 (button) collected ($0.26)
Seat 4: the_wickstar (small blind) folded before Flop
Seat 5: Adashko#1 (big blind) folded on the Flop
Seat 6: konex folded before Flop (didn't bet)
Seat 7: shunysun68 folded before Flop (didn't bet)
Seat 8: bubamix folded before Flop
Seat 9: duulemes folded before Flop (didn't bet)


*********** # 98 **************
PokerStars Hand #169563606326:  Hold'em No Limit ($0.01/$0.02 USD) - 20=
17/04/26 10:11:20 CUST [2017/04/25 20:11:20 ET]
Table 'Ulrike' 9-max Seat #5 is the button
Seat 2: the_wickstar ($1.13 in chips)=20
Seat 3: Comra1d ($2.12 in chips)=20
Seat 4: Irvade ($2.40 in chips)=20
Seat 5: Gabeleleu_np ($1.72 in chips)=20
Seat 6: hashex ($2 in chips)=20
Seat 7: creezy.by ($1.79 in chips)=20
Seat 8: TJAbram ($0.81 in chips)=20
Seat 9: MDS17 ($4.18 in chips)=20
hashex: posts small blind $0.01
creezy.by: posts big blind $0.02
ELECTROZOR: sits out=20
*** HOLE CARDS ***
Dealt to the_wickstar [Td 7s]
TJAbram: folds=20
MDS17: folds=20
the_wickstar: folds=20
Comra1d: folds=20
Irvade: folds=20
Gabeleleu_np: raises $0.04 to $0.06
hashex: folds=20
creezy.by: calls $0.04
*** FLOP *** [6d 9h 8s]
creezy.by: checks=20
Gabeleleu_np: checks=20
*** TURN *** [6d 9h 8s] [8h]
creezy.by: checks=20
Gabeleleu_np: checks=20
*** RIVER *** [6d 9h 8s 8h] [Kh]
creezy.by: checks=20
Gabeleleu_np: bets $0.08
creezy.by: folds=20
Uncalled bet ($0.08) returned to Gabeleleu_np
Gabeleleu_np collected $0.13 from pot
Gabeleleu_np: doesn't show hand=20
*** SUMMARY ***
Total pot $0.13 | Rake $0=20
Board [6d 9h 8s 8h Kh]
Seat 2: the_wickstar folded before Flop (didn't bet)
Seat 3: Comra1d folded before Flop (didn't bet)
Seat 4: Irvade folded before Flop (didn't bet)
Seat 5: Gabeleleu_np (button) collected ($0.13)
Seat 6: hashex (small blind) folded before Flop
Seat 7: creezy.by (big blind) folded on the River
Seat 8: TJAbram folded before Flop (didn't bet)
Seat 9: MDS17 folded before Flop (didn't bet)


*********** # 99 **************
PokerStars Hand #169563595639:  Hold'em No Limit ($0.01/$0.02 USD) - 20=
17/04/26 10:10:59 CUST [2017/04/25 20:10:59 ET]
Table 'Irus' 9-max Seat #2 is the button
Seat 1: hard nutss ($2.01 in chips)=20
Seat 2: FuriousCards ($0.60 in chips)=20
Seat 3: papin1988 ($2 in chips)=20
Seat 4: the_wickstar ($1.35 in chips)=20
Seat 5: Adashko#1 ($2.12 in chips)=20
Seat 6: konex ($1.98 in chips)=20
Seat 7: shunysun68 ($0.97 in chips)=20
Seat 8: bubamix ($4.46 in chips)=20
Seat 9: duulemes ($0.66 in chips)=20
papin1988: posts small blind $0.01
the_wickstar: posts big blind $0.02
*** HOLE CARDS ***
Dealt to the_wickstar [As 6c]
Adashko#1: folds=20
konex: folds=20
shunysun68: raises $0.05 to $0.07
bubamix: folds=20
duulemes: folds=20
hard nutss: folds=20
FuriousCards: folds=20
papin1988: folds=20
the_wickstar: folds=20
Uncalled bet ($0.05) returned to shunysun68
shunysun68 collected $0.05 from pot
*** SUMMARY ***
Total pot $0.05 | Rake $0=20
Seat 1: hard nutss folded before Flop (didn't bet)
Seat 2: FuriousCards (button) folded before Flop (didn't bet)
Seat 3: papin1988 (small blind) folded before Flop
Seat 4: the_wickstar (big blind) folded before Flop
Seat 5: Adashko#1 folded before Flop (didn't bet)
Seat 6: konex folded before Flop (didn't bet)
Seat 7: shunysun68 collected ($0.05)
Seat 8: bubamix folded before Flop (didn't bet)
Seat 9: duulemes folded before Flop (didn't bet)


*********** # 100 **************
PokerStars Hand #169563566469:  Hold'em No Limit ($0.01/$0.02 USD) - 20=
17/04/26 10:10:17 CUST [2017/04/25 20:10:17 ET]
Table 'Ulrike' 9-max Seat #4 is the button
Seat 2: the_wickstar ($1.02 in chips)=20
Seat 3: Comra1d ($2.12 in chips)=20
Seat 4: Irvade ($2.40 in chips)=20
Seat 5: Gabeleleu_np ($1.74 in chips)=20
Seat 6: hashex ($2 in chips)=20
Seat 7: creezy.by ($1.79 in chips)=20
Seat 8: TJAbram ($0.81 in chips)=20
Seat 9: MDS17 ($4.18 in chips)=20
Gabeleleu_np: posts small blind $0.01
hashex: posts big blind $0.02
ELECTROZOR: sits out=20
*** HOLE CARDS ***
Dealt to the_wickstar [7c 7s]
creezy.by: folds=20
TJAbram: folds=20
MDS17: folds=20
the_wickstar: calls $0.02
Comra1d: folds=20
Irvade: folds=20
Gabeleleu_np: calls $0.01
hashex: checks=20
*** FLOP *** [6h 4s Jc]
Gabeleleu_np: checks=20
hashex: checks=20
the_wickstar: checks=20
*** TURN *** [6h 4s Jc] [Jh]
Gabeleleu_np: checks=20
hashex: bets $0.04
the_wickstar: calls $0.04
TJAbram is disconnected=20
Gabeleleu_np: folds=20
*** RIVER *** [6h 4s Jc Jh] [2h]
hashex: bets $0.04
the_wickstar: calls $0.04
*** SHOW DOWN ***
hashex: shows [Ad 4c] (two pair, Jacks and Fours)
the_wickstar: shows [7c 7s] (two pair, Jacks and Sevens)
the_wickstar collected $0.21 from pot
*** SUMMARY ***
Total pot $0.22 | Rake $0.01=20
Board [6h 4s Jc Jh 2h]
Seat 2: the_wickstar showed [7c 7s] and won ($0.21) with two pair, Jack=
s and Sevens
Seat 3: Comra1d folded before Flop (didn't bet)
Seat 4: Irvade (button) folded before Flop (didn't bet)
Seat 5: Gabeleleu_np (small blind) folded on the Turn
Seat 6: hashex (big blind) showed [Ad 4c] and lost with two pair, Jacks=
 and Fours
Seat 7: creezy.by folded before Flop (didn't bet)
Seat 8: TJAbram folded before Flop (didn't bet)
Seat 9: MDS17 folded before Flop (didn't bet)


*********** # 101 **************
PokerStars Hand #169563565673:  Hold'em No Limit ($0.01/$0.02 USD) - 20=
17/04/26 10:10:15 CUST [2017/04/25 20:10:15 ET]
Table 'Irus' 9-max Seat #1 is the button
Seat 1: hard nutss ($2.01 in chips)=20
Seat 2: FuriousCards ($0.61 in chips)=20
Seat 3: papin1988 ($2.04 in chips)=20
Seat 4: the_wickstar ($1.35 in chips)=20
Seat 5: Adashko#1 ($2.12 in chips)=20
Seat 6: konex ($1.98 in chips)=20
Seat 7: shunysun68 ($0.92 in chips)=20
Seat 8: bubamix ($4.46 in chips)=20
Seat 9: duulemes ($0.66 in chips)=20
FuriousCards: posts small blind $0.01
papin1988: posts big blind $0.02
*** HOLE CARDS ***
Dealt to the_wickstar [3s Ks]
the_wickstar: folds=20
Adashko#1: folds=20
konex: folds=20
shunysun68: raises $0.02 to $0.04
bubamix: folds=20
duulemes: folds=20
hard nutss: folds=20
FuriousCards: folds=20
papin1988: calls $0.02
*** FLOP *** [Qh 5s 9h]
papin1988: checks=20
shunysun68: bets $0.04
papin1988: folds=20
Uncalled bet ($0.04) returned to shunysun68
shunysun68 collected $0.09 from pot
*** SUMMARY ***
Total pot $0.09 | Rake $0=20
Board [Qh 5s 9h]
Seat 1: hard nutss (button) folded before Flop (didn't bet)
Seat 2: FuriousCards (small blind) folded before Flop
Seat 3: papin1988 (big blind) folded on the Flop
Seat 4: the_wickstar folded before Flop (didn't bet)
Seat 5: Adashko#1 folded before Flop (didn't bet)
Seat 6: konex folded before Flop (didn't bet)
Seat 7: shunysun68 collected ($0.09)
Seat 8: bubamix folded before Flop (didn't bet)
Seat 9: duulemes folded before Flop (didn't bet)


*********** # 102 **************
PokerStars Hand #169563540481:  Hold'em No Limit ($0.01/$0.02 USD) - 20=
17/04/26 10:09:25 CUST [2017/04/25 20:09:25 ET]
Table 'Irus' 9-max Seat #9 is the button
Seat 1: hard nutss ($2.02 in chips)=20
Seat 2: FuriousCards ($0.63 in chips)=20
Seat 3: papin1988 ($2.04 in chips)=20
Seat 4: the_wickstar ($1.37 in chips)=20
Seat 5: Adashko#1 ($2.12 in chips)=20
Seat 6: konex ($1.98 in chips)=20
Seat 7: shunysun68 ($0.87 in chips)=20
Seat 8: bubamix ($4.46 in chips)=20
Seat 9: duulemes ($0.66 in chips)=20
hard nutss: posts small blind $0.01
FuriousCards: posts big blind $0.02
*** HOLE CARDS ***
Dealt to the_wickstar [Jh Ad]
papin1988: folds=20
the_wickstar: calls $0.02
Adashko#1: folds=20
konex: folds=20
shunysun68: calls $0.02
bubamix: folds=20
duulemes: folds=20
hard nutss: folds=20
FuriousCards: checks=20
*** FLOP *** [7s Tc 9h]
FuriousCards: checks=20
the_wickstar: checks=20
shunysun68: bets $0.07
FuriousCards: folds=20
the_wickstar: folds=20
Uncalled bet ($0.07) returned to shunysun68
shunysun68 collected $0.07 from pot
*** SUMMARY ***
Total pot $0.07 | Rake $0=20
Board [7s Tc 9h]
Seat 1: hard nutss (small blind) folded before Flop
Seat 2: FuriousCards (big blind) folded on the Flop
Seat 3: papin1988 folded before Flop (didn't bet)
Seat 4: the_wickstar folded on the Flop
Seat 5: Adashko#1 folded before Flop (didn't bet)
Seat 6: konex folded before Flop (didn't bet)
Seat 7: shunysun68 collected ($0.07)
Seat 8: bubamix folded before Flop (didn't bet)
Seat 9: duulemes (button) folded before Flop (didn't bet)


*********** # 103 **************
PokerStars Hand #169563527417:  Hold'em No Limit ($0.01/$0.02 USD) - 20=
17/04/26 10:08:59 CUST [2017/04/25 20:08:59 ET]
Table 'Irus' 9-max Seat #8 is the button
Seat 1: hard nutss ($2 in chips)=20
Seat 2: FuriousCards ($0.63 in chips)=20
Seat 3: papin1988 ($2.04 in chips)=20
Seat 4: the_wickstar ($1.37 in chips)=20
Seat 5: Adashko#1 ($2.12 in chips)=20
Seat 6: konex ($1.98 in chips)=20
Seat 7: shunysun68 ($0.87 in chips)=20
Seat 8: bubamix ($4.46 in chips)=20
Seat 9: duulemes ($0.68 in chips)=20
duulemes: posts small blind $0.01
hard nutss: posts big blind $0.02
*** HOLE CARDS ***
Dealt to the_wickstar [Js 6h]
FuriousCards: folds=20
papin1988: folds=20
the_wickstar: folds=20
Adashko#1: folds=20
konex: folds=20
shunysun68: folds=20
bubamix: folds=20
duulemes: calls $0.01
hard nutss: raises $0.06 to $0.08
duulemes: folds=20
Uncalled bet ($0.06) returned to hard nutss
hard nutss collected $0.04 from pot
hard nutss: doesn't show hand=20
*** SUMMARY ***
Total pot $0.04 | Rake $0=20
Seat 1: hard nutss (big blind) collected ($0.04)
Seat 2: FuriousCards folded before Flop (didn't bet)
Seat 3: papin1988 folded before Flop (didn't bet)
Seat 4: the_wickstar folded before Flop (didn't bet)
Seat 5: Adashko#1 folded before Flop (didn't bet)
Seat 6: konex folded before Flop (didn't bet)
Seat 7: shunysun68 folded before Flop (didn't bet)
Seat 8: bubamix (button) folded before Flop (didn't bet)
Seat 9: duulemes (small blind) folded before Flop


*********** # 104 **************
PokerStars Hand #169563508407:  Hold'em No Limit ($0.01/$0.02 USD) - 20=
17/04/26 10:08:21 CUST [2017/04/25 20:08:21 ET]
Table 'Irus' 9-max Seat #7 is the button
Seat 2: FuriousCards ($0.63 in chips)=20
Seat 3: papin1988 ($2.04 in chips)=20
Seat 4: the_wickstar ($1.37 in chips)=20
Seat 5: Adashko#1 ($2.12 in chips)=20
Seat 6: konex ($1.98 in chips)=20
Seat 7: shunysun68 ($0.84 in chips)=20
Seat 8: bubamix ($4.47 in chips)=20
Seat 9: duulemes ($0.70 in chips)=20
bubamix: posts small blind $0.01
duulemes: posts big blind $0.02
hard nutss: sits out=20
*** HOLE CARDS ***
Dealt to the_wickstar [Ts 4h]
FuriousCards: folds=20
papin1988: folds=20
the_wickstar: folds=20
Adashko#1: folds=20
konex: folds=20
shunysun68: raises $0.05 to $0.07
bubamix: folds=20
duulemes: folds=20
Uncalled bet ($0.05) returned to shunysun68
shunysun68 collected $0.05 from pot
*** SUMMARY ***
Total pot $0.05 | Rake $0=20
Seat 2: FuriousCards folded before Flop (didn't bet)
Seat 3: papin1988 folded before Flop (didn't bet)
Seat 4: the_wickstar folded before Flop (didn't bet)
Seat 5: Adashko#1 folded before Flop (didn't bet)
Seat 6: konex folded before Flop (didn't bet)
Seat 7: shunysun68 (button) collected ($0.05)
Seat 8: bubamix (small blind) folded before Flop
Seat 9: duulemes (big blind) folded before Flop


*********** # 105 **************
PokerStars Hand #169563506316:  Hold'em No Limit ($0.01/$0.02 USD) - 20=
17/04/26 10:08:17 CUST [2017/04/25 20:08:17 ET]
Table 'Ulrike' 9-max Seat #3 is the button
Seat 2: the_wickstar ($1.02 in chips)=20
Seat 3: Comra1d ($2.38 in chips)=20
Seat 4: Irvade ($2.41 in chips)=20
Seat 5: Gabeleleu_np ($1.92 in chips)=20
Seat 6: hashex ($2 in chips)=20
Seat 7: creezy.by ($1.36 in chips)=20
Seat 8: TJAbram ($0.81 in chips)=20
Seat 9: MDS17 ($4.18 in chips)=20
Irvade: posts small blind $0.01
Gabeleleu_np is connected=20
Gabeleleu_np: posts big blind $0.02
ELECTROZOR: sits out=20
*** HOLE CARDS ***
Dealt to the_wickstar [Kc 6s]
hashex: folds=20
creezy.by: raises $0.10 to $0.12
TJAbram: folds=20
MDS17: folds=20
the_wickstar: folds=20
Comra1d: calls $0.12
Irvade: folds=20
Gabeleleu_np: calls $0.10
*** FLOP *** [Jh 7d Jd]
Gabeleleu_np: checks=20
creezy.by: checks=20
Comra1d: checks=20
*** TURN *** [Jh 7d Jd] [5s]
Gabeleleu_np: checks=20
creezy.by: bets $0.06
Comra1d: calls $0.06
Gabeleleu_np: calls $0.06
*** RIVER *** [Jh 7d Jd 5s] [2h]
Gabeleleu_np: checks=20
creezy.by: bets $0.08
Comra1d: calls $0.08
Gabeleleu_np: folds=20
*** SHOW DOWN ***
creezy.by: shows [Tc Jc] (three of a kind, Jacks)
Comra1d: mucks hand=20
creezy.by collected $0.69 from pot
*** SUMMARY ***
Total pot $0.71 | Rake $0.02=20
Board [Jh 7d Jd 5s 2h]
Seat 2: the_wickstar folded before Flop (didn't bet)
Seat 3: Comra1d (button) mucked [9c 9h]
Seat 4: Irvade (small blind) folded before Flop
Seat 5: Gabeleleu_np (big blind) folded on the River
Seat 6: hashex folded before Flop (didn't bet)
Seat 7: creezy.by showed [Tc Jc] and won ($0.69) with three of a kind, =
Jacks
Seat 8: TJAbram folded before Flop (didn't bet)
Seat 9: MDS17 folded before Flop (didn't bet)


*********** # 106 **************
PokerStars Hand #169563481289:  Hold'em No Limit ($0.01/$0.02 USD) - 20=
17/04/26 10:07:28 CUST [2017/04/25 20:07:28 ET]
Table 'Irus' 9-max Seat #6 is the button
Seat 1: manugar91 ($3.84 in chips)=20
Seat 2: FuriousCards ($0.63 in chips)=20
Seat 3: papin1988 ($2.04 in chips)=20
Seat 4: the_wickstar ($1.39 in chips)=20
Seat 5: Adashko#1 ($2.12 in chips)=20
Seat 6: konex ($1.98 in chips)=20
Seat 7: shunysun68 ($0.78 in chips)=20
Seat 8: bubamix ($4.49 in chips)=20
Seat 9: duulemes ($0.72 in chips)=20
shunysun68: posts small blind $0.01
bubamix: posts big blind $0.02
*** HOLE CARDS ***
Dealt to the_wickstar [Qc 6d]
duulemes: calls $0.02
manugar91: folds=20
FuriousCards: folds=20
papin1988: folds=20
the_wickstar: calls $0.02
Adashko#1: folds=20
konex: folds=20
shunysun68: raises $0.08 to $0.10
manugar91 leaves the table
bubamix: folds=20
hard nutss joins the table at seat #1=20
duulemes: folds=20
the_wickstar: folds=20
Uncalled bet ($0.08) returned to shunysun68
shunysun68 collected $0.08 from pot
*** SUMMARY ***
Total pot $0.08 | Rake $0=20
Seat 1: manugar91 folded before Flop (didn't bet)
Seat 2: FuriousCards folded before Flop (didn't bet)
Seat 3: papin1988 folded before Flop (didn't bet)
Seat 4: the_wickstar folded before Flop
Seat 5: Adashko#1 folded before Flop (didn't bet)
Seat 6: konex (button) folded before Flop (didn't bet)
Seat 7: shunysun68 (small blind) collected ($0.08)
Seat 8: bubamix (big blind) folded before Flop
Seat 9: duulemes folded before Flop


*********** # 107 **************
PokerStars Hand #169563472858:  Hold'em No Limit ($0.01/$0.02 USD) - 20=
17/04/26 10:07:11 CUST [2017/04/25 20:07:11 ET]
Table 'Ulrike' 9-max Seat #2 is the button
Seat 2: the_wickstar ($0.97 in chips)=20
Seat 3: Comra1d ($2.39 in chips)=20
Seat 4: Irvade ($2.43 in chips)=20
Seat 5: Gabeleleu_np ($1.92 in chips)=20
Seat 6: hashex ($2 in chips)=20
Seat 7: creezy.by ($1.36 in chips)=20
Seat 8: TJAbram ($0.81 in chips)=20
Seat 9: MDS17 ($4.20 in chips)=20
Comra1d: posts small blind $0.01
Irvade: posts big blind $0.02
*** HOLE CARDS ***
Dealt to the_wickstar [Jh 3d]
Gabeleleu_np: folds=20
hashex: folds=20
creezy.by: folds=20
TJAbram: folds=20
MDS17: calls $0.02
the_wickstar: calls $0.02
Comra1d: folds=20
Irvade: checks=20
*** FLOP *** [Ts Th 2s]
ELECTROZOR joins the table at seat #1=20
Irvade: checks=20
MDS17: checks=20
the_wickstar: bets $0.03
Irvade: folds=20
MDS17: folds=20
Uncalled bet ($0.03) returned to the_wickstar
the_wickstar collected $0.07 from pot
*** SUMMARY ***
Total pot $0.07 | Rake $0=20
Board [Ts Th 2s]
Seat 2: the_wickstar (button) collected ($0.07)
Seat 3: Comra1d (small blind) folded before Flop
Seat 4: Irvade (big blind) folded on the Flop
Seat 5: Gabeleleu_np folded before Flop (didn't bet)
Seat 6: hashex folded before Flop (didn't bet)
Seat 7: creezy.by folded before Flop (didn't bet)
Seat 8: TJAbram folded before Flop (didn't bet)
Seat 9: MDS17 folded on the Flop


*********** # 108 **************
PokerStars Hand #169563460631:  Hold'em No Limit ($0.01/$0.02 USD) - 20=
17/04/26 10:06:47 CUST [2017/04/25 20:06:47 ET]
Table 'Irus' 9-max Seat #5 is the button
Seat 1: manugar91 ($3.84 in chips)=20
Seat 2: FuriousCards ($0.63 in chips)=20
Seat 3: papin1988 ($2.04 in chips)=20
Seat 4: the_wickstar ($1.31 in chips)=20
Seat 5: Adashko#1 ($2.12 in chips)=20
Seat 6: konex ($1.99 in chips)=20
Seat 7: shunysun68 ($0.80 in chips)=20
Seat 8: bubamix ($4.49 in chips)=20
Seat 9: duulemes ($0.78 in chips)=20
konex: posts small blind $0.01
shunysun68: posts big blind $0.02
*** HOLE CARDS ***
Dealt to the_wickstar [Td As]
bubamix: folds=20
duulemes: calls $0.02
manugar91: folds=20
FuriousCards: folds=20
papin1988: folds=20
the_wickstar: raises $0.04 to $0.06
Adashko#1: folds=20
konex: folds=20
shunysun68: folds=20
duulemes: calls $0.04
*** FLOP *** [Jd Jh Ac]
duulemes: checks=20
the_wickstar: checks=20
*** TURN *** [Jd Jh Ac] [3c]
duulemes: checks=20
the_wickstar: bets $0.07
duulemes: folds=20
Uncalled bet ($0.07) returned to the_wickstar
the_wickstar collected $0.14 from pot
*** SUMMARY ***
Total pot $0.15 | Rake $0.01=20
Board [Jd Jh Ac 3c]
Seat 1: manugar91 folded before Flop (didn't bet)
Seat 2: FuriousCards folded before Flop (didn't bet)
Seat 3: papin1988 folded before Flop (didn't bet)
Seat 4: the_wickstar collected ($0.14)
Seat 5: Adashko#1 (button) folded before Flop (didn't bet)
Seat 6: konex (small blind) folded before Flop
Seat 7: shunysun68 (big blind) folded before Flop
Seat 8: bubamix folded before Flop (didn't bet)
Seat 9: duulemes folded on the Turn


*********** # 109 **************
PokerStars Hand #169563453481:  Hold'em No Limit ($0.01/$0.02 USD) - 20=
17/04/26 10:06:33 CUST [2017/04/25 20:06:33 ET]
Table 'Ulrike' 9-max Seat #9 is the button
Seat 2: the_wickstar ($0.98 in chips)=20
Seat 3: Comra1d ($2.41 in chips)=20
Seat 4: Irvade ($2.43 in chips)=20
Seat 5: Gabeleleu_np ($1.89 in chips)=20
Seat 6: hashex ($2 in chips)=20
Seat 7: creezy.by ($1.36 in chips)=20
Seat 8: TJAbram ($0.81 in chips)=20
Seat 9: MDS17 ($4.20 in chips)=20
the_wickstar: posts small blind $0.01
Comra1d: posts big blind $0.02
*** HOLE CARDS ***
Dealt to the_wickstar [8d 6h]
Irvade: folds=20
Gabeleleu_np: raises $0.04 to $0.06
hashex: folds=20
creezy.by: folds=20
TJAbram: folds=20
MDS17: folds=20
the_wickstar: folds=20
Comra1d: folds=20
Uncalled bet ($0.04) returned to Gabeleleu_np
Gabeleleu_np collected $0.05 from pot
Gabeleleu_np: doesn't show hand=20
*** SUMMARY ***
Total pot $0.05 | Rake $0=20
Seat 2: the_wickstar (small blind) folded before Flop
Seat 3: Comra1d (big blind) folded before Flop
Seat 4: Irvade folded before Flop (didn't bet)
Seat 5: Gabeleleu_np collected ($0.05)
Seat 6: hashex folded before Flop (didn't bet)
Seat 7: creezy.by folded before Flop (didn't bet)
Seat 8: TJAbram folded before Flop (didn't bet)
Seat 9: MDS17 (button) folded before Flop (didn't bet)


*********** # 110 **************
PokerStars Hand #169563427135:  Hold'em No Limit ($0.01/$0.02 USD) - 20=
17/04/26 10:05:42 CUST [2017/04/25 20:05:42 ET]
Table 'Ulrike' 9-max Seat #8 is the button
Seat 2: the_wickstar ($1 in chips)=20
Seat 3: Comra1d ($2.41 in chips)=20
Seat 4: Irvade ($2.43 in chips)=20
Seat 5: Gabeleleu_np ($1.75 in chips)=20
Seat 6: hashex ($2 in chips)=20
Seat 7: creezy.by ($1.48 in chips)=20
Seat 8: TJAbram ($0.81 in chips)=20
Seat 9: MDS17 ($4.21 in chips)=20
MDS17: posts small blind $0.01
nimzoindia: is sitting out=20
nimzoindia leaves the table
the_wickstar: posts big blind $0.02
*** HOLE CARDS ***
Dealt to the_wickstar [5s 4s]
Comra1d: folds=20
Irvade: folds=20
Gabeleleu_np: raises $0.04 to $0.06
hashex: folds=20
creezy.by: calls $0.06
TJAbram: folds=20
MDS17: folds=20
the_wickstar: folds=20
*** FLOP *** [2h 6h 2d]
Gabeleleu_np: checks=20
creezy.by: checks=20
*** TURN *** [2h 6h 2d] [3d]
Gabeleleu_np: checks=20
creezy.by: checks=20
*** RIVER *** [2h 6h 2d 3d] [5d]
Gabeleleu_np: checks=20
creezy.by: bets $0.06
Gabeleleu_np: calls $0.06
*** SHOW DOWN ***
creezy.by: shows [Tc 9c] (a pair of Deuces)
Gabeleleu_np: shows [Ad Kh] (a pair of Deuces - Ace kicker)
Gabeleleu_np collected $0.26 from pot
*** SUMMARY ***
Total pot $0.27 | Rake $0.01=20
Board [2h 6h 2d 3d 5d]
Seat 2: the_wickstar (big blind) folded before Flop
Seat 3: Comra1d folded before Flop (didn't bet)
Seat 4: Irvade folded before Flop (didn't bet)
Seat 5: Gabeleleu_np showed [Ad Kh] and won ($0.26) with a pair of Deuc=
es
Seat 6: hashex folded before Flop (didn't bet)
Seat 7: creezy.by showed [Tc 9c] and lost with a pair of Deuces
Seat 8: TJAbram (button) folded before Flop (didn't bet)
Seat 9: MDS17 (small blind) folded before Flop


*********** # 111 **************
PokerStars Hand #169563418347:  Hold'em No Limit ($0.01/$0.02 USD) - 20=
17/04/26 10:05:25 CUST [2017/04/25 20:05:25 ET]
Table 'Irus' 9-max Seat #4 is the button
Seat 1: manugar91 ($3.84 in chips)=20
Seat 2: FuriousCards ($0.63 in chips)=20
Seat 3: papin1988 ($2.04 in chips)=20
Seat 4: the_wickstar ($1.28 in chips)=20
Seat 5: Adashko#1 ($2.13 in chips)=20
Seat 6: konex ($2.01 in chips)=20
Seat 8: bubamix ($4.49 in chips)=20
Seat 9: duulemes ($0.78 in chips)=20
Adashko#1: posts small blind $0.01
konex: posts big blind $0.02
shunysun68: sits out=20
*** HOLE CARDS ***
Dealt to the_wickstar [5h 4d]
bubamix: folds=20
duulemes: folds=20
manugar91: folds=20
FuriousCards: folds=20
papin1988: folds=20
the_wickstar: calls $0.02
Adashko#1: folds=20
konex: checks=20
*** FLOP *** [Ts Qs 2h]
konex: checks=20
the_wickstar: bets $0.03
konex: folds=20
Uncalled bet ($0.03) returned to the_wickstar
the_wickstar collected $0.05 from pot
*** SUMMARY ***
Total pot $0.05 | Rake $0=20
Board [Ts Qs 2h]
Seat 1: manugar91 folded before Flop (didn't bet)
Seat 2: FuriousCards folded before Flop (didn't bet)
Seat 3: papin1988 folded before Flop (didn't bet)
Seat 4: the_wickstar (button) collected ($0.05)
Seat 5: Adashko#1 (small blind) folded before Flop
Seat 6: konex (big blind) folded on the Flop
Seat 8: bubamix folded before Flop (didn't bet)
Seat 9: duulemes folded before Flop (didn't bet)


*********** # 112 **************
PokerStars Hand #169563407682:  Hold'em No Limit ($0.01/$0.02 USD) - 20=
17/04/26 10:05:04 CUST [2017/04/25 20:05:04 ET]
Table 'Ulrike' 9-max Seat #7 is the button
Seat 1: nimzoindia ($2.36 in chips)=20
Seat 2: the_wickstar ($1.02 in chips)=20
Seat 3: Comra1d ($2.41 in chips)=20
Seat 4: Irvade ($2.43 in chips)=20
Seat 5: Gabeleleu_np ($1.75 in chips)=20
Seat 6: hashex ($2 in chips)=20
Seat 7: creezy.by ($1.48 in chips)=20
Seat 8: TJAbram ($0.82 in chips)=20
Seat 9: MDS17 ($4.08 in chips)=20
TJAbram: posts small blind $0.01
MDS17: posts big blind $0.02
*** HOLE CARDS ***
Dealt to the_wickstar [Jc Ts]
nimzoindia: folds=20
the_wickstar: calls $0.02
Comra1d: folds=20
Irvade: folds=20
Gabeleleu_np: folds=20
hashex: raises $0.08 to $0.10
creezy.by: folds=20
TJAbram: folds=20
MDS17: raises $0.23 to $0.33
the_wickstar: folds=20
hashex: folds=20
Uncalled bet ($0.23) returned to MDS17
MDS17 collected $0.23 from pot
*** SUMMARY ***
Total pot $0.23 | Rake $0=20
Seat 1: nimzoindia folded before Flop (didn't bet)
Seat 2: the_wickstar folded before Flop
Seat 3: Comra1d folded before Flop (didn't bet)
Seat 4: Irvade folded before Flop (didn't bet)
Seat 5: Gabeleleu_np folded before Flop (didn't bet)
Seat 6: hashex folded before Flop
Seat 7: creezy.by (button) folded before Flop (didn't bet)
Seat 8: TJAbram (small blind) folded before Flop
Seat 9: MDS17 (big blind) collected ($0.23)


*********** # 113 **************
PokerStars Hand #169563381609:  Hold'em No Limit ($0.01/$0.02 USD) - 20=
17/04/26 10:04:13 CUST [2017/04/25 20:04:13 ET]
Table 'Irus' 9-max Seat #3 is the button
Seat 1: manugar91 ($3.84 in chips)=20
Seat 2: FuriousCards ($0.63 in chips)=20
Seat 3: papin1988 ($2.04 in chips)=20
Seat 4: the_wickstar ($1.29 in chips)=20
Seat 5: Adashko#1 ($2.15 in chips)=20
Seat 6: konex ($2.25 in chips)=20
Seat 8: bubamix ($4.22 in chips)=20
Seat 9: duulemes ($0.80 in chips)=20
the_wickstar: posts small blind $0.01
Adashko#1: posts big blind $0.02
shunysun68: sits out=20
duulemes: posts big blind $0.02
*** HOLE CARDS ***
Dealt to the_wickstar [Qd 5d]
konex: raises $0.04 to $0.06
bubamix: raises $0.06 to $0.12
duulemes: folds=20
manugar91: folds=20
FuriousCards: folds=20
papin1988: folds=20
the_wickstar: folds=20
Adashko#1: folds=20
konex: calls $0.06
*** FLOP *** [4s 5s 7h]
konex: bets $0.06
bubamix: raises $0.06 to $0.12
konex: calls $0.06
*** TURN *** [4s 5s 7h] [Tc]
konex: checks=20
bubamix: checks=20
*** RIVER *** [4s 5s 7h Tc] [5c]
konex: checks=20
bubamix: bets $0.51
konex: folds=20
Uncalled bet ($0.51) returned to bubamix
bubamix collected $0.51 from pot
bubamix: doesn't show hand=20
*** SUMMARY ***
Total pot $0.53 | Rake $0.02=20
Board [4s 5s 7h Tc 5c]
Seat 1: manugar91 folded before Flop (didn't bet)
Seat 2: FuriousCards folded before Flop (didn't bet)
Seat 3: papin1988 (button) folded before Flop (didn't bet)
Seat 4: the_wickstar (small blind) folded before Flop
Seat 5: Adashko#1 (big blind) folded before Flop
Seat 6: konex folded on the River
Seat 8: bubamix collected ($0.51)
Seat 9: duulemes folded before Flop


*********** # 114 **************
PokerStars Hand #169563360614:  Hold'em No Limit ($0.01/$0.02 USD) - 20=
17/04/26 10:03:32 CUST [2017/04/25 20:03:32 ET]
Table 'Ulrike' 9-max Seat #6 is the button
Seat 1: nimzoindia ($2.36 in chips)=20
Seat 2: the_wickstar ($1.04 in chips)=20
Seat 3: Comra1d ($2.41 in chips)=20
Seat 4: Irvade ($2.45 in chips)=20
Seat 5: Gabeleleu_np ($1.60 in chips)=20
Seat 6: hashex ($2 in chips)=20
Seat 7: creezy.by ($1.54 in chips)=20
Seat 8: TJAbram ($0.88 in chips)=20
Seat 9: MDS17 ($4.08 in chips)=20
creezy.by: posts small blind $0.01
TJAbram: posts big blind $0.02
Gabeleleu_np: posts big blind $0.02
*** HOLE CARDS ***
Dealt to the_wickstar [7s 4s]
MDS17: folds=20
nimzoindia: folds=20
the_wickstar: calls $0.02
Comra1d: folds=20
Irvade: calls $0.02
Gabeleleu_np: checks=20
hashex: folds=20
creezy.by: calls $0.01
TJAbram: checks=20
*** FLOP *** [8h Ad Qc]
creezy.by: checks=20
TJAbram: checks=20
the_wickstar: checks=20
Irvade: checks=20
Gabeleleu_np: checks=20
*** TURN *** [8h Ad Qc] [Qd]
creezy.by: checks=20
TJAbram: bets $0.04
the_wickstar: folds=20
Irvade: folds=20
Gabeleleu_np: calls $0.04
creezy.by: calls $0.04
*** RIVER *** [8h Ad Qc Qd] [As]
creezy.by: checks=20
TJAbram: checks=20
Gabeleleu_np: checks=20
*** SHOW DOWN ***
creezy.by: shows [5d 5s] (two pair, Aces and Queens)
TJAbram: shows [6d Js] (two pair, Aces and Queens - Jack kicker)
Gabeleleu_np: shows [3d Kd] (two pair, Aces and Queens - King kicker)
Gabeleleu_np collected $0.21 from pot
*** SUMMARY ***
Total pot $0.22 | Rake $0.01=20
Board [8h Ad Qc Qd As]
Seat 1: nimzoindia folded before Flop (didn't bet)
Seat 2: the_wickstar folded on the Turn
Seat 3: Comra1d folded before Flop (didn't bet)
Seat 4: Irvade folded on the Turn
Seat 5: Gabeleleu_np showed [3d Kd] and won ($0.21) with two pair, Aces=
 and Queens
Seat 6: hashex (button) folded before Flop (didn't bet)
Seat 7: creezy.by (small blind) showed [5d 5s] and lost with two pair, =
Aces and Queens
Seat 8: TJAbram (big blind) showed [6d Js] and lost with two pair, Aces=
 and Queens
Seat 9: MDS17 folded before Flop (didn't bet)


*********** # 115 **************
PokerStars Hand #169563358435:  Hold'em No Limit ($0.01/$0.02 USD) - 20=
17/04/26 10:03:28 CUST [2017/04/25 20:03:28 ET]
Table 'Irus' 9-max Seat #2 is the button
Seat 1: manugar91 ($3.84 in chips)=20
Seat 2: FuriousCards ($0.60 in chips)=20
Seat 3: papin1988 ($2.05 in chips)=20
Seat 4: the_wickstar ($1.31 in chips)=20
Seat 5: Adashko#1 ($2.15 in chips)=20
Seat 6: konex ($2.25 in chips)=20
Seat 8: bubamix ($4.22 in chips)=20
papin1988: posts small blind $0.01
the_wickstar: posts big blind $0.02
shunysun68: sits out=20
duulemes: sits out=20
*** HOLE CARDS ***
Dealt to the_wickstar [3c Qc]
Adashko#1: folds=20
konex: folds=20
bubamix: folds=20
manugar91: folds=20
FuriousCards: calls $0.02
papin1988: folds=20
the_wickstar: checks=20
*** FLOP *** [5c 4d 8s]
the_wickstar: checks=20
FuriousCards: checks=20
*** TURN *** [5c 4d 8s] [Kc]
the_wickstar: checks=20
FuriousCards: checks=20
*** RIVER *** [5c 4d 8s Kc] [6s]
the_wickstar: checks=20
FuriousCards: checks=20
*** SHOW DOWN ***
the_wickstar: shows [3c Qc] (high card King)
FuriousCards: shows [Td Ts] (a pair of Tens)
FuriousCards collected $0.05 from pot
*** SUMMARY ***
Total pot $0.05 | Rake $0=20
Board [5c 4d 8s Kc 6s]
Seat 1: manugar91 folded before Flop (didn't bet)
Seat 2: FuriousCards (button) showed [Td Ts] and won ($0.05) with a pai=
r of Tens
Seat 3: papin1988 (small blind) folded before Flop
Seat 4: the_wickstar (big blind) showed [3c Qc] and lost with high card=
 King
Seat 5: Adashko#1 folded before Flop (didn't bet)
Seat 6: konex folded before Flop (didn't bet)
Seat 8: bubamix folded before Flop (didn't bet)


*********** # 116 **************
PokerStars Hand #169563338385:  Hold'em No Limit ($0.01/$0.02 USD) - 20=
17/04/26 10:02:48 CUST [2017/04/25 20:02:48 ET]
Table 'Ulrike' 9-max Seat #4 is the button
Seat 1: nimzoindia ($2.27 in chips)=20
Seat 2: the_wickstar ($1.04 in chips)=20
Seat 3: Comra1d ($2.48 in chips)=20
Seat 4: Irvade ($2.45 in chips)=20
Seat 6: hashex ($2 in chips)=20
Seat 7: creezy.by ($1.56 in chips)=20
Seat 8: TJAbram ($0.88 in chips)=20
Seat 9: MDS17 ($4.08 in chips)=20
hashex: posts small blind $0.01
creezy.by: posts big blind $0.02
*** HOLE CARDS ***
Dealt to the_wickstar [Ks 6d]
Gabeleleu_np joins the table at seat #5=20
TJAbram: folds=20
MDS17: folds=20
nimzoindia: raises $0.05 to $0.07
the_wickstar: folds=20
Comra1d: calls $0.07
Irvade: folds=20
hashex: folds=20
creezy.by: folds=20
*** FLOP *** [Ah 5c Qd]
nimzoindia: bets $0.12
Comra1d: folds=20
Uncalled bet ($0.12) returned to nimzoindia
nimzoindia collected $0.16 from pot
nimzoindia: doesn't show hand=20
*** SUMMARY ***
Total pot $0.17 | Rake $0.01=20
Board [Ah 5c Qd]
Seat 1: nimzoindia collected ($0.16)
Seat 2: the_wickstar folded before Flop (didn't bet)
Seat 3: Comra1d folded on the Flop
Seat 4: Irvade (button) folded before Flop (didn't bet)
Seat 6: hashex (small blind) folded before Flop
Seat 7: creezy.by (big blind) folded before Flop
Seat 8: TJAbram folded before Flop (didn't bet)
Seat 9: MDS17 folded before Flop (didn't bet)


*********** # 117 **************
PokerStars Hand #169563331527:  Hold'em No Limit ($0.01/$0.02 USD) - 20=
17/04/26 10:02:34 CUST [2017/04/25 20:02:34 ET]
Table 'Irus' 9-max Seat #1 is the button
Seat 1: manugar91 ($3.84 in chips)=20
Seat 2: FuriousCards ($0.61 in chips)=20
Seat 3: papin1988 ($2 in chips)=20
Seat 4: the_wickstar ($1.31 in chips)=20
Seat 5: Adashko#1 ($2.15 in chips)=20
Seat 6: konex ($2.29 in chips)=20
Seat 8: bubamix ($4.22 in chips)=20
FuriousCards: posts small blind $0.01
papin1988: posts big blind $0.02
shunysun68: sits out=20
duulemes: sits out=20
*** HOLE CARDS ***
Dealt to the_wickstar [9c 2h]
the_wickstar: folds=20
Adashko#1: folds=20
konex: raises $0.02 to $0.04
bubamix: folds=20
manugar91: folds=20
FuriousCards: folds=20
papin1988: calls $0.02
*** FLOP *** [Ac 7s Tc]
papin1988: checks=20
konex: checks=20
*** TURN *** [Ac 7s Tc] [5c]
papin1988: bets $0.09
konex: folds=20
Uncalled bet ($0.09) returned to papin1988
papin1988 collected $0.09 from pot
*** SUMMARY ***
Total pot $0.09 | Rake $0=20
Board [Ac 7s Tc 5c]
Seat 1: manugar91 (button) folded before Flop (didn't bet)
Seat 2: FuriousCards (small blind) folded before Flop
Seat 3: papin1988 (big blind) collected ($0.09)
Seat 4: the_wickstar folded before Flop (didn't bet)
Seat 5: Adashko#1 folded before Flop (didn't bet)
Seat 6: konex folded on the Turn
Seat 8: bubamix folded before Flop (didn't bet)


*********** # 118 **************
PokerStars Hand #169563310322:  Hold'em No Limit ($0.01/$0.02 USD) - 20=
17/04/26 10:01:52 CUST [2017/04/25 20:01:52 ET]
Table 'Ulrike' 9-max Seat #3 is the button
Seat 1: nimzoindia ($2.27 in chips)=20
Seat 2: the_wickstar ($1.04 in chips)=20
Seat 3: Comra1d ($2.45 in chips)=20
Seat 4: Irvade ($2.46 in chips)=20
Seat 6: hashex ($2 in chips)=20
Seat 7: creezy.by ($1.56 in chips)=20
Seat 8: TJAbram ($0.88 in chips)=20
Seat 9: MDS17 ($4.08 in chips)=20
Irvade: posts small blind $0.01
hashex: posts big blind $0.02
*** HOLE CARDS ***
Dealt to the_wickstar [Ts 6d]
creezy.by: folds=20
TJAbram: folds=20
MDS17: folds=20
nimzoindia: folds=20
the_wickstar: folds=20
Comra1d: raises $0.03 to $0.05
Irvade: folds=20
hashex: folds=20
Uncalled bet ($0.03) returned to Comra1d
Comra1d collected $0.05 from pot
Comra1d: doesn't show hand=20
*** SUMMARY ***
Total pot $0.05 | Rake $0=20
Seat 1: nimzoindia folded before Flop (didn't bet)
Seat 2: the_wickstar folded before Flop (didn't bet)
Seat 3: Comra1d (button) collected ($0.05)
Seat 4: Irvade (small blind) folded before Flop
Seat 6: hashex (big blind) folded before Flop
Seat 7: creezy.by folded before Flop (didn't bet)
Seat 8: TJAbram folded before Flop (didn't bet)
Seat 9: MDS17 folded before Flop (didn't bet)


*********** # 119 **************
PokerStars Hand #169563302494:  Hold'em No Limit ($0.01/$0.02 USD) - 20=
17/04/26 10:01:37 CUST [2017/04/25 20:01:37 ET]
Table 'Irus' 9-max Seat #8 is the button
Seat 1: manugar91 ($3.85 in chips)=20
Seat 2: FuriousCards ($0.80 in chips)=20
Seat 3: papin1988 ($2 in chips)=20
Seat 4: the_wickstar ($1.12 in chips)=20
Seat 5: Adashko#1 ($2.15 in chips)=20
Seat 6: konex ($2.29 in chips)=20
Seat 8: bubamix ($4.22 in chips)=20
duulemes will be allowed to play after the button
manugar91: posts small blind $0.01
FuriousCards: posts big blind $0.02
shunysun68: sits out=20
*** HOLE CARDS ***
Dealt to the_wickstar [9h Ah]
papin1988: folds=20
the_wickstar: calls $0.02
Adashko#1: folds=20
konex: folds=20
bubamix: folds=20
manugar91: folds=20
FuriousCards: checks=20
*** FLOP *** [3h 5d 4h]
FuriousCards: checks=20
the_wickstar: checks=20
*** TURN *** [3h 5d 4h] [2h]
FuriousCards: bets $0.05
the_wickstar: calls $0.05
*** RIVER *** [3h 5d 4h 2h] [4s]
FuriousCards: bets $0.06
the_wickstar: raises $0.06 to $0.12
FuriousCards: calls $0.06
*** SHOW DOWN ***
the_wickstar: shows [9h Ah] (a flush, Ace high)
FuriousCards: mucks hand=20
the_wickstar collected $0.38 from pot
*** SUMMARY ***
Total pot $0.39 | Rake $0.01=20
Board [3h 5d 4h 2h 4s]
Seat 1: manugar91 (small blind) folded before Flop
Seat 2: FuriousCards (big blind) mucked [6c Jc]
Seat 3: papin1988 folded before Flop (didn't bet)
Seat 4: the_wickstar showed [9h Ah] and won ($0.38) with a flush, Ace h=
igh
Seat 5: Adashko#1 folded before Flop (didn't bet)
Seat 6: konex folded before Flop (didn't bet)
Seat 8: bubamix (button) folded before Flop (didn't bet)


*********** # 120 **************
PokerStars Hand #169563280471:  Hold'em No Limit ($0.01/$0.02 USD) - 20=
17/04/26 10:00:52 CUST [2017/04/25 20:00:52 ET]
Table 'Irus' 9-max Seat #6 is the button
Seat 1: manugar91 ($3.87 in chips)=20
Seat 3: papin1988 ($2 in chips)=20
Seat 4: the_wickstar ($1.09 in chips)=20
Seat 5: Adashko#1 ($2.15 in chips)=20
Seat 6: konex ($2.29 in chips)=20
Seat 8: bubamix ($4.23 in chips)=20
bubamix: posts small blind $0.01
manugar91: posts big blind $0.02
FuriousCards: sits out=20
*** HOLE CARDS ***
Dealt to the_wickstar [Ks Qh]
papin1988: folds=20
shunysun68 joins the table at seat #7=20
the_wickstar: raises $0.04 to $0.06
Adashko#1: folds=20
konex: folds=20
bubamix: folds=20
duulemes joins the table at seat #9=20
manugar91: folds=20
Uncalled bet ($0.04) returned to the_wickstar
the_wickstar collected $0.05 from pot
*** SUMMARY ***
Total pot $0.05 | Rake $0=20
Seat 1: manugar91 (big blind) folded before Flop
Seat 3: papin1988 folded before Flop (didn't bet)
Seat 4: the_wickstar collected ($0.05)
Seat 5: Adashko#1 folded before Flop (didn't bet)
Seat 6: konex (button) folded before Flop (didn't bet)
Seat 8: bubamix (small blind) folded before Flop


*********** # 121 **************
PokerStars Hand #169563269724:  Hold'em No Limit ($0.01/$0.02 USD) - 20=
17/04/26 10:00:29 CUST [2017/04/25 20:00:29 ET]
Table 'Ulrike' 9-max Seat #2 is the button
Seat 1: nimzoindia ($2.27 in chips)=20
Seat 2: the_wickstar ($1.10 in chips)=20
Seat 3: Comra1d ($2.46 in chips)=20
Seat 4: Irvade ($2.52 in chips)=20
Seat 6: hashex ($2 in chips)=20
Seat 7: creezy.by ($1.56 in chips)=20
Seat 8: TJAbram ($0.75 in chips)=20
Seat 9: MDS17 ($4.08 in chips)=20
Comra1d: posts small blind $0.01
Irvade: posts big blind $0.02
*** HOLE CARDS ***
Dealt to the_wickstar [Td Kh]
hashex: folds=20
creezy.by: folds=20
TJAbram: raises $0.02 to $0.04
MDS17: folds=20
nimzoindia: folds=20
the_wickstar: raises $0.02 to $0.06
Comra1d: folds=20
Irvade: calls $0.04
TJAbram: raises $0.19 to $0.25
the_wickstar: folds=20
Irvade: folds=20
Uncalled bet ($0.19) returned to TJAbram
TJAbram collected $0.19 from pot
TJAbram: doesn't show hand=20
*** SUMMARY ***
Total pot $0.19 | Rake $0=20
Seat 1: nimzoindia folded before Flop (didn't bet)
Seat 2: the_wickstar (button) folded before Flop
Seat 3: Comra1d (small blind) folded before Flop
Seat 4: Irvade (big blind) folded before Flop
Seat 6: hashex folded before Flop (didn't bet)
Seat 7: creezy.by folded before Flop (didn't bet)
Seat 8: TJAbram collected ($0.19)
Seat 9: MDS17 folded before Flop (didn't bet)


*********** # 122 **************
PokerStars Hand #169563251514:  Hold'em No Limit ($0.01/$0.02 USD) - 20=
17/04/26 9:59:48 CUST [2017/04/25 19:59:48 ET]
Table 'Irus' 9-max Seat #5 is the button
Seat 1: manugar91 ($3.87 in chips)=20
Seat 3: papin1988 ($2 in chips)=20
Seat 4: the_wickstar ($1.09 in chips)=20
Seat 5: Adashko#1 ($2.15 in chips)=20
Seat 6: konex ($2.27 in chips)=20
Seat 8: bubamix ($4.25 in chips)=20
konex: posts small blind $0.01
letyrn: is sitting out=20
bubamix: posts big blind $0.02
letyrn leaves the table
FuriousCards: sits out=20
*** HOLE CARDS ***
Dealt to the_wickstar [5s Ks]
manugar91: folds=20
papin1988: folds=20
the_wickstar: folds=20
Adashko#1: folds=20
konex: calls $0.01
bubamix: checks=20
*** FLOP *** [2c Kd Kc]
konex: checks=20
bubamix: checks=20
*** TURN *** [2c Kd Kc] [5c]
konex: checks=20
bubamix: checks=20
*** RIVER *** [2c Kd Kc 5c] [3h]
konex: checks=20
bubamix: checks=20
*** SHOW DOWN ***
konex: shows [3d Ts] (two pair, Kings and Threes)
bubamix: mucks hand=20
konex collected $0.04 from pot
*** SUMMARY ***
Total pot $0.04 | Rake $0=20
Board [2c Kd Kc 5c 3h]
Seat 1: manugar91 folded before Flop (didn't bet)
Seat 3: papin1988 folded before Flop (didn't bet)
Seat 4: the_wickstar folded before Flop (didn't bet)
Seat 5: Adashko#1 (button) folded before Flop (didn't bet)
Seat 6: konex (small blind) showed [3d Ts] and won ($0.04) with two pai=
r, Kings and Threes
Seat 8: bubamix (big blind) mucked [9h Th]


*********** # 123 **************
PokerStars Hand #169563244617:  Hold'em No Limit ($0.01/$0.02 USD) - 20=
17/04/26 9:59:32 CUST [2017/04/25 19:59:32 ET]
Table 'Ulrike' 9-max Seat #1 is the button
Seat 1: nimzoindia ($2.35 in chips)=20
Seat 2: the_wickstar ($1.11 in chips)=20
Seat 3: Comra1d ($2.48 in chips)=20
Seat 4: Irvade ($2.52 in chips)=20
Seat 6: hashex ($2 in chips)=20
Seat 7: creezy.by ($1.46 in chips)=20
Seat 8: TJAbram ($0.75 in chips)=20
Seat 9: MDS17 ($4.08 in chips)=20
the_wickstar: posts small blind $0.01
Comra1d: posts big blind $0.02
*** HOLE CARDS ***
Dealt to the_wickstar [9c 7d]
Irvade: folds=20
hashex: folds=20
creezy.by: raises $0.06 to $0.08
TJAbram: folds=20
MDS17: folds=20
nimzoindia: calls $0.08
the_wickstar: folds=20
Comra1d: folds=20
*** FLOP *** [8d 5h Ts]
creezy.by: bets $0.08
nimzoindia: folds=20
Uncalled bet ($0.08) returned to creezy.by
creezy.by collected $0.18 from pot
*** SUMMARY ***
Total pot $0.19 | Rake $0.01=20
Board [8d 5h Ts]
Seat 1: nimzoindia (button) folded on the Flop
Seat 2: the_wickstar (small blind) folded before Flop
Seat 3: Comra1d (big blind) folded before Flop
Seat 4: Irvade folded before Flop (didn't bet)
Seat 6: hashex folded before Flop (didn't bet)
Seat 7: creezy.by collected ($0.18)
Seat 8: TJAbram folded before Flop (didn't bet)
Seat 9: MDS17 folded before Flop (didn't bet)


*********** # 124 **************
PokerStars Hand #169563224195:  Hold'em No Limit ($0.01/$0.02 USD) - 20=
17/04/26 9:58:46 CUST [2017/04/25 19:58:46 ET]
Table 'Irus' 9-max Seat #4 is the button
Seat 1: manugar91 ($3.87 in chips)=20
Seat 3: papin1988 ($2 in chips)=20
Seat 4: the_wickstar ($1.15 in chips)=20
Seat 5: Adashko#1 ($2.01 in chips)=20
Seat 6: konex ($2.29 in chips)=20
Seat 7: letyrn ($0.71 in chips)=20
Seat 8: bubamix ($4.25 in chips)=20
Adashko#1: posts small blind $0.01
konex: posts big blind $0.02
FuriousCards: sits out=20
*** HOLE CARDS ***
Dealt to the_wickstar [Tc Jd]
letyrn: folds=20
bubamix: folds=20
manugar91: folds=20
papin1988: raises $0.04 to $0.06
the_wickstar: calls $0.06
Adashko#1: raises $0.20 to $0.26
konex: folds=20
papin1988: folds=20
the_wickstar: folds=20
Uncalled bet ($0.20) returned to Adashko#1
Adashko#1 collected $0.20 from pot
Adashko#1: doesn't show hand=20
*** SUMMARY ***
Total pot $0.20 | Rake $0=20
Seat 1: manugar91 folded before Flop (didn't bet)
Seat 3: papin1988 folded before Flop
Seat 4: the_wickstar (button) folded before Flop
Seat 5: Adashko#1 (small blind) collected ($0.20)
Seat 6: konex (big blind) folded before Flop
Seat 7: letyrn folded before Flop (didn't bet)
Seat 8: bubamix folded before Flop (didn't bet)


*********** # 125 **************
PokerStars Hand #169563214936:  Hold'em No Limit ($0.01/$0.02 USD) - 20=
17/04/26 9:58:25 CUST [2017/04/25 19:58:25 ET]
Table 'Irus' 9-max Seat #3 is the button
Seat 1: manugar91 ($3.84 in chips)=20
Seat 3: papin1988 ($2 in chips)=20
Seat 4: the_wickstar ($1.16 in chips)=20
Seat 5: Adashko#1 ($2.03 in chips)=20
Seat 6: konex ($2.29 in chips)=20
Seat 7: letyrn ($0.71 in chips)=20
Seat 8: bubamix ($4.25 in chips)=20
the_wickstar: posts small blind $0.01
Adashko#1: posts big blind $0.02
FuriousCards: sits out=20
*** HOLE CARDS ***
Dealt to the_wickstar [9c 5h]
konex: folds=20
letyrn: folds=20
bubamix: folds=20
manugar91: raises $0.03 to $0.05
papin1988: folds=20
the_wickstar: folds=20
Adashko#1: folds=20
Uncalled bet ($0.03) returned to manugar91
manugar91 collected $0.05 from pot
manugar91: doesn't show hand=20
*** SUMMARY ***
Total pot $0.05 | Rake $0=20
Seat 1: manugar91 collected ($0.05)
Seat 3: papin1988 (button) folded before Flop (didn't bet)
Seat 4: the_wickstar (small blind) folded before Flop
Seat 5: Adashko#1 (big blind) folded before Flop
Seat 6: konex folded before Flop (didn't bet)
Seat 7: letyrn folded before Flop (didn't bet)
Seat 8: bubamix folded before Flop (didn't bet)


*********** # 126 **************
PokerStars Hand #169563207229:  Hold'em No Limit ($0.01/$0.02 USD) - 20=
17/04/26 9:58:08 CUST [2017/04/25 19:58:08 ET]
Table 'Ulrike' 9-max Seat #9 is the button
Seat 1: nimzoindia ($2.36 in chips)=20
Seat 2: the_wickstar ($0.97 in chips)=20
Seat 3: Comra1d ($2.48 in chips)=20
Seat 4: Irvade ($2.52 in chips)=20
Seat 5: Jrenf2008 ($0.78 in chips)=20
Seat 6: hashex ($2 in chips)=20
Seat 7: creezy.by ($1.46 in chips)=20
Seat 8: TJAbram ($0.89 in chips)=20
Seat 9: MDS17 ($4.08 in chips)=20
nimzoindia: posts small blind $0.01
the_wickstar: posts big blind $0.02
*** HOLE CARDS ***
Dealt to the_wickstar [Jh 7d]
Comra1d: folds=20
Irvade: folds=20
Jrenf2008: folds=20
Jrenf2008 leaves the table
hashex: folds=20
creezy.by: folds=20
TJAbram: calls $0.02
MDS17: folds=20
nimzoindia: folds=20
the_wickstar: checks=20
*** FLOP *** [7s 4c 6d]
the_wickstar: bets $0.03
TJAbram: raises $0.03 to $0.06
the_wickstar: calls $0.03
*** TURN *** [7s 4c 6d] [Ks]
the_wickstar: checks=20
TJAbram: bets $0.06
the_wickstar: calls $0.06
*** RIVER *** [7s 4c 6d Ks] [7h]
the_wickstar: checks=20
TJAbram: checks=20
*** SHOW DOWN ***
the_wickstar: shows [Jh 7d] (three of a kind, Sevens)
TJAbram: mucks hand=20
the_wickstar collected $0.28 from pot
*** SUMMARY ***
Total pot $0.29 | Rake $0.01=20
Board [7s 4c 6d Ks 7h]
Seat 1: nimzoindia (small blind) folded before Flop
Seat 2: the_wickstar (big blind) showed [Jh 7d] and won ($0.28) with th=
ree of a kind, Sevens
Seat 3: Comra1d folded before Flop (didn't bet)
Seat 4: Irvade folded before Flop (didn't bet)
Seat 5: Jrenf2008 folded before Flop (didn't bet)
Seat 6: hashex folded before Flop (didn't bet)
Seat 7: creezy.by folded before Flop (didn't bet)
Seat 8: TJAbram mucked [Ah 4s]
Seat 9: MDS17 (button) folded before Flop (didn't bet)


*********** # 127 **************
PokerStars Hand #169563194505:  Hold'em No Limit ($0.01/$0.02 USD) - 20=
17/04/26 9:57:39 CUST [2017/04/25 19:57:39 ET]
Table 'Irus' 9-max Seat #1 is the button
Seat 1: manugar91 ($3.84 in chips)=20
Seat 3: papin1988 ($2.04 in chips)=20
Seat 4: the_wickstar ($1.07 in chips)=20
Seat 5: Adashko#1 ($2.03 in chips)=20
Seat 6: konex ($2.29 in chips)=20
Seat 7: letyrn ($0.71 in chips)=20
Seat 8: bubamix ($4.25 in chips)=20
Seat 9: Vanek940 ($0.93 in chips)=20
FuriousCards will be allowed to play after the button
papin1988: posts small blind $0.01
the_wickstar: posts big blind $0.02
*** HOLE CARDS ***
Dealt to the_wickstar [4d Ad]
Adashko#1: folds=20
konex: folds=20
letyrn: folds=20
bubamix: folds=20
Vanek940: folds=20
manugar91: folds=20
papin1988: raises $0.02 to $0.04
the_wickstar: calls $0.02
*** FLOP *** [9h Ah 5s]
Vanek940 leaves the table
papin1988: bets $0.06
the_wickstar: calls $0.06
*** TURN *** [9h Ah 5s] [5h]
papin1988: checks=20
the_wickstar: bets $0.10
papin1988: folds=20
Uncalled bet ($0.10) returned to the_wickstar
the_wickstar collected $0.19 from pot
*** SUMMARY ***
Total pot $0.20 | Rake $0.01=20
Board [9h Ah 5s 5h]
Seat 1: manugar91 (button) folded before Flop (didn't bet)
Seat 3: papin1988 (small blind) folded on the Turn
Seat 4: the_wickstar (big blind) collected ($0.19)
Seat 5: Adashko#1 folded before Flop (didn't bet)
Seat 6: konex folded before Flop (didn't bet)
Seat 7: letyrn folded before Flop (didn't bet)
Seat 8: bubamix folded before Flop (didn't bet)
Seat 9: Vanek940 folded before Flop (didn't bet)


*********** # 128 **************
PokerStars Hand #169563182368:  Hold'em No Limit ($0.01/$0.02 USD) - 20=
17/04/26 9:57:11 CUST [2017/04/25 19:57:11 ET]
Table 'Ulrike' 9-max Seat #8 is the button
Seat 1: nimzoindia ($2.38 in chips)=20
Seat 2: the_wickstar ($0.97 in chips)=20
Seat 3: Comra1d ($2.48 in chips)=20
Seat 4: Irvade ($2.49 in chips)=20
Seat 5: Jrenf2008 ($0.78 in chips)=20
Seat 6: hashex ($2 in chips)=20
Seat 7: creezy.by ($1.46 in chips)=20
Seat 8: TJAbram ($0.89 in chips)=20
Seat 9: MDS17 ($4.09 in chips)=20
MDS17: posts small blind $0.01
nimzoindia: posts big blind $0.02
*** HOLE CARDS ***
Dealt to the_wickstar [3c 2h]
the_wickstar: folds=20
Comra1d: folds=20
Irvade: raises $0.04 to $0.06
Jrenf2008: folds=20
hashex: folds=20
creezy.by: folds=20
TJAbram: folds=20
MDS17: folds=20
nimzoindia: folds=20
Uncalled bet ($0.04) returned to Irvade
Irvade collected $0.05 from pot
Irvade: doesn't show hand=20
*** SUMMARY ***
Total pot $0.05 | Rake $0=20
Seat 1: nimzoindia (big blind) folded before Flop
Seat 2: the_wickstar folded before Flop (didn't bet)
Seat 3: Comra1d folded before Flop (didn't bet)
Seat 4: Irvade collected ($0.05)
Seat 5: Jrenf2008 folded before Flop (didn't bet)
Seat 6: hashex folded before Flop (didn't bet)
Seat 7: creezy.by folded before Flop (didn't bet)
Seat 8: TJAbram (button) folded before Flop (didn't bet)
Seat 9: MDS17 (small blind) folded before Flop


*********** # 129 **************
PokerStars Hand #169563168499:  Hold'em No Limit ($0.01/$0.02 USD) - 20=
17/04/26 9:56:48 CUST [2017/04/25 19:56:48 ET]
Table 'Irus' 9-max Seat #9 is the button
Seat 1: manugar91 ($3.84 in chips)=20
Seat 3: papin1988 ($2.05 in chips)=20
Seat 4: the_wickstar ($1.09 in chips)=20
Seat 5: Adashko#1 ($2.03 in chips)=20
Seat 6: konex ($2.29 in chips)=20
Seat 7: letyrn ($0.71 in chips)=20
Seat 8: bubamix ($4.37 in chips)=20
Seat 9: Vanek940 ($0.93 in chips)=20
manugar91: posts small blind $0.01
papin1988: posts big blind $0.02
*** HOLE CARDS ***
Dealt to the_wickstar [5h 5s]
the_wickstar: calls $0.02
Adashko#1: folds=20
konex: folds=20
letyrn: folds=20
bubamix: raises $0.10 to $0.12
Vanek940: folds=20
manugar91: raises $0.22 to $0.34
papin1988: calls $0.32
the_wickstar: folds=20
bubamix: folds=20
*** FLOP *** [Ts 8d 4s]
manugar91: bets $3.50 and is all-in
papin1988: calls $1.71 and is all-in
Uncalled bet ($1.79) returned to manugar91
FuriousCards joins the table at seat #2=20
*** TURN *** [Ts 8d 4s] [6h]
*** RIVER *** [Ts 8d 4s 6h] [Jc]
*** SHOW DOWN ***
manugar91: shows [Ks Kh] (a pair of Kings)
papin1988: shows [Kc Kd] (a pair of Kings)
manugar91 collected $2.05 from pot
papin1988 collected $2.04 from pot
*** SUMMARY ***
Total pot $4.24 | Rake $0.15=20
Board [Ts 8d 4s 6h Jc]
Seat 1: manugar91 (small blind) showed [Ks Kh] and won ($2.05) with a p=
air of Kings
Seat 3: papin1988 (big blind) showed [Kc Kd] and won ($2.04) with a pai=
r of Kings
Seat 4: the_wickstar folded before Flop
Seat 5: Adashko#1 folded before Flop (didn't bet)
Seat 6: konex folded before Flop (didn't bet)
Seat 7: letyrn folded before Flop (didn't bet)
Seat 8: bubamix folded before Flop
Seat 9: Vanek940 (button) folded before Flop (didn't bet)


*********** # 130 **************
PokerStars Hand #169563159800:  Hold'em No Limit ($0.01/$0.02 USD) - 20=
17/04/26 9:56:28 CUST [2017/04/25 19:56:28 ET]
Table 'Ulrike' 9-max Seat #7 is the button
Seat 1: nimzoindia ($2.38 in chips)=20
Seat 2: the_wickstar ($0.92 in chips)=20
Seat 3: Comra1d ($2.48 in chips)=20
Seat 4: Irvade ($2.49 in chips)=20
Seat 5: Jrenf2008 ($0.80 in chips)=20
Seat 6: hashex ($2 in chips)=20
Seat 7: creezy.by ($1.46 in chips)=20
Seat 8: TJAbram ($0.90 in chips)=20
Seat 9: MDS17 ($4.11 in chips)=20
TJAbram: posts small blind $0.01
MDS17: posts big blind $0.02
Jrenf2008: posts big blind $0.02
*** HOLE CARDS ***
Dealt to the_wickstar [Kd Ac]
nimzoindia: folds=20
the_wickstar: raises $0.04 to $0.06
Comra1d: folds=20
Irvade: folds=20
Jrenf2008: folds=20
hashex: folds=20
creezy.by: folds=20
TJAbram: folds=20
MDS17: folds=20
Uncalled bet ($0.04) returned to the_wickstar
the_wickstar collected $0.07 from pot
*** SUMMARY ***
Total pot $0.07 | Rake $0=20
Seat 1: nimzoindia folded before Flop (didn't bet)
Seat 2: the_wickstar collected ($0.07)
Seat 3: Comra1d folded before Flop (didn't bet)
Seat 4: Irvade folded before Flop (didn't bet)
Seat 5: Jrenf2008 folded before Flop
Seat 6: hashex folded before Flop (didn't bet)
Seat 7: creezy.by (button) folded before Flop (didn't bet)
Seat 8: TJAbram (small blind) folded before Flop
Seat 9: MDS17 (big blind) folded before Flop


*********** # 131 **************
PokerStars Hand #169563145119:  Hold'em No Limit ($0.01/$0.02 USD) - 20=
17/04/26 9:55:55 CUST [2017/04/25 19:55:55 ET]
Table 'Irus' 9-max Seat #8 is the button
Seat 1: manugar91 ($3.86 in chips)=20
Seat 2: YOOOOR ($1.07 in chips)=20
Seat 3: papin1988 ($2.05 in chips)=20
Seat 4: the_wickstar ($1.09 in chips)=20
Seat 5: Adashko#1 ($2.03 in chips)=20
Seat 6: konex ($2.35 in chips)=20
Seat 7: letyrn ($0.77 in chips)=20
Seat 8: bubamix ($4.37 in chips)=20
Seat 9: Vanek940 ($0.80 in chips)=20
Vanek940: posts small blind $0.01
manugar91: posts big blind $0.02
*** HOLE CARDS ***
Dealt to the_wickstar [4h 9s]
YOOOOR: folds=20
papin1988: folds=20
the_wickstar: folds=20
Adashko#1: folds=20
konex: raises $0.04 to $0.06
letyrn: calls $0.06
bubamix: folds=20
Vanek940: calls $0.05
manugar91: folds=20
*** FLOP *** [Ac Ad 7c]
Vanek940: checks=20
konex: checks=20
letyrn: checks=20
*** TURN *** [Ac Ad 7c] [Tc]
Vanek940: bets $0.10
konex: folds=20
YOOOOR leaves the table
letyrn: folds=20
Uncalled bet ($0.10) returned to Vanek940
Vanek940 collected $0.19 from pot
Vanek940: doesn't show hand=20
*** SUMMARY ***
Total pot $0.20 | Rake $0.01=20
Board [Ac Ad 7c Tc]
Seat 1: manugar91 (big blind) folded before Flop
Seat 2: YOOOOR folded before Flop (didn't bet)
Seat 3: papin1988 folded before Flop (didn't bet)
Seat 4: the_wickstar folded before Flop (didn't bet)
Seat 5: Adashko#1 folded before Flop (didn't bet)
Seat 6: konex folded on the Turn
Seat 7: letyrn folded on the Turn
Seat 8: bubamix (button) folded before Flop (didn't bet)
Seat 9: Vanek940 (small blind) collected ($0.19)


*********** # 132 **************
PokerStars Hand #169563127345:  Hold'em No Limit ($0.01/$0.02 USD) - 20=
17/04/26 9:55:15 CUST [2017/04/25 19:55:15 ET]
Table 'Irus' 9-max Seat #7 is the button
Seat 1: manugar91 ($3.86 in chips)=20
Seat 2: YOOOOR ($1.07 in chips)=20
Seat 3: papin1988 ($2.05 in chips)=20
Seat 4: the_wickstar ($1.09 in chips)=20
Seat 5: Adashko#1 ($2 in chips)=20
Seat 6: konex ($2.35 in chips)=20
Seat 7: letyrn ($0.77 in chips)=20
Seat 8: bubamix ($4.38 in chips)=20
Seat 9: Vanek940 ($0.80 in chips)=20
bubamix: posts small blind $0.01
Vanek940: posts big blind $0.02
*** HOLE CARDS ***
Dealt to the_wickstar [4s 8s]
manugar91: folds=20
YOOOOR: folds=20
papin1988: folds=20
the_wickstar: folds=20
Adashko#1: raises $0.04 to $0.06
konex: folds=20
letyrn: folds=20
bubamix: folds=20
Vanek940: folds=20
Uncalled bet ($0.04) returned to Adashko#1
Adashko#1 collected $0.05 from pot
Adashko#1: doesn't show hand=20
*** SUMMARY ***
Total pot $0.05 | Rake $0=20
Seat 1: manugar91 folded before Flop (didn't bet)
Seat 2: YOOOOR folded before Flop (didn't bet)
Seat 3: papin1988 folded before Flop (didn't bet)
Seat 4: the_wickstar folded before Flop (didn't bet)
Seat 5: Adashko#1 collected ($0.05)
Seat 6: konex folded before Flop (didn't bet)
Seat 7: letyrn (button) folded before Flop (didn't bet)
Seat 8: bubamix (small blind) folded before Flop
Seat 9: Vanek940 (big blind) folded before Flop


*********** # 133 **************
PokerStars Hand #169563119929:  Hold'em No Limit ($0.01/$0.02 USD) - 20=
17/04/26 9:55:00 CUST [2017/04/25 19:55:00 ET]
Table 'Ulrike' 9-max Seat #6 is the button
Seat 1: nimzoindia ($2.38 in chips)=20
Seat 2: the_wickstar ($1.18 in chips)=20
Seat 3: Comra1d ($2.48 in chips)=20
Seat 4: Irvade ($2.75 in chips)=20
Seat 6: hashex ($2 in chips)=20
Seat 7: creezy.by ($0.95 in chips)=20
Seat 8: TJAbram ($0.92 in chips)=20
Seat 9: MDS17 ($4.11 in chips)=20
creezy.by: posts small blind $0.01
TJAbram: posts big blind $0.02
Jrenf2008: sits out=20
*** HOLE CARDS ***
Dealt to the_wickstar [Jh Ac]
MDS17: folds=20
nimzoindia: folds=20
the_wickstar: calls $0.02
Comra1d: folds=20
Irvade: calls $0.02
hashex: folds=20
creezy.by: calls $0.01
TJAbram: checks=20
*** FLOP *** [4c Js 7s]
creezy.by: bets $0.08
TJAbram: folds=20
the_wickstar: calls $0.08
Irvade: calls $0.08
*** TURN *** [4c Js 7s] [Ts]
creezy.by: bets $0.16
the_wickstar: calls $0.16
Irvade: calls $0.16
*** RIVER *** [4c Js 7s Ts] [4s]
creezy.by: checks=20
the_wickstar: checks=20
Irvade: checks=20
*** SHOW DOWN ***
creezy.by: shows [8d 9d] (a straight, Seven to Jack)
the_wickstar: mucks hand=20
Irvade: mucks hand=20
creezy.by collected $0.77 from pot
*** SUMMARY ***
Total pot $0.80 | Rake $0.03=20
Board [4c Js 7s Ts 4s]
Seat 1: nimzoindia folded before Flop (didn't bet)
Seat 2: the_wickstar mucked [Jh Ac]
Seat 3: Comra1d folded before Flop (didn't bet)
Seat 4: Irvade mucked [Jc Kd]
Seat 6: hashex (button) folded before Flop (didn't bet)
Seat 7: creezy.by (small blind) showed [8d 9d] and won ($0.77) with a s=
traight, Seven to Jack
Seat 8: TJAbram (big blind) folded on the Flop
Seat 9: MDS17 folded before Flop (didn't bet)


*********** # 134 **************
PokerStars Hand #169563109744:  Hold'em No Limit ($0.01/$0.02 USD) - 20=
17/04/26 9:54:41 CUST [2017/04/25 19:54:41 ET]
Table 'Ulrike' 9-max Seat #4 is the button
Seat 1: nimzoindia ($2.38 in chips)=20
Seat 2: the_wickstar ($1.18 in chips)=20
Seat 3: Comra1d ($2.48 in chips)=20
Seat 4: Irvade ($2.75 in chips)=20
Seat 6: hashex ($2.01 in chips)=20
Seat 7: creezy.by ($0.94 in chips)=20
Seat 8: TJAbram ($0.92 in chips)=20
Seat 9: MDS17 ($4.11 in chips)=20
hashex: posts small blind $0.01
creezy.by: posts big blind $0.02
*** HOLE CARDS ***
Dealt to the_wickstar [6c 3h]
TJAbram: folds=20
MDS17: folds=20
nimzoindia: folds=20
the_wickstar: folds=20
Comra1d: folds=20
Irvade: folds=20
hashex: folds=20
Uncalled bet ($0.01) returned to creezy.by
creezy.by collected $0.02 from pot
Jrenf2008 joins the table at seat #5=20
*** SUMMARY ***
Total pot $0.02 | Rake $0=20
Seat 1: nimzoindia folded before Flop (didn't bet)
Seat 2: the_wickstar folded before Flop (didn't bet)
Seat 3: Comra1d folded before Flop (didn't bet)
Seat 4: Irvade (button) folded before Flop (didn't bet)
Seat 6: hashex (small blind) folded before Flop
Seat 7: creezy.by (big blind) collected ($0.02)
Seat 8: TJAbram folded before Flop (didn't bet)
Seat 9: MDS17 folded before Flop (didn't bet)


*********** # 135 **************
PokerStars Hand #169563106732:  Hold'em No Limit ($0.01/$0.02 USD) - 20=
17/04/26 9:54:35 CUST [2017/04/25 19:54:35 ET]
Table 'Irus' 9-max Seat #6 is the button
Seat 1: manugar91 ($3.77 in chips)=20
Seat 2: YOOOOR ($1.07 in chips)=20
Seat 3: papin1988 ($2.05 in chips)=20
Seat 4: the_wickstar ($1.09 in chips)=20
Seat 5: Adashko#1 ($2 in chips)=20
Seat 6: konex ($2.35 in chips)=20
Seat 7: letyrn ($0.78 in chips)=20
Seat 8: bubamix ($4.40 in chips)=20
Seat 9: Vanek940 ($0.83 in chips)=20
letyrn: posts small blind $0.01
bubamix: posts big blind $0.02
*** HOLE CARDS ***
Dealt to the_wickstar [5d 3c]
Vanek940: raises $0.04 to $0.06
manugar91: raises $0.12 to $0.18
YOOOOR: folds=20
papin1988: folds=20
the_wickstar: folds=20
Adashko#1: folds=20
konex: folds=20
letyrn: folds=20
bubamix: folds=20
Vanek940: folds=20
Uncalled bet ($0.12) returned to manugar91
manugar91 collected $0.15 from pot
manugar91: doesn't show hand=20
*** SUMMARY ***
Total pot $0.15 | Rake $0=20
Seat 1: manugar91 collected ($0.15)
Seat 2: YOOOOR folded before Flop (didn't bet)
Seat 3: papin1988 folded before Flop (didn't bet)
Seat 4: the_wickstar folded before Flop (didn't bet)
Seat 5: Adashko#1 folded before Flop (didn't bet)
Seat 6: konex (button) folded before Flop (didn't bet)
Seat 7: letyrn (small blind) folded before Flop
Seat 8: bubamix (big blind) folded before Flop
Seat 9: Vanek940 folded before Flop


*********** # 136 **************
PokerStars Hand #169563077013:  Hold'em No Limit ($0.01/$0.02 USD) - 20=
17/04/26 9:53:38 CUST [2017/04/25 19:53:38 ET]
Table 'Ulrike' 9-max Seat #3 is the button
Seat 1: nimzoindia ($2.38 in chips)=20
Seat 2: the_wickstar ($1.15 in chips)=20
Seat 3: Comra1d ($2.48 in chips)=20
Seat 4: Irvade ($2.76 in chips)=20
Seat 6: hashex ($2.03 in chips)=20
Seat 7: creezy.by ($0.94 in chips)=20
Seat 8: TJAbram ($0.92 in chips)=20
Seat 9: MDS17 ($4.11 in chips)=20
Irvade: posts small blind $0.01
hashex: posts big blind $0.02
*** HOLE CARDS ***
Dealt to the_wickstar [3c 3s]
creezy.by: folds=20
TJAbram: folds=20
MDS17: folds=20
nimzoindia: folds=20
the_wickstar: calls $0.02
Comra1d: folds=20
Irvade: folds=20
hashex: checks=20
*** FLOP *** [Kc Kh 4s]
hashex: checks=20
the_wickstar: checks=20
*** TURN *** [Kc Kh 4s] [Jc]
hashex: checks=20
the_wickstar: checks=20
*** RIVER *** [Kc Kh 4s Jc] [Td]
hashex: checks=20
the_wickstar: checks=20
*** SHOW DOWN ***
hashex: shows [7d 9c] (a pair of Kings)
the_wickstar: shows [3c 3s] (two pair, Kings and Threes)
the_wickstar collected $0.05 from pot
*** SUMMARY ***
Total pot $0.05 | Rake $0=20
Board [Kc Kh 4s Jc Td]
Seat 1: nimzoindia folded before Flop (didn't bet)
Seat 2: the_wickstar showed [3c 3s] and won ($0.05) with two pair, King=
s and Threes
Seat 3: Comra1d (button) folded before Flop (didn't bet)
Seat 4: Irvade (small blind) folded before Flop
Seat 6: hashex (big blind) showed [7d 9c] and lost with a pair of Kings
Seat 7: creezy.by folded before Flop (didn't bet)
Seat 8: TJAbram folded before Flop (didn't bet)
Seat 9: MDS17 folded before Flop (didn't bet)


*********** # 137 **************
PokerStars Hand #169563072696:  Hold'em No Limit ($0.01/$0.02 USD) - 20=
17/04/26 9:53:30 CUST [2017/04/25 19:53:30 ET]
Table 'Irus' 9-max Seat #5 is the button
Seat 1: manugar91 ($3.77 in chips)=20
Seat 2: YOOOOR ($1.07 in chips)=20
Seat 3: papin1988 ($2.05 in chips)=20
Seat 4: the_wickstar ($1.05 in chips)=20
Seat 5: Adashko#1 ($2 in chips)=20
Seat 6: konex ($2.37 in chips)=20
Seat 7: letyrn ($0.80 in chips)=20
Seat 8: bubamix ($4.40 in chips)=20
Seat 9: Vanek940 ($0.83 in chips)=20
konex: posts small blind $0.01
letyrn: posts big blind $0.02
*** HOLE CARDS ***
Dealt to the_wickstar [Jd 4h]
bubamix: folds=20
Vanek940: folds=20
manugar91: folds=20
YOOOOR: folds=20
papin1988: folds=20
the_wickstar: calls $0.02
Adashko#1: folds=20
konex: calls $0.01
letyrn: checks=20
*** FLOP *** [3c 5d 3h]
konex: checks=20
letyrn: checks=20
the_wickstar: bets $0.04
konex: folds=20
letyrn: folds=20
Uncalled bet ($0.04) returned to the_wickstar
the_wickstar collected $0.06 from pot
*** SUMMARY ***
Total pot $0.06 | Rake $0=20
Board [3c 5d 3h]
Seat 1: manugar91 folded before Flop (didn't bet)
Seat 2: YOOOOR folded before Flop (didn't bet)
Seat 3: papin1988 folded before Flop (didn't bet)
Seat 4: the_wickstar collected ($0.06)
Seat 5: Adashko#1 (button) folded before Flop (didn't bet)
Seat 6: konex (small blind) folded on the Flop
Seat 7: letyrn (big blind) folded on the Flop
Seat 8: bubamix folded before Flop (didn't bet)
Seat 9: Vanek940 folded before Flop (didn't bet)


*********** # 138 **************
PokerStars Hand #169563050402:  Hold'em No Limit ($0.01/$0.02 USD) - 20=
17/04/26 9:52:47 CUST [2017/04/25 19:52:47 ET]
Table 'Irus' 9-max Seat #4 is the button
Seat 1: manugar91 ($3.77 in chips)=20
Seat 2: YOOOOR ($1.07 in chips)=20
Seat 3: papin1988 ($2.05 in chips)=20
Seat 4: the_wickstar ($1.05 in chips)=20
Seat 5: Adashko#1 ($2 in chips)=20
Seat 6: konex ($2.36 in chips)=20
Seat 7: letyrn ($0.80 in chips)=20
Seat 8: bubamix ($4.40 in chips)=20
Seat 9: Vanek940 ($0.83 in chips)=20
Adashko#1: posts small blind $0.01
konex: posts big blind $0.02
*** HOLE CARDS ***
Dealt to the_wickstar [9c 5c]
letyrn: folds=20
bubamix: folds=20
Vanek940: folds=20
manugar91: folds=20
YOOOOR: folds=20
papin1988: folds=20
the_wickstar: folds=20
Adashko#1: folds=20
Uncalled bet ($0.01) returned to konex
konex collected $0.02 from pot
*** SUMMARY ***
Total pot $0.02 | Rake $0=20
Seat 1: manugar91 folded before Flop (didn't bet)
Seat 2: YOOOOR folded before Flop (didn't bet)
Seat 3: papin1988 folded before Flop (didn't bet)
Seat 4: the_wickstar (button) folded before Flop (didn't bet)
Seat 5: Adashko#1 (small blind) folded before Flop
Seat 6: konex (big blind) collected ($0.02)
Seat 7: letyrn folded before Flop (didn't bet)
Seat 8: bubamix folded before Flop (didn't bet)
Seat 9: Vanek940 folded before Flop (didn't bet)


*********** # 139 **************
PokerStars Hand #169563042446:  Hold'em No Limit ($0.01/$0.02 USD) - 20=
17/04/26 9:52:32 CUST [2017/04/25 19:52:32 ET]
Table 'Ulrike' 9-max Seat #2 is the button
Seat 1: nimzoindia ($2.45 in chips)=20
Seat 2: the_wickstar ($1 in chips)=20
Seat 3: Comra1d ($2.55 in chips)=20
Seat 4: Irvade ($2.78 in chips)=20
Seat 6: hashex ($2.03 in chips)=20
Seat 7: creezy.by ($0.94 in chips)=20
Seat 8: TJAbram ($0.92 in chips)=20
Seat 9: MDS17 ($4.11 in chips)=20
Comra1d: posts small blind $0.01
Irvade: posts big blind $0.02
*** HOLE CARDS ***
Dealt to the_wickstar [Qs Kd]
hashex: folds=20
creezy.by: folds=20
TJAbram: folds=20
MDS17: folds=20
nimzoindia: raises $0.05 to $0.07
the_wickstar: calls $0.07
Comra1d: calls $0.06
Irvade: folds=20
*** FLOP *** [Jd 2c Td]
Comra1d: checks=20
nimzoindia: checks=20
the_wickstar: checks=20
*** TURN *** [Jd 2c Td] [Jh]
Comra1d: checks=20
nimzoindia: checks=20
the_wickstar: bets $0.12
Comra1d: folds=20
nimzoindia: folds=20
Uncalled bet ($0.12) returned to the_wickstar
the_wickstar collected $0.22 from pot
*** SUMMARY ***
Total pot $0.23 | Rake $0.01=20
Board [Jd 2c Td Jh]
Seat 1: nimzoindia folded on the Turn
Seat 2: the_wickstar (button) collected ($0.22)
Seat 3: Comra1d (small blind) folded on the Turn
Seat 4: Irvade (big blind) folded before Flop
Seat 6: hashex folded before Flop (didn't bet)
Seat 7: creezy.by folded before Flop (didn't bet)
Seat 8: TJAbram folded before Flop (didn't bet)
Seat 9: MDS17 folded before Flop (didn't bet)


*********** # 140 **************
PokerStars Hand #169563033047:  Hold'em No Limit ($0.01/$0.02 USD) - 20=
17/04/26 9:52:13 CUST [2017/04/25 19:52:13 ET]
Table 'Irus' 9-max Seat #3 is the button
Seat 1: manugar91 ($3.77 in chips)=20
Seat 2: YOOOOR ($1.07 in chips)=20
Seat 3: papin1988 ($2.02 in chips)=20
Seat 4: the_wickstar ($1.06 in chips)=20
Seat 5: Adashko#1 ($2 in chips)=20
Seat 6: konex ($2.36 in chips)=20
Seat 7: letyrn ($0.80 in chips)=20
Seat 8: bubamix ($4.40 in chips)=20
Seat 9: Vanek940 ($0.83 in chips)=20
the_wickstar: posts small blind $0.01
Adashko#1: posts big blind $0.02
*** HOLE CARDS ***
Dealt to the_wickstar [4c 9s]
konex: folds=20
letyrn: folds=20
bubamix: folds=20
Vanek940: folds=20
manugar91: folds=20
YOOOOR: folds=20
papin1988: raises $0.04 to $0.06
the_wickstar: folds=20
Adashko#1: folds=20
Uncalled bet ($0.04) returned to papin1988
papin1988 collected $0.05 from pot
*** SUMMARY ***
Total pot $0.05 | Rake $0=20
Seat 1: manugar91 folded before Flop (didn't bet)
Seat 2: YOOOOR folded before Flop (didn't bet)
Seat 3: papin1988 (button) collected ($0.05)
Seat 4: the_wickstar (small blind) folded before Flop
Seat 5: Adashko#1 (big blind) folded before Flop
Seat 6: konex folded before Flop (didn't bet)
Seat 7: letyrn folded before Flop (didn't bet)
Seat 8: bubamix folded before Flop (didn't bet)
Seat 9: Vanek940 folded before Flop (didn't bet)


*********** # 141 **************
PokerStars Hand #169563017475:  Hold'em No Limit ($0.01/$0.02 USD) - 20=
17/04/26 9:51:44 CUST [2017/04/25 19:51:44 ET]
Table 'Irus' 9-max Seat #2 is the button
Seat 1: manugar91 ($3.77 in chips)=20
Seat 2: YOOOOR ($1.07 in chips)=20
Seat 3: papin1988 ($2 in chips)=20
Seat 4: the_wickstar ($1.08 in chips)=20
Seat 5: Adashko#1 ($2 in chips)=20
Seat 6: konex ($2.36 in chips)=20
Seat 8: bubamix ($4.40 in chips)=20
Seat 9: Vanek940 ($0.83 in chips)=20
papin1988: posts small blind $0.01
the_wickstar: posts big blind $0.02
*** HOLE CARDS ***
Dealt to the_wickstar [2s 6h]
Adashko#1: folds=20
konex: folds=20
bubamix: folds=20
Vanek940: folds=20
manugar91: folds=20
YOOOOR: folds=20
papin1988: raises $0.02 to $0.04
the_wickstar: folds=20
Uncalled bet ($0.02) returned to papin1988
papin1988 collected $0.04 from pot
*** SUMMARY ***
Total pot $0.04 | Rake $0=20
Seat 1: manugar91 folded before Flop (didn't bet)
Seat 2: YOOOOR (button) folded before Flop (didn't bet)
Seat 3: papin1988 (small blind) collected ($0.04)
Seat 4: the_wickstar (big blind) folded before Flop
Seat 5: Adashko#1 folded before Flop (didn't bet)
Seat 6: konex folded before Flop (didn't bet)
Seat 8: bubamix folded before Flop (didn't bet)
Seat 9: Vanek940 folded before Flop (didn't bet)


*********** # 142 **************
PokerStars Hand #169563000315:  Hold'em No Limit ($0.01/$0.02 USD) - 20=
17/04/26 9:51:11 CUST [2017/04/25 19:51:11 ET]
Table 'Ulrike' 9-max Seat #1 is the button
Seat 1: nimzoindia ($2.05 in chips)=20
Seat 2: the_wickstar ($1.01 in chips)=20
Seat 3: Comra1d ($2.57 in chips)=20
Seat 4: Irvade ($2.78 in chips)=20
Seat 6: hashex ($2.03 in chips)=20
Seat 7: creezy.by ($0.94 in chips)=20
Seat 8: TJAbram ($1.14 in chips)=20
Seat 9: MDS17 ($4.28 in chips)=20
the_wickstar: posts small blind $0.01
Comra1d: posts big blind $0.02
MDS17: posts small & big blinds $0.03
*** HOLE CARDS ***
Dealt to the_wickstar [2s 9h]
Irvade: folds=20
hashex: folds=20
creezy.by: folds=20
TJAbram: raises $0.04 to $0.06
MDS17: calls $0.04
nimzoindia: calls $0.06
the_wickstar: folds=20
tumbon leaves the table
Comra1d: folds=20
*** FLOP *** [7h 9s 5h]
TJAbram: bets $0.04
MDS17: calls $0.04
nimzoindia: calls $0.04
*** TURN *** [7h 9s 5h] [5c]
TJAbram: bets $0.06
MDS17: calls $0.06
nimzoindia: calls $0.06
*** RIVER *** [7h 9s 5h 5c] [9d]
TJAbram: bets $0.06
MDS17: folds=20
nimzoindia: raises $0.37 to $0.43
TJAbram: folds=20
Uncalled bet ($0.37) returned to nimzoindia
nimzoindia collected $0.62 from pot
nimzoindia: doesn't show hand=20
*** SUMMARY ***
Total pot $0.64 | Rake $0.02=20
Board [7h 9s 5h 5c 9d]
Seat 1: nimzoindia (button) collected ($0.62)
Seat 2: the_wickstar (small blind) folded before Flop
Seat 3: Comra1d (big blind) folded before Flop
Seat 4: Irvade folded before Flop (didn't bet)
Seat 6: hashex folded before Flop (didn't bet)
Seat 7: creezy.by folded before Flop (didn't bet)
Seat 8: TJAbram folded on the River
Seat 9: MDS17 folded on the River


*********** # 143 **************
PokerStars Hand #169562963411:  Hold'em No Limit ($0.01/$0.02 USD) - 20=
17/04/26 9:50:02 CUST [2017/04/25 19:50:02 ET]
Table 'Ulrike' 9-max Seat #8 is the button
Seat 1: nimzoindia ($2.06 in chips)=20
Seat 2: the_wickstar ($1.03 in chips)=20
Seat 3: Comra1d ($2.57 in chips)=20
Seat 4: Irvade ($2.15 in chips)=20
Seat 6: hashex ($2.03 in chips)=20
Seat 7: creezy.by ($1.59 in chips)=20
Seat 8: TJAbram ($1.14 in chips)=20
nimzoindia: posts small blind $0.01
the_wickstar: posts big blind $0.02
*** HOLE CARDS ***
Dealt to the_wickstar [3h 2c]
Comra1d: folds=20
Irvade: raises $0.04 to $0.06
hashex: folds=20
creezy.by: calls $0.06
TJAbram: folds=20
nimzoindia: folds=20
the_wickstar: folds=20
*** FLOP *** [Kd Jd 9c]
Irvade: bets $0.09
creezy.by: calls $0.09
*** TURN *** [Kd Jd 9c] [3c]
Irvade: bets $0.24
creezy.by: calls $0.24
*** RIVER *** [Kd Jd 9c 3c] [8c]
Irvade: bets $0.26
creezy.by: calls $0.26
*** SHOW DOWN ***
Irvade: shows [Js 9s] (two pair, Jacks and Nines)
creezy.by: mucks hand=20
Irvade collected $1.28 from pot
*** SUMMARY ***
Total pot $1.33 | Rake $0.05=20
Board [Kd Jd 9c 3c 8c]
Seat 1: nimzoindia (small blind) folded before Flop
Seat 2: the_wickstar (big blind) folded before Flop
Seat 3: Comra1d folded before Flop (didn't bet)
Seat 4: Irvade showed [Js 9s] and won ($1.28) with two pair, Jacks and =
Nines
Seat 6: hashex folded before Flop (didn't bet)
Seat 7: creezy.by mucked [Qh Jh]
Seat 8: TJAbram (button) folded before Flop (didn't bet)


*********** # 144 **************
PokerStars Hand #169562927409:  Hold'em No Limit ($0.01/$0.02 USD) - 20=
17/04/26 9:48:54 CUST [2017/04/25 19:48:54 ET]
Table 'Ulrike' 9-max Seat #7 is the button
Seat 1: nimzoindia ($2.08 in chips)=20
Seat 2: the_wickstar ($1.03 in chips)=20
Seat 3: Comra1d ($2.57 in chips)=20
Seat 4: Irvade ($2.15 in chips)=20
Seat 6: hashex ($2.03 in chips)=20
Seat 7: creezy.by ($1.67 in chips)=20
Seat 8: TJAbram ($1.05 in chips)=20
TJAbram: posts small blind $0.01
nimzoindia: posts big blind $0.02
*** HOLE CARDS ***
Dealt to the_wickstar [Ks 2s]
the_wickstar: folds=20
Comra1d: folds=20
Irvade: folds=20
hashex: folds=20
creezy.by: calls $0.02
TJAbram: calls $0.01
nimzoindia: checks=20
*** FLOP *** [6c Ts 7c]
TJAbram: bets $0.06
nimzoindia: folds=20
creezy.by: calls $0.06
*** TURN *** [6c Ts 7c] [8d]
TJAbram: bets $0.10
creezy.by: folds=20
Uncalled bet ($0.10) returned to TJAbram
TJAbram collected $0.17 from pot
TJAbram: doesn't show hand=20
*** SUMMARY ***
Total pot $0.18 | Rake $0.01=20
Board [6c Ts 7c 8d]
Seat 1: nimzoindia (big blind) folded on the Flop
Seat 2: the_wickstar folded before Flop (didn't bet)
Seat 3: Comra1d folded before Flop (didn't bet)
Seat 4: Irvade folded before Flop (didn't bet)
Seat 6: hashex folded before Flop (didn't bet)
Seat 7: creezy.by (button) folded on the Turn
Seat 8: TJAbram (small blind) collected ($0.17)


*********** # 145 **************
PokerStars Hand #169562881398:  Hold'em No Limit ($0.01/$0.02 USD) - 20=
17/04/26 9:47:29 CUST [2017/04/25 19:47:29 ET]
Table 'Ulrike' 9-max Seat #6 is the button
Seat 1: nimzoindia ($2.08 in chips)=20
Seat 2: the_wickstar ($1.05 in chips)=20
Seat 3: Comra1d ($2.57 in chips)=20
Seat 4: Irvade ($2.15 in chips)=20
Seat 6: hashex ($2.03 in chips)=20
Seat 7: creezy.by ($1.63 in chips)=20
Seat 8: TJAbram ($1.07 in chips)=20
creezy.by: posts small blind $0.01
TJAbram: posts big blind $0.02
*** HOLE CARDS ***
Dealt to the_wickstar [Ks Qs]
nimzoindia: folds=20
the_wickstar: calls $0.02
Comra1d: folds=20
Irvade: folds=20
hashex: folds=20
creezy.by: calls $0.01
TJAbram: checks=20
*** FLOP *** [Td 5d 7d]
creezy.by: bets $0.06
TJAbram: folds=20
the_wickstar: folds=20
Uncalled bet ($0.06) returned to creezy.by
creezy.by collected $0.06 from pot
*** SUMMARY ***
Total pot $0.06 | Rake $0=20
Board [Td 5d 7d]
Seat 1: nimzoindia folded before Flop (didn't bet)
Seat 2: the_wickstar folded on the Flop
Seat 3: Comra1d folded before Flop (didn't bet)
Seat 4: Irvade folded before Flop (didn't bet)
Seat 6: hashex (button) folded before Flop (didn't bet)
Seat 7: creezy.by (small blind) collected ($0.06)
Seat 8: TJAbram (big blind) folded on the Flop


*********** # 146 **************
PokerStars Hand #169562859712:  Hold'em No Limit ($0.01/$0.02 USD) - 20=
17/04/26 9:46:49 CUST [2017/04/25 19:46:49 ET]
Table 'Ulrike' 9-max Seat #4 is the button
Seat 1: nimzoindia ($2.08 in chips)=20
Seat 2: the_wickstar ($1.05 in chips)=20
Seat 3: Comra1d ($2.57 in chips)=20
Seat 4: Irvade ($2.12 in chips)=20
Seat 6: hashex ($2.04 in chips)=20
Seat 7: creezy.by ($1.65 in chips)=20
hashex: posts small blind $0.01
creezy.by: posts big blind $0.02
TJAbram: sits out=20
*** HOLE CARDS ***
Dealt to the_wickstar [3h Ts]
nimzoindia: folds=20
the_wickstar: folds=20
Comra1d: folds=20
Irvade: raises $0.04 to $0.06
hashex: folds=20
creezy.by: folds=20
Uncalled bet ($0.04) returned to Irvade
Irvade collected $0.05 from pot
Irvade: doesn't show hand=20
*** SUMMARY ***
Total pot $0.05 | Rake $0=20
Seat 1: nimzoindia folded before Flop (didn't bet)
Seat 2: the_wickstar folded before Flop (didn't bet)
Seat 3: Comra1d folded before Flop (didn't bet)
Seat 4: Irvade (button) collected ($0.05)
Seat 6: hashex (small blind) folded before Flop
Seat 7: creezy.by (big blind) folded before Flop


*********** # 147 **************
PokerStars Hand #169562848984:  Hold'em No Limit ($0.01/$0.02 USD) - 20=
17/04/26 9:46:29 CUST [2017/04/25 19:46:29 ET]
Table 'Ulrike' 9-max Seat #3 is the button
Seat 1: nimzoindia ($2.08 in chips)=20
Seat 2: the_wickstar ($1.05 in chips)=20
Seat 3: Comra1d ($2.57 in chips)=20
Seat 4: Irvade ($2.13 in chips)=20
Seat 6: hashex ($2.03 in chips)=20
Seat 7: creezy.by ($1.65 in chips)=20
Irvade: posts small blind $0.01
hashex: posts big blind $0.02
TJAbram: sits out=20
*** HOLE CARDS ***
Dealt to the_wickstar [8d Qc]
creezy.by: folds=20
nimzoindia: folds=20
the_wickstar: folds=20
Comra1d: folds=20
Irvade: folds=20
Uncalled bet ($0.01) returned to hashex
hashex collected $0.02 from pot
hashex: doesn't show hand=20
*** SUMMARY ***
Total pot $0.02 | Rake $0=20
Seat 1: nimzoindia folded before Flop (didn't bet)
Seat 2: the_wickstar folded before Flop (didn't bet)
Seat 3: Comra1d (button) folded before Flop (didn't bet)
Seat 4: Irvade (small blind) folded before Flop
Seat 6: hashex (big blind) collected ($0.02)
Seat 7: creezy.by folded before Flop (didn't bet)


*********** # 148 **************
PokerStars Hand #169562813694:  Hold'em No Limit ($0.01/$0.02 USD) - 20=
17/04/26 9:45:24 CUST [2017/04/25 19:45:24 ET]
Table 'Ulrike' 9-max Seat #2 is the button
Seat 1: nimzoindia ($2.08 in chips)=20
Seat 2: the_wickstar ($1.05 in chips)=20
Seat 3: Comra1d ($2.58 in chips)=20
Seat 4: Irvade ($2.19 in chips)=20
Seat 6: hashex ($2.03 in chips)=20
Seat 7: creezy.by ($1.58 in chips)=20
Comra1d: posts small blind $0.01
Irvade: posts big blind $0.02
TJAbram: sits out=20
*** HOLE CARDS ***
Dealt to the_wickstar [7s 8c]
hashex: folds=20
creezy.by: raises $0.04 to $0.06
nimzoindia: folds=20
the_wickstar: folds=20
Comra1d: folds=20
Irvade: calls $0.04
*** FLOP *** [2s 9h Jh]
Irvade: checks=20
creezy.by: bets $0.08
Irvade: folds=20
Uncalled bet ($0.08) returned to creezy.by
creezy.by collected $0.13 from pot
*** SUMMARY ***
Total pot $0.13 | Rake $0=20
Board [2s 9h Jh]
Seat 1: nimzoindia folded before Flop (didn't bet)
Seat 2: the_wickstar (button) folded before Flop (didn't bet)
Seat 3: Comra1d (small blind) folded before Flop
Seat 4: Irvade (big blind) folded on the Flop
Seat 6: hashex folded before Flop (didn't bet)
Seat 7: creezy.by collected ($0.13)


*********** # 149 **************
PokerStars Hand #169562794164:  Hold'em No Limit ($0.01/$0.02 USD) - 20=
17/04/26 9:44:48 CUST [2017/04/25 19:44:48 ET]
Table 'Ulrike' 9-max Seat #1 is the button
Seat 1: nimzoindia ($2.08 in chips)=20
Seat 2: the_wickstar ($1.06 in chips)=20
Seat 3: Comra1d ($2.60 in chips)=20
Seat 4: Irvade ($2.19 in chips)=20
Seat 6: hashex ($2 in chips)=20
Seat 7: creezy.by ($1.58 in chips)=20
Seat 9: MDS17 ($4.28 in chips)=20
the_wickstar: posts small blind $0.01
Comra1d: posts big blind $0.02
hashex: posts big blind $0.02
TJAbram: sits out=20
*** HOLE CARDS ***
Dealt to the_wickstar [9h Ac]
Irvade: folds=20
hashex: raises $0.06 to $0.08
creezy.by: folds=20
MDS17: folds=20
nimzoindia: folds=20
the_wickstar: folds=20
Comra1d: folds=20
Uncalled bet ($0.06) returned to hashex
hashex collected $0.05 from pot
hashex: doesn't show hand=20
*** SUMMARY ***
Total pot $0.05 | Rake $0=20
Seat 1: nimzoindia (button) folded before Flop (didn't bet)
Seat 2: the_wickstar (small blind) folded before Flop
Seat 3: Comra1d (big blind) folded before Flop
Seat 4: Irvade folded before Flop (didn't bet)
Seat 6: hashex collected ($0.05)
Seat 7: creezy.by folded before Flop (didn't bet)
Seat 9: MDS17 folded before Flop (didn't bet)


*********** # 150 **************
PokerStars Hand #169562774420:  Hold'em No Limit ($0.01/$0.02 USD) - 20=
17/04/26 9:44:12 CUST [2017/04/25 19:44:12 ET]
Table 'Ulrike' 9-max Seat #9 is the button
Seat 1: nimzoindia ($2 in chips)=20
Seat 2: the_wickstar ($1.08 in chips)=20
Seat 3: Comra1d ($2.60 in chips)=20
Seat 4: Irvade ($2.25 in chips)=20
Seat 7: creezy.by ($1.58 in chips)=20
Seat 9: MDS17 ($4.28 in chips)=20
nimzoindia: posts small blind $0.01
the_wickstar: posts big blind $0.02
TJAbram: sits out=20
*** HOLE CARDS ***
Dealt to the_wickstar [5d Qc]
Comra1d: folds=20
Irvade: raises $0.04 to $0.06
hashex joins the table at seat #6=20
creezy.by: folds=20
MDS17: folds=20
nimzoindia: raises $0.14 to $0.20
the_wickstar: folds=20
Irvade: folds=20
Uncalled bet ($0.14) returned to nimzoindia
nimzoindia collected $0.14 from pot
nimzoindia: doesn't show hand=20
*** SUMMARY ***
Total pot $0.14 | Rake $0=20
Seat 1: nimzoindia (small blind) collected ($0.14)
Seat 2: the_wickstar (big blind) folded before Flop
Seat 3: Comra1d folded before Flop (didn't bet)
Seat 4: Irvade folded before Flop
Seat 7: creezy.by folded before Flop (didn't bet)
Seat 9: MDS17 (button) folded before Flop (didn't bet)


*********** # 151 **************
PokerStars Hand #169530069118:  Hold'em No Limit ($0.01/$0.02 USD) - 20=
17/04/25 20:11:54 CUST [2017/04/25 6:11:54 ET]
Table 'Peneleos' 9-max Seat #1 is the button
Seat 1: TOMOKI K ($1.57 in chips)=20
Seat 2: Vadim2503 ($2.01 in chips)=20
Seat 3: the_wickstar ($1.13 in chips)=20
Seat 4: Ape50 ($5.76 in chips)=20
Seat 5: MISHKA2220 ($2.26 in chips)=20
Seat 7: minumz3nz ($1.03 in chips)=20
Seat 8: i2dv8 ($1.53 in chips)=20
Seat 9: vartovij ($0.91 in chips)=20
Vadim2503: posts small blind $0.01
the_wickstar: posts big blind $0.02
*** HOLE CARDS ***
Dealt to the_wickstar [6c Tc]
Ape50: folds=20
MISHKA2220: folds=20
minumz3nz: calls $0.02
i2dv8: calls $0.02
vartovij: folds=20
TOMOKI K: folds=20
Vadim2503: folds=20
the_wickstar: checks=20
*** FLOP *** [6s Ah 2c]
the_wickstar: bets $0.04
minumz3nz: calls $0.04
i2dv8: folds=20
*** TURN *** [6s Ah 2c] [4s]
the_wickstar: checks=20
minumz3nz: bets $0.10
the_wickstar: folds=20
Uncalled bet ($0.10) returned to minumz3nz
minumz3nz collected $0.14 from pot
minumz3nz: doesn't show hand=20
*** SUMMARY ***
Total pot $0.15 | Rake $0.01=20
Board [6s Ah 2c 4s]
Seat 1: TOMOKI K (button) folded before Flop (didn't bet)
Seat 2: Vadim2503 (small blind) folded before Flop
Seat 3: the_wickstar (big blind) folded on the Turn
Seat 4: Ape50 folded before Flop (didn't bet)
Seat 5: MISHKA2220 folded before Flop (didn't bet)
Seat 7: minumz3nz collected ($0.14)
Seat 8: i2dv8 folded on the Flop
Seat 9: vartovij folded before Flop (didn't bet)


*********** # 152 **************
PokerStars Hand #169530056735:  Hold'em No Limit ($0.01/$0.02 USD) - 20=
17/04/25 20:11:23 CUST [2017/04/25 6:11:23 ET]
Table 'Peneleos' 9-max Seat #9 is the button
Seat 1: TOMOKI K ($1.58 in chips)=20
Seat 2: Vadim2503 ($2 in chips)=20
Seat 3: the_wickstar ($1.13 in chips)=20
Seat 4: Ape50 ($5.76 in chips)=20
Seat 5: MISHKA2220 ($2.26 in chips)=20
Seat 7: minumz3nz ($1.03 in chips)=20
Seat 8: i2dv8 ($1.53 in chips)=20
Seat 9: vartovij ($0.91 in chips)=20
TOMOKI K: posts small blind $0.01
Vadim2503: posts big blind $0.02
*** HOLE CARDS ***
Dealt to the_wickstar [Qs 7c]
the_wickstar: folds=20
Ape50: folds=20
MISHKA2220: folds=20
minumz3nz: folds=20
i2dv8: folds=20
vartovij: folds=20
TOMOKI K: folds=20
Uncalled bet ($0.01) returned to Vadim2503
Vadim2503 collected $0.02 from pot
*** SUMMARY ***
Total pot $0.02 | Rake $0=20
Seat 1: TOMOKI K (small blind) folded before Flop
Seat 2: Vadim2503 (big blind) collected ($0.02)
Seat 3: the_wickstar folded before Flop (didn't bet)
Seat 4: Ape50 folded before Flop (didn't bet)
Seat 5: MISHKA2220 folded before Flop (didn't bet)
Seat 7: minumz3nz folded before Flop (didn't bet)
Seat 8: i2dv8 folded before Flop (didn't bet)
Seat 9: vartovij (button) folded before Flop (didn't bet)


*********** # 153 **************
PokerStars Hand #169530038551:  Hold'em No Limit ($0.01/$0.02 USD) - 20=
17/04/25 20:10:36 CUST [2017/04/25 6:10:36 ET]
Table 'Peneleos' 9-max Seat #8 is the button
Seat 1: TOMOKI K ($1.60 in chips)=20
Seat 3: the_wickstar ($1.13 in chips)=20
Seat 4: Ape50 ($5.76 in chips)=20
Seat 5: MISHKA2220 ($2.26 in chips)=20
Seat 7: minumz3nz ($1 in chips)=20
Seat 8: i2dv8 ($1.53 in chips)=20
Seat 9: vartovij ($0.92 in chips)=20
vartovij: posts small blind $0.01
TOMOKI K: posts big blind $0.02
Vadim2503: sits out=20
minumz3nz: posts big blind $0.02
*** HOLE CARDS ***
Dealt to the_wickstar [Td 5c]
the_wickstar: folds=20
Ape50: folds=20
MISHKA2220: folds=20
minumz3nz: checks=20
i2dv8: folds=20
vartovij: folds=20
TOMOKI K: checks=20
*** FLOP *** [Kh Kd As]
TOMOKI K: checks=20
minumz3nz: bets $0.02
TOMOKI K: folds=20
Uncalled bet ($0.02) returned to minumz3nz
minumz3nz collected $0.05 from pot
minumz3nz: doesn't show hand=20
*** SUMMARY ***
Total pot $0.05 | Rake $0=20
Board [Kh Kd As]
Seat 1: TOMOKI K (big blind) folded on the Flop
Seat 3: the_wickstar folded before Flop (didn't bet)
Seat 4: Ape50 folded before Flop (didn't bet)
Seat 5: MISHKA2220 folded before Flop (didn't bet)
Seat 7: minumz3nz collected ($0.05)
Seat 8: i2dv8 (button) folded before Flop (didn't bet)
Seat 9: vartovij (small blind) folded before Flop


*********** # 154 **************
PokerStars Hand #169530036780:  Hold'em No Limit ($0.01/$0.02 USD) - 20=
17/04/25 20:10:32 CUST [2017/04/25 6:10:32 ET]
Table 'El Djezair' 9-max Seat #1 is the button
Seat 1: Metridat ($0.87 in chips)=20
Seat 2: ramirasss ($1.26 in chips)=20
Seat 3: Lorhem ($1.08 in chips)=20
Seat 4: izy cykerman ($1.02 in chips)=20
Seat 5: 5Oceanov ($0.48 in chips)=20
Seat 6: lk77771 ($1.32 in chips)=20
Seat 7: tirapolisme ($2.11 in chips)=20
Seat 8: the_wickstar ($1.22 in chips)=20
Seat 9: Vladimir65 ($0.37 in chips)=20
ramirasss: posts small blind $0.01
Lorhem: posts big blind $0.02
*** HOLE CARDS ***
Dealt to the_wickstar [4c 8h]
izy cykerman: folds=20
5Oceanov: calls $0.02
lk77771: folds=20
tirapolisme: folds=20
the_wickstar: folds=20
Vladimir65: folds=20
Metridat: folds=20
ramirasss: calls $0.01
Lorhem: checks=20
*** FLOP *** [2c 7s 4d]
ramirasss: checks=20
Lorhem: checks=20
5Oceanov: bets $0.02
ramirasss: calls $0.02
Lorhem: folds=20
*** TURN *** [2c 7s 4d] [5d]
ramirasss: checks=20
5Oceanov: bets $0.02
ramirasss: calls $0.02
*** RIVER *** [2c 7s 4d 5d] [7d]
ramirasss: checks=20
5Oceanov: bets $0.02
ramirasss: folds=20
Uncalled bet ($0.02) returned to 5Oceanov
5Oceanov collected $0.14 from pot
5Oceanov: doesn't show hand=20
*** SUMMARY ***
Total pot $0.14 | Rake $0=20
Board [2c 7s 4d 5d 7d]
Seat 1: Metridat (button) folded before Flop (didn't bet)
Seat 2: ramirasss (small blind) folded on the River
Seat 3: Lorhem (big blind) folded on the Flop
Seat 4: izy cykerman folded before Flop (didn't bet)
Seat 5: 5Oceanov collected ($0.14)
Seat 6: lk77771 folded before Flop (didn't bet)
Seat 7: tirapolisme folded before Flop (didn't bet)
Seat 8: the_wickstar folded before Flop (didn't bet)
Seat 9: Vladimir65 folded before Flop (didn't bet)


*********** # 155 **************
PokerStars Hand #169530026814:  Hold'em No Limit ($0.01/$0.02 USD) - 20=
17/04/25 20:10:06 CUST [2017/04/25 6:10:06 ET]
Table 'Peneleos' 9-max Seat #5 is the button
Seat 3: the_wickstar ($1.13 in chips)=20
Seat 4: Ape50 ($5.76 in chips)=20
Seat 5: MISHKA2220 ($2.26 in chips)=20
Seat 8: i2dv8 ($1.55 in chips)=20
Seat 9: vartovij ($0.90 in chips)=20
i2dv8: posts small blind $0.01
vartovij: posts big blind $0.02
TOMOKI K: sits out=20
Vadim2503: sits out=20
*** HOLE CARDS ***
Dealt to the_wickstar [Ah 7h]
minumz3nz joins the table at seat #7=20
the_wickstar: folds=20
Ape50: folds=20
MISHKA2220: folds=20
i2dv8: calls $0.01
vartovij: checks=20
*** FLOP *** [9c 6d 8c]
i2dv8: checks=20
vartovij: bets $0.02
i2dv8: folds=20
Uncalled bet ($0.02) returned to vartovij
vartovij collected $0.04 from pot
vartovij: doesn't show hand=20
*** SUMMARY ***
Total pot $0.04 | Rake $0=20
Board [9c 6d 8c]
Seat 3: the_wickstar folded before Flop (didn't bet)
Seat 4: Ape50 folded before Flop (didn't bet)
Seat 5: MISHKA2220 (button) folded before Flop (didn't bet)
Seat 8: i2dv8 (small blind) folded on the Flop
Seat 9: vartovij (big blind) collected ($0.04)


*********** # 156 **************
PokerStars Hand #169530006396:  Hold'em No Limit ($0.01/$0.02 USD) - 20=
17/04/25 20:09:14 CUST [2017/04/25 6:09:14 ET]
Table 'El Djezair' 9-max Seat #9 is the button
Seat 1: Metridat ($0.88 in chips)=20
Seat 2: ramirasss ($1.23 in chips)=20
Seat 3: Lorhem ($1.08 in chips)=20
Seat 4: izy cykerman ($1.02 in chips)=20
Seat 5: 5Oceanov ($0.48 in chips)=20
Seat 6: lk77771 ($1.32 in chips)=20
Seat 7: tirapolisme ($2.11 in chips)=20
Seat 8: the_wickstar ($1.24 in chips)=20
Seat 9: Vladimir65 ($0.37 in chips)=20
Metridat: posts small blind $0.01
ramirasss: posts big blind $0.02
*** HOLE CARDS ***
Dealt to the_wickstar [Ah 2s]
Lorhem: folds=20
izy cykerman: folds=20
5Oceanov: folds=20
lk77771: folds=20
tirapolisme: folds=20
the_wickstar: calls $0.02
Vladimir65: folds=20
Metridat: folds=20
ramirasss: checks=20
*** FLOP *** [3s Td 7h]
ramirasss: checks=20
the_wickstar: checks=20
*** TURN *** [3s Td 7h] [3c]
ramirasss: bets $0.02
the_wickstar: folds=20
Uncalled bet ($0.02) returned to ramirasss
ramirasss collected $0.05 from pot
ramirasss: doesn't show hand=20
*** SUMMARY ***
Total pot $0.05 | Rake $0=20
Board [3s Td 7h 3c]
Seat 1: Metridat (small blind) folded before Flop
Seat 2: ramirasss (big blind) collected ($0.05)
Seat 3: Lorhem folded before Flop (didn't bet)
Seat 4: izy cykerman folded before Flop (didn't bet)
Seat 5: 5Oceanov folded before Flop (didn't bet)
Seat 6: lk77771 folded before Flop (didn't bet)
Seat 7: tirapolisme folded before Flop (didn't bet)
Seat 8: the_wickstar folded on the Turn
Seat 9: Vladimir65 (button) folded before Flop (didn't bet)


*********** # 157 **************
PokerStars Hand #169530003178:  Hold'em No Limit ($0.01/$0.02 USD) - 20=
17/04/25 20:09:06 CUST [2017/04/25 6:09:06 ET]
Table 'Peneleos' 9-max Seat #4 is the button
Seat 3: the_wickstar ($1.15 in chips)=20
Seat 4: Ape50 ($5.76 in chips)=20
Seat 5: MISHKA2220 ($2.27 in chips)=20
Seat 8: i2dv8 ($1.52 in chips)=20
MISHKA2220: posts small blind $0.01
i2dv8: posts big blind $0.02
vartovij: sits out=20
TOMOKI K: sits out=20
Vadim2503: sits out=20
*** HOLE CARDS ***
Dealt to the_wickstar [3d 3c]
the_wickstar: calls $0.02
Ape50: folds=20
MISHKA2220: folds=20
i2dv8: checks=20
*** FLOP *** [Kc 2c Jc]
i2dv8: checks=20
the_wickstar: checks=20
*** TURN *** [Kc 2c Jc] [2d]
i2dv8: checks=20
the_wickstar: checks=20
*** RIVER *** [Kc 2c Jc 2d] [9c]
i2dv8: checks=20
the_wickstar: checks=20
*** SHOW DOWN ***
i2dv8: shows [Qc 6h] (a flush, King high)
the_wickstar: mucks hand=20
i2dv8 collected $0.05 from pot
*** SUMMARY ***
Total pot $0.05 | Rake $0=20
Board [Kc 2c Jc 2d 9c]
Seat 3: the_wickstar mucked [3d 3c]
Seat 4: Ape50 (button) folded before Flop (didn't bet)
Seat 5: MISHKA2220 (small blind) folded before Flop
Seat 8: i2dv8 (big blind) showed [Qc 6h] and won ($0.05) with a flush, =
King high


*********** # 158 **************
PokerStars Hand #169529996930:  Hold'em No Limit ($0.01/$0.02 USD) - 20=
17/04/25 20:08:50 CUST [2017/04/25 6:08:50 ET]
Table 'Peneleos' 9-max Seat #3 is the button
Seat 3: the_wickstar ($1.12 in chips)=20
Seat 4: Ape50 ($5.77 in chips)=20
Seat 5: MISHKA2220 ($2.29 in chips)=20
Seat 8: i2dv8 ($1.52 in chips)=20
Ape50: posts small blind $0.01
MISHKA2220: posts big blind $0.02
vartovij: sits out=20
TOMOKI K: sits out=20
Vadim2503: sits out=20
*** HOLE CARDS ***
Dealt to the_wickstar [Qc Kh]
i2dv8: folds=20
the_wickstar: raises $0.04 to $0.06
Ape50: folds=20
MISHKA2220: folds=20
Uncalled bet ($0.04) returned to the_wickstar
the_wickstar collected $0.05 from pot
*** SUMMARY ***
Total pot $0.05 | Rake $0=20
Seat 3: the_wickstar (button) collected ($0.05)
Seat 4: Ape50 (small blind) folded before Flop
Seat 5: MISHKA2220 (big blind) folded before Flop
Seat 8: i2dv8 folded before Flop (didn't bet)


*********** # 159 **************
PokerStars Hand #169529987929:  Hold'em No Limit ($0.01/$0.02 USD) - 20=
17/04/25 20:08:27 CUST [2017/04/25 6:08:27 ET]
Table 'Peneleos' 9-max Seat #8 is the button
Seat 3: the_wickstar ($1.13 in chips)=20
Seat 4: Ape50 ($5.76 in chips)=20
Seat 5: MISHKA2220 ($2.29 in chips)=20
Seat 8: i2dv8 ($1.52 in chips)=20
vartovij will be allowed to play after the button
TOMOKI K will be allowed to play after the button
the_wickstar: posts small blind $0.01
Ape50: posts big blind $0.02
*** HOLE CARDS ***
Dealt to the_wickstar [5d Kd]
MISHKA2220: folds=20
i2dv8: folds=20
the_wickstar: folds=20
Uncalled bet ($0.01) returned to Ape50
Ape50 collected $0.02 from pot
Vadim2503 joins the table at seat #2=20
Ape50: doesn't show hand=20
*** SUMMARY ***
Total pot $0.02 | Rake $0=20
Seat 3: the_wickstar (small blind) folded before Flop
Seat 4: Ape50 (big blind) collected ($0.02)
Seat 5: MISHKA2220 folded before Flop (didn't bet)
Seat 8: i2dv8 (button) folded before Flop (didn't bet)


*********** # 160 **************
PokerStars Hand #169529987173:  Hold'em No Limit ($0.01/$0.02 USD) - 20=
17/04/25 20:08:25 CUST [2017/04/25 6:08:25 ET]
Table 'El Djezair' 9-max Seat #8 is the button
Seat 1: Metridat ($0.90 in chips)=20
Seat 2: ramirasss ($1.23 in chips)=20
Seat 3: Lorhem ($1.08 in chips)=20
Seat 4: izy cykerman ($1.02 in chips)=20
Seat 5: 5Oceanov ($0.48 in chips)=20
Seat 6: lk77771 ($1.32 in chips)=20
Seat 7: tirapolisme ($2.08 in chips)=20
Seat 8: the_wickstar ($1.24 in chips)=20
Seat 9: Vladimir65 ($0.38 in chips)=20
Vladimir65: posts small blind $0.01
Metridat: posts big blind $0.02
*** HOLE CARDS ***
Dealt to the_wickstar [2h 3c]
ramirasss: folds=20
Lorhem: folds=20
izy cykerman: folds=20
5Oceanov: folds=20
lk77771: folds=20
tirapolisme: raises $0.04 to $0.06
the_wickstar: folds=20
Vladimir65: folds=20
Metridat: folds=20
Uncalled bet ($0.04) returned to tirapolisme
tirapolisme collected $0.05 from pot
tirapolisme: doesn't show hand=20
*** SUMMARY ***
Total pot $0.05 | Rake $0=20
Seat 1: Metridat (big blind) folded before Flop
Seat 2: ramirasss folded before Flop (didn't bet)
Seat 3: Lorhem folded before Flop (didn't bet)
Seat 4: izy cykerman folded before Flop (didn't bet)
Seat 5: 5Oceanov folded before Flop (didn't bet)
Seat 6: lk77771 folded before Flop (didn't bet)
Seat 7: tirapolisme collected ($0.05)
Seat 8: the_wickstar (button) folded before Flop (didn't bet)
Seat 9: Vladimir65 (small blind) folded before Flop


*********** # 161 **************
PokerStars Hand #169529959449:  Hold'em No Limit ($0.01/$0.02 USD) - 20=
17/04/25 20:07:14 CUST [2017/04/25 6:07:14 ET]
Table 'Peneleos' 9-max Seat #5 is the button
Seat 3: the_wickstar ($1.17 in chips)=20
Seat 5: MISHKA2220 ($2.29 in chips)=20
Seat 8: i2dv8 ($1.48 in chips)=20
i2dv8: posts small blind $0.01
the_wickstar: posts big blind $0.02
Ape50: sits out=20
*** HOLE CARDS ***
Dealt to the_wickstar [6d 8d]
MISHKA2220: folds=20
i2dv8: calls $0.01
the_wickstar: checks=20
*** FLOP *** [5h 9s 2d]
i2dv8: bets $0.02
TOMOKI K joins the table at seat #1=20
the_wickstar: calls $0.02
*** TURN *** [5h 9s 2d] [Ks]
i2dv8: checks=20
the_wickstar: checks=20
*** RIVER *** [5h 9s 2d Ks] [Kh]
i2dv8: checks=20
the_wickstar: checks=20
*** SHOW DOWN ***
i2dv8: shows [Qc 9c] (two pair, Kings and Nines)
the_wickstar: mucks hand=20
i2dv8 collected $0.08 from pot
*** SUMMARY ***
Total pot $0.08 | Rake $0=20
Board [5h 9s 2d Ks Kh]
Seat 3: the_wickstar (big blind) mucked [6d 8d]
Seat 5: MISHKA2220 (button) folded before Flop (didn't bet)
Seat 8: i2dv8 (small blind) showed [Qc 9c] and won ($0.08) with two pai=
r, Kings and Nines


*********** # 162 **************
PokerStars Hand #169529944070:  Hold'em No Limit ($0.01/$0.02 USD) - 20=
17/04/25 20:06:35 CUST [2017/04/25 6:06:35 ET]
Table 'El Djezair' 9-max Seat #7 is the button
Seat 1: Metridat ($0.90 in chips)=20
Seat 2: ramirasss ($1.29 in chips)=20
Seat 3: Lorhem ($1.08 in chips)=20
Seat 4: izy cykerman ($1.02 in chips)=20
Seat 5: 5Oceanov ($0.48 in chips)=20
Seat 6: lk77771 ($1.24 in chips)=20
Seat 7: tirapolisme ($2.08 in chips)=20
Seat 8: the_wickstar ($1.25 in chips)=20
Seat 9: Vladimir65 ($0.40 in chips)=20
the_wickstar: posts small blind $0.01
Vladimir65: posts big blind $0.02
lk77771: posts big blind $0.02
*** HOLE CARDS ***
Dealt to the_wickstar [3c 9s]
Metridat: folds=20
ramirasss: raises $0.04 to $0.06
Lorhem: folds=20
izy cykerman: folds=20
5Oceanov: folds=20
lk77771: calls $0.04
tirapolisme: folds=20
the_wickstar: folds=20
Vladimir65: folds=20
*** FLOP *** [Jc 3h 6s]
ramirasss: checks=20
lk77771: checks=20
*** TURN *** [Jc 3h 6s] [5d]
lk77771 said, "zzzzzzzz"
ramirasss: checks=20
lk77771: checks=20
*** RIVER *** [Jc 3h 6s 5d] [Jh]
ramirasss: checks=20
lk77771: bets $0.14
ramirasss: folds=20
Uncalled bet ($0.14) returned to lk77771
lk77771 collected $0.14 from pot
*** SUMMARY ***
Total pot $0.15 | Rake $0.01=20
Board [Jc 3h 6s 5d Jh]
Seat 1: Metridat folded before Flop (didn't bet)
Seat 2: ramirasss folded on the River
Seat 3: Lorhem folded before Flop (didn't bet)
Seat 4: izy cykerman folded before Flop (didn't bet)
Seat 5: 5Oceanov folded before Flop (didn't bet)
Seat 6: lk77771 collected ($0.14)
Seat 7: tirapolisme (button) folded before Flop (didn't bet)
Seat 8: the_wickstar (small blind) folded before Flop
Seat 9: Vladimir65 (big blind) folded before Flop


*********** # 163 **************
PokerStars Hand #169529912624:  Hold'em No Limit ($0.01/$0.02 USD) - 20=
17/04/25 20:05:14 CUST [2017/04/25 6:05:14 ET]
Table 'El Djezair' 9-max Seat #5 is the button
Seat 1: Metridat ($0.90 in chips)=20
Seat 2: ramirasss ($1.29 in chips)=20
Seat 3: Lorhem ($1.10 in chips)=20
Seat 4: izy cykerman ($1.02 in chips)=20
Seat 5: 5Oceanov ($0.64 in chips)=20
Seat 7: tirapolisme ($1.89 in chips)=20
Seat 8: the_wickstar ($1.27 in chips)=20
Seat 9: Vladimir65 ($0.40 in chips)=20
lk77771 will be allowed to play after the button
tirapolisme: posts small blind $0.01
the_wickstar: posts big blind $0.02
*** HOLE CARDS ***
Dealt to the_wickstar [3c 5s]
Vladimir65: folds=20
Metridat: folds=20
ramirasss: folds=20
Lorhem: calls $0.02
izy cykerman: folds=20
5Oceanov: calls $0.02
tirapolisme: raises $0.14 to $0.16
the_wickstar: folds=20
Lorhem: folds=20
5Oceanov: calls $0.14
*** FLOP *** [Qd Kc 9s]
tirapolisme: bets $0.21
5Oceanov: folds=20
Uncalled bet ($0.21) returned to tirapolisme
tirapolisme collected $0.35 from pot
tirapolisme: doesn't show hand=20
*** SUMMARY ***
Total pot $0.36 | Rake $0.01=20
Board [Qd Kc 9s]
Seat 1: Metridat folded before Flop (didn't bet)
Seat 2: ramirasss folded before Flop (didn't bet)
Seat 3: Lorhem folded before Flop
Seat 4: izy cykerman folded before Flop (didn't bet)
Seat 5: 5Oceanov (button) folded on the Flop
Seat 7: tirapolisme (small blind) collected ($0.35)
Seat 8: the_wickstar (big blind) folded before Flop
Seat 9: Vladimir65 folded before Flop (didn't bet)


*********** # 164 **************
PokerStars Hand #169529906451:  Hold'em No Limit ($0.01/$0.02 USD) - 20=
17/04/25 20:04:58 CUST [2017/04/25 6:04:58 ET]
Table 'Peneleos' 9-max Seat #3 is the button
Seat 3: the_wickstar ($1.19 in chips)=20
Seat 5: MISHKA2220 ($2.30 in chips)=20
Seat 7: emmmetswe ($1.91 in chips)=20
Seat 8: i2dv8 ($1.37 in chips)=20
Seat 9: vartovij ($0.97 in chips)=20
MISHKA2220: posts small blind $0.01
emmmetswe: posts big blind $0.02
*** HOLE CARDS ***
Dealt to the_wickstar [5h Ac]
i2dv8: calls $0.02
vartovij: calls $0.02
the_wickstar: calls $0.02
MISHKA2220: folds=20
emmmetswe: checks=20
*** FLOP *** [7s Jc 9h]
emmmetswe: checks=20
i2dv8: checks=20
vartovij: bets $0.05
the_wickstar: folds=20
emmmetswe: folds=20
i2dv8: calls $0.05
*** TURN *** [7s Jc 9h] [5s]
i2dv8: checks=20
emmmetswe leaves the table
vartovij: checks=20
*** RIVER *** [7s Jc 9h 5s] [7d]
i2dv8: bets $0.09
vartovij has timed out
vartovij: folds=20
Uncalled bet ($0.09) returned to i2dv8
i2dv8 collected $0.18 from pot
i2dv8: doesn't show hand=20
*** SUMMARY ***
Total pot $0.19 | Rake $0.01=20
Board [7s Jc 9h 5s 7d]
Seat 3: the_wickstar (button) folded on the Flop
Seat 5: MISHKA2220 (small blind) folded before Flop
Seat 7: emmmetswe (big blind) folded on the Flop
Seat 8: i2dv8 collected ($0.18)
Seat 9: vartovij folded on the River


*********** # 165 **************
PokerStars Hand #169529894150:  Hold'em No Limit ($0.01/$0.02 USD) - 20=
17/04/25 20:04:26 CUST [2017/04/25 6:04:26 ET]
Table 'Peneleos' 9-max Seat #9 is the button
Seat 3: the_wickstar ($1.20 in chips)=20
Seat 5: MISHKA2220 ($2.29 in chips)=20
Seat 7: emmmetswe ($1.91 in chips)=20
Seat 8: i2dv8 ($1.37 in chips)=20
Seat 9: vartovij ($0.97 in chips)=20
the_wickstar: posts small blind $0.01
MISHKA2220: posts big blind $0.02
*** HOLE CARDS ***
Dealt to the_wickstar [5c Jh]
emmmetswe: folds=20
i2dv8: folds=20
vartovij: folds=20
the_wickstar: folds=20
Uncalled bet ($0.01) returned to MISHKA2220
MISHKA2220 collected $0.02 from pot
*** SUMMARY ***
Total pot $0.02 | Rake $0=20
Seat 3: the_wickstar (small blind) folded before Flop
Seat 5: MISHKA2220 (big blind) collected ($0.02)
Seat 7: emmmetswe folded before Flop (didn't bet)
Seat 8: i2dv8 folded before Flop (didn't bet)
Seat 9: vartovij (button) folded before Flop (didn't bet)


*********** # 166 **************
PokerStars Hand #169529888058:  Hold'em No Limit ($0.01/$0.02 USD) - 20=
17/04/25 20:04:11 CUST [2017/04/25 6:04:11 ET]
Table 'Peneleos' 9-max Seat #8 is the button
Seat 3: the_wickstar ($1.19 in chips)=20
Seat 5: MISHKA2220 ($2.29 in chips)=20
Seat 7: emmmetswe ($1.91 in chips)=20
Seat 8: i2dv8 ($1.37 in chips)=20
Seat 9: vartovij ($0.98 in chips)=20
vartovij: posts small blind $0.01
Strelo4ekk: is sitting out=20
Strelo4ekk leaves the table
the_wickstar: posts big blind $0.02
*** HOLE CARDS ***
Dealt to the_wickstar [As 9h]
MISHKA2220: folds=20
emmmetswe: folds=20
i2dv8: folds=20
vartovij: folds=20
Uncalled bet ($0.01) returned to the_wickstar
the_wickstar collected $0.02 from pot
*** SUMMARY ***
Total pot $0.02 | Rake $0=20
Seat 3: the_wickstar (big blind) collected ($0.02)
Seat 5: MISHKA2220 folded before Flop (didn't bet)
Seat 7: emmmetswe folded before Flop (didn't bet)
Seat 8: i2dv8 (button) folded before Flop (didn't bet)
Seat 9: vartovij (small blind) folded before Flop


*********** # 167 **************
PokerStars Hand #169529874777:  Hold'em No Limit ($0.01/$0.02 USD) - 20=
17/04/25 20:03:37 CUST [2017/04/25 6:03:37 ET]
Table 'El Djezair' 9-max Seat #4 is the button
Seat 1: Metridat ($0.90 in chips)=20
Seat 2: ramirasss ($1.12 in chips)=20
Seat 3: Lorhem ($1.10 in chips)=20
Seat 4: izy cykerman ($1.12 in chips)=20
Seat 5: 5Oceanov ($0.70 in chips)=20
Seat 7: tirapolisme ($1.91 in chips)=20
Seat 8: the_wickstar ($1.27 in chips)=20
Seat 9: Vladimir65 ($0.40 in chips)=20
5Oceanov: posts small blind $0.01
Chernovsky: is sitting out=20
tirapolisme: posts big blind $0.02
*** HOLE CARDS ***
Dealt to the_wickstar [8d 9h]
Chernovsky leaves the table
the_wickstar: folds=20
Vladimir65: folds=20
Metridat: folds=20
ramirasss: raises $0.04 to $0.06
lk77771 joins the table at seat #6=20
Lorhem: folds=20
izy cykerman: calls $0.06
5Oceanov: calls $0.05
tirapolisme: folds=20
*** FLOP *** [Qc Tc Ts]
5Oceanov: checks=20
ramirasss: checks=20
izy cykerman: checks=20
*** TURN *** [Qc Tc Ts] [3h]
5Oceanov: checks=20
ramirasss: checks=20
izy cykerman: bets $0.04
5Oceanov: folds=20
ramirasss: calls $0.04
*** RIVER *** [Qc Tc Ts 3h] [Qs]
ramirasss: checks=20
izy cykerman: checks=20
*** SHOW DOWN ***
ramirasss: shows [Ac Kd] (two pair, Queens and Tens)
izy cykerman: mucks hand=20
ramirasss collected $0.27 from pot
*** SUMMARY ***
Total pot $0.28 | Rake $0.01=20
Board [Qc Tc Ts 3h Qs]
Seat 1: Metridat folded before Flop (didn't bet)
Seat 2: ramirasss showed [Ac Kd] and won ($0.27) with two pair, Queens =
and Tens
Seat 3: Lorhem folded before Flop (didn't bet)
Seat 4: izy cykerman (button) mucked [9d 9s]
Seat 5: 5Oceanov (small blind) folded on the Turn
Seat 7: tirapolisme (big blind) folded before Flop
Seat 8: the_wickstar folded before Flop (didn't bet)
Seat 9: Vladimir65 folded before Flop (didn't bet)


*********** # 168 **************
PokerStars Hand #169529871820:  Hold'em No Limit ($0.01/$0.02 USD) - 20=
17/04/25 20:03:30 CUST [2017/04/25 6:03:30 ET]
Table 'Peneleos' 9-max Seat #7 is the button
Seat 1: Strelo4ekk ($2.11 in chips)=20
Seat 3: the_wickstar ($1.19 in chips)=20
Seat 5: MISHKA2220 ($2.29 in chips)=20
Seat 7: emmmetswe ($1.88 in chips)=20
Seat 8: i2dv8 ($1.38 in chips)=20
Seat 9: vartovij ($1 in chips)=20
i2dv8: posts small blind $0.01
vartovij: posts big blind $0.02
*** HOLE CARDS ***
Dealt to the_wickstar [5h 2d]
Strelo4ekk: folds=20
the_wickstar: folds=20
MISHKA2220: folds=20
emmmetswe: raises $0.04 to $0.06
i2dv8: folds=20
vartovij: folds=20
Uncalled bet ($0.04) returned to emmmetswe
emmmetswe collected $0.05 from pot
emmmetswe: doesn't show hand=20
*** SUMMARY ***
Total pot $0.05 | Rake $0=20
Seat 1: Strelo4ekk folded before Flop (didn't bet)
Seat 3: the_wickstar folded before Flop (didn't bet)
Seat 5: MISHKA2220 folded before Flop (didn't bet)
Seat 7: emmmetswe (button) collected ($0.05)
Seat 8: i2dv8 (small blind) folded before Flop
Seat 9: vartovij (big blind) folded before Flop


*********** # 169 **************
PokerStars Hand #169529858401:  Hold'em No Limit ($0.01/$0.02 USD) - 20=
17/04/25 20:02:55 CUST [2017/04/25 6:02:55 ET]
Table 'El Djezair' 9-max Seat #3 is the button
Seat 1: Metridat ($0.90 in chips)=20
Seat 2: ramirasss ($1.12 in chips)=20
Seat 3: Lorhem ($1.10 in chips)=20
Seat 4: izy cykerman ($1.13 in chips)=20
Seat 5: 5Oceanov ($0.69 in chips)=20
Seat 6: Chernovsky ($2.04 in chips)=20
Seat 7: tirapolisme ($1.91 in chips)=20
Seat 8: the_wickstar ($1.27 in chips)=20
Seat 9: Vladimir65 ($0.40 in chips)=20
izy cykerman: posts small blind $0.01
5Oceanov: posts big blind $0.02
*** HOLE CARDS ***
Dealt to the_wickstar [6c 8c]
Chernovsky: folds=20
tirapolisme: folds=20
the_wickstar: folds=20
Vladimir65: folds=20
Metridat: folds=20
ramirasss: folds=20
Lorhem: folds=20
izy cykerman: folds=20
Uncalled bet ($0.01) returned to 5Oceanov
5Oceanov collected $0.02 from pot
5Oceanov: doesn't show hand=20
*** SUMMARY ***
Total pot $0.02 | Rake $0=20
Seat 1: Metridat folded before Flop (didn't bet)
Seat 2: ramirasss folded before Flop (didn't bet)
Seat 3: Lorhem (button) folded before Flop (didn't bet)
Seat 4: izy cykerman (small blind) folded before Flop
Seat 5: 5Oceanov (big blind) collected ($0.02)
Seat 6: Chernovsky folded before Flop (didn't bet)
Seat 7: tirapolisme folded before Flop (didn't bet)
Seat 8: the_wickstar folded before Flop (didn't bet)
Seat 9: Vladimir65 folded before Flop (didn't bet)


*********** # 170 **************
PokerStars Hand #169529857618:  Hold'em No Limit ($0.01/$0.02 USD) - 20=
17/04/25 20:02:53 CUST [2017/04/25 6:02:53 ET]
Table 'Peneleos' 9-max Seat #5 is the button
Seat 1: Strelo4ekk ($2.11 in chips)=20
Seat 3: the_wickstar ($1.19 in chips)=20
Seat 5: MISHKA2220 ($2.29 in chips)=20
Seat 7: emmmetswe ($1.86 in chips)=20
Seat 8: i2dv8 ($1.40 in chips)=20
Seat 9: vartovij ($1 in chips)=20
emmmetswe: posts small blind $0.01
i2dv8: posts big blind $0.02
*** HOLE CARDS ***
Dealt to the_wickstar [5d 2d]
vartovij has timed out
vartovij: folds=20
Strelo4ekk: folds=20
the_wickstar: folds=20
MISHKA2220: folds=20
emmmetswe: raises $0.04 to $0.06
i2dv8: folds=20
Uncalled bet ($0.04) returned to emmmetswe
emmmetswe collected $0.04 from pot
emmmetswe: doesn't show hand=20
*** SUMMARY ***
Total pot $0.04 | Rake $0=20
Seat 1: Strelo4ekk folded before Flop (didn't bet)
Seat 3: the_wickstar folded before Flop (didn't bet)
Seat 5: MISHKA2220 (button) folded before Flop (didn't bet)
Seat 7: emmmetswe (small blind) collected ($0.04)
Seat 8: i2dv8 (big blind) folded before Flop
Seat 9: vartovij folded before Flop (didn't bet)


*********** # 171 **************
PokerStars Hand #169529843493:  Hold'em No Limit ($0.01/$0.02 USD) - 20=
17/04/25 20:02:17 CUST [2017/04/25 6:02:17 ET]
Table 'El Djezair' 9-max Seat #2 is the button
Seat 1: Metridat ($0.87 in chips)=20
Seat 2: ramirasss ($1.12 in chips)=20
Seat 3: Lorhem ($1.11 in chips)=20
Seat 4: izy cykerman ($1.15 in chips)=20
Seat 6: Chernovsky ($2.04 in chips)=20
Seat 7: tirapolisme ($1.91 in chips)=20
Seat 8: the_wickstar ($1.27 in chips)=20
Seat 9: Vladimir65 ($0.40 in chips)=20
Lorhem: posts small blind $0.01
izy cykerman: posts big blind $0.02
*** HOLE CARDS ***
Dealt to the_wickstar [Th 6c]
Chernovsky: folds=20
tirapolisme: folds=20
the_wickstar: folds=20
Vladimir65: folds=20
Metridat: raises $0.03 to $0.05
ramirasss: folds=20
Lorhem: folds=20
izy cykerman: folds=20
Uncalled bet ($0.03) returned to Metridat
Metridat collected $0.05 from pot
*** SUMMARY ***
Total pot $0.05 | Rake $0=20
Seat 1: Metridat collected ($0.05)
Seat 2: ramirasss (button) folded before Flop (didn't bet)
Seat 3: Lorhem (small blind) folded before Flop
Seat 4: izy cykerman (big blind) folded before Flop
Seat 6: Chernovsky folded before Flop (didn't bet)
Seat 7: tirapolisme folded before Flop (didn't bet)
Seat 8: the_wickstar folded before Flop (didn't bet)
Seat 9: Vladimir65 folded before Flop (didn't bet)


*********** # 172 **************
PokerStars Hand #169529834503:  Hold'em No Limit ($0.01/$0.02 USD) - 20=
17/04/25 20:01:53 CUST [2017/04/25 6:01:53 ET]
Table 'El Djezair' 9-max Seat #1 is the button
Seat 1: Metridat ($0.84 in chips)=20
Seat 2: ramirasss ($1.13 in chips)=20
Seat 3: Lorhem ($1.13 in chips)=20
Seat 6: Chernovsky ($2.04 in chips)=20
Seat 7: tirapolisme ($1.91 in chips)=20
Seat 8: the_wickstar ($1.27 in chips)=20
Seat 9: Vladimir65 ($0.40 in chips)=20
ramirasss: posts small blind $0.01
Lorhem: posts big blind $0.02
izy cykerman: sits out=20
*** HOLE CARDS ***
Dealt to the_wickstar [Jc 9s]
Chernovsky: folds=20
tirapolisme: folds=20
the_wickstar: folds=20
Vladimir65: folds=20
Metridat: raises $0.03 to $0.05
ramirasss: folds=20
Lorhem: folds=20
Uncalled bet ($0.03) returned to Metridat
Metridat collected $0.05 from pot
*** SUMMARY ***
Total pot $0.05 | Rake $0=20
Seat 1: Metridat (button) collected ($0.05)
Seat 2: ramirasss (small blind) folded before Flop
Seat 3: Lorhem (big blind) folded before Flop
Seat 6: Chernovsky folded before Flop (didn't bet)
Seat 7: tirapolisme folded before Flop (didn't bet)
Seat 8: the_wickstar folded before Flop (didn't bet)
Seat 9: Vladimir65 folded before Flop (didn't bet)


*********** # 173 **************
PokerStars Hand #169529827020:  Hold'em No Limit ($0.01/$0.02 USD) - 20=
17/04/25 20:01:34 CUST [2017/04/25 6:01:34 ET]
Table 'Peneleos' 9-max Seat #3 is the button
Seat 1: Strelo4ekk ($2.11 in chips)=20
Seat 3: the_wickstar ($1.04 in chips)=20
Seat 5: MISHKA2220 ($2.30 in chips)=20
Seat 7: emmmetswe ($1.88 in chips)=20
Seat 8: i2dv8 ($1.40 in chips)=20
Seat 9: vartovij ($1.13 in chips)=20
MISHKA2220: posts small blind $0.01
emmmetswe: posts big blind $0.02
*** HOLE CARDS ***
Dealt to the_wickstar [Qh Jc]
i2dv8: folds=20
vartovij: calls $0.02
Strelo4ekk: folds=20
the_wickstar: raises $0.04 to $0.06
MISHKA2220: folds=20
emmmetswe: folds=20
vartovij: calls $0.04
*** FLOP *** [Kc Ah 5c]
vartovij: bets $0.07
the_wickstar: calls $0.07
*** TURN *** [Kc Ah 5c] [4s]
vartovij: checks=20
the_wickstar: checks=20
*** RIVER *** [Kc Ah 5c 4s] [4c]
vartovij: checks=20
the_wickstar: bets $0.28
vartovij: folds=20
Uncalled bet ($0.28) returned to the_wickstar
the_wickstar collected $0.28 from pot
*** SUMMARY ***
Total pot $0.29 | Rake $0.01=20
Board [Kc Ah 5c 4s 4c]
Seat 1: Strelo4ekk folded before Flop (didn't bet)
Seat 3: the_wickstar (button) collected ($0.28)
Seat 5: MISHKA2220 (small blind) folded before Flop
Seat 7: emmmetswe (big blind) folded before Flop
Seat 8: i2dv8 folded before Flop (didn't bet)
Seat 9: vartovij folded on the River


*********** # 174 **************
PokerStars Hand #169529799186:  Hold'em No Limit ($0.01/$0.02 USD) - 20=
17/04/25 20:00:18 CUST [2017/04/25 6:00:18 ET]
Table 'Peneleos' 9-max Seat #1 is the button
Seat 1: Strelo4ekk ($2.11 in chips)=20
Seat 3: the_wickstar ($1.06 in chips)=20
Seat 4: Ape50 ($6.01 in chips)=20
Seat 5: MISHKA2220 ($2.30 in chips)=20
Seat 7: emmmetswe ($1.88 in chips)=20
Seat 8: i2dv8 ($1.15 in chips)=20
Seat 9: vartovij ($1.13 in chips)=20
the_wickstar: posts small blind $0.01
Ape50: posts big blind $0.02
*** HOLE CARDS ***
Dealt to the_wickstar [Kc 7s]
MISHKA2220: folds=20
emmmetswe: folds=20
i2dv8: calls $0.02
GypsyBaron leaves the table
vartovij has timed out
vartovij: folds=20
Strelo4ekk: folds=20
the_wickstar: calls $0.01
Ape50: checks=20
*** FLOP *** [9h 8d 5h]
the_wickstar: checks=20
Ape50: bets $0.05
i2dv8: raises $0.05 to $0.10
the_wickstar: folds=20
Ape50: calls $0.05
*** TURN *** [9h 8d 5h] [Jc]
Ape50: checks=20
i2dv8: bets $0.13
Ape50: calls $0.13
*** RIVER *** [9h 8d 5h Jc] [3c]
Ape50: checks=20
i2dv8: checks=20
*** SHOW DOWN ***
Ape50: shows [Ah 2h] (high card Ace)
i2dv8: shows [9c Tc] (a pair of Nines)
i2dv8 collected $0.50 from pot
*** SUMMARY ***
Total pot $0.52 | Rake $0.02=20
Board [9h 8d 5h Jc 3c]
Seat 1: Strelo4ekk (button) folded before Flop (didn't bet)
Seat 3: the_wickstar (small blind) folded on the Flop
Seat 4: Ape50 (big blind) showed [Ah 2h] and lost with high card Ace
Seat 5: MISHKA2220 folded before Flop (didn't bet)
Seat 7: emmmetswe folded before Flop (didn't bet)
Seat 8: i2dv8 showed [9c Tc] and won ($0.50) with a pair of Nines
Seat 9: vartovij folded before Flop (didn't bet)


*********** # 175 **************
PokerStars Hand #169529795206:  Hold'em No Limit ($0.01/$0.02 USD) - 20=
17/04/25 20:00:07 CUST [2017/04/25 6:00:07 ET]
Table 'El Djezair' 9-max Seat #9 is the button
Seat 1: Metridat ($0.85 in chips)=20
Seat 2: ramirasss ($1.21 in chips)=20
Seat 3: Lorhem ($0.89 in chips)=20
Seat 4: AND55REW ($2.08 in chips)=20
Seat 6: Chernovsky ($2.04 in chips)=20
Seat 7: tirapolisme ($1.91 in chips)=20
Seat 8: the_wickstar ($1.27 in chips)=20
Seat 9: Vladimir65 ($0.56 in chips)=20
Metridat: posts small blind $0.01
ramirasss: posts big blind $0.02
*** HOLE CARDS ***
Dealt to the_wickstar [9d 2s]
Lorhem: calls $0.02
AND55REW: folds=20
AND55REW leaves the table
Chernovsky: folds=20
izy cykerman joins the table at seat #4=20
tirapolisme: folds=20
the_wickstar: folds=20
Vladimir65: calls $0.02
Metridat: folds=20
ramirasss: checks=20
*** FLOP *** [6d 7h 8d]
ramirasss: bets $0.02
Lorhem: raises $0.04 to $0.06
Vladimir65: calls $0.06
ramirasss: calls $0.04
*** TURN *** [6d 7h 8d] [Jc]
ramirasss: checks=20
Lorhem: bets $0.08
Vladimir65: calls $0.08
ramirasss: folds=20
*** RIVER *** [6d 7h 8d Jc] [Kd]
Lorhem: bets $0.28
Vladimir65: folds=20
Uncalled bet ($0.28) returned to Lorhem
Lorhem collected $0.40 from pot
Lorhem: doesn't show hand=20
*** SUMMARY ***
Total pot $0.41 | Rake $0.01=20
Board [6d 7h 8d Jc Kd]
Seat 1: Metridat (small blind) folded before Flop
Seat 2: ramirasss (big blind) folded on the Turn
Seat 3: Lorhem collected ($0.40)
Seat 4: AND55REW folded before Flop (didn't bet)
Seat 6: Chernovsky folded before Flop (didn't bet)
Seat 7: tirapolisme folded before Flop (didn't bet)
Seat 8: the_wickstar folded before Flop (didn't bet)
Seat 9: Vladimir65 (button) folded on the River


*********** # 176 **************
PokerStars Hand #169529784062:  Hold'em No Limit ($0.01/$0.02 USD) - 20=
17/04/25 19:59:34 CUST [2017/04/25 5:59:34 ET]
Table 'El Djezair' 9-max Seat #8 is the button
Seat 1: Metridat ($0.80 in chips)=20
Seat 2: ramirasss ($1.21 in chips)=20
Seat 3: Lorhem ($0.89 in chips)=20
Seat 4: AND55REW ($2.08 in chips)=20
Seat 6: Chernovsky ($2.04 in chips)=20
Seat 7: tirapolisme ($1.91 in chips)=20
Seat 8: the_wickstar ($1.27 in chips)=20
Seat 9: Vladimir65 ($0.61 in chips)=20
Vladimir65: posts small blind $0.01
Metridat: posts big blind $0.02
*** HOLE CARDS ***
Dealt to the_wickstar [8d 6s]
ramirasss: folds=20
Lorhem: folds=20
AND55REW: folds=20
Chernovsky: folds=20
tirapolisme: folds=20
the_wickstar: folds=20
Vladimir65: calls $0.01
Metridat: checks=20
*** FLOP *** [9d Jd Kc]
Vladimir65: checks=20
Metridat: bets $0.03
Vladimir65: calls $0.03
*** TURN *** [9d Jd Kc] [Kh]
Vladimir65: checks=20
Metridat: bets $0.08
Vladimir65: folds=20
Uncalled bet ($0.08) returned to Metridat
Metridat collected $0.10 from pot
*** SUMMARY ***
Total pot $0.10 | Rake $0=20
Board [9d Jd Kc Kh]
Seat 1: Metridat (big blind) collected ($0.10)
Seat 2: ramirasss folded before Flop (didn't bet)
Seat 3: Lorhem folded before Flop (didn't bet)
Seat 4: AND55REW folded before Flop (didn't bet)
Seat 6: Chernovsky folded before Flop (didn't bet)
Seat 7: tirapolisme folded before Flop (didn't bet)
Seat 8: the_wickstar (button) folded before Flop (didn't bet)
Seat 9: Vladimir65 (small blind) folded on the Turn


*********** # 177 **************
PokerStars Hand #169529778669:  Hold'em No Limit ($0.01/$0.02 USD) - 20=
17/04/25 19:59:19 CUST [2017/04/25 5:59:19 ET]
Table 'Peneleos' 9-max Seat #9 is the button
Seat 1: Strelo4ekk ($2.13 in chips)=20
Seat 2: GypsyBaron ($2.05 in chips)=20
Seat 3: the_wickstar ($1.06 in chips)=20
Seat 4: Ape50 ($6.03 in chips)=20
Seat 5: MISHKA2220 ($2.28 in chips)=20
Seat 7: emmmetswe ($1.88 in chips)=20
Seat 8: i2dv8 ($1.15 in chips)=20
Seat 9: vartovij ($1.13 in chips)=20
Strelo4ekk: posts small blind $0.01
GypsyBaron: posts big blind $0.02
*** HOLE CARDS ***
Dealt to the_wickstar [6d 7s]
the_wickstar: folds=20
Ape50: calls $0.02
MISHKA2220: calls $0.02
emmmetswe: folds=20
i2dv8: folds=20
vartovij: folds=20
Strelo4ekk: calls $0.01
GypsyBaron: checks=20
*** FLOP *** [Qd 5c 6h]
Strelo4ekk: checks=20
GypsyBaron: checks=20
Ape50: checks=20
MISHKA2220: checks=20
*** TURN *** [Qd 5c 6h] [9c]
Strelo4ekk: checks=20
GypsyBaron: checks=20
Ape50: checks=20
MISHKA2220: checks=20
*** RIVER *** [Qd 5c 6h 9c] [Ad]
Strelo4ekk: checks=20
GypsyBaron: checks=20
Ape50: checks=20
MISHKA2220: checks=20
*** SHOW DOWN ***
Strelo4ekk: shows [Kh 8h] (high card Ace)
GypsyBaron: shows [Td Ac] (a pair of Aces)
Ape50: mucks hand=20
MISHKA2220: shows [Ah Th] (a pair of Aces)
GypsyBaron collected $0.04 from pot
MISHKA2220 collected $0.04 from pot
*** SUMMARY ***
Total pot $0.08 | Rake $0=20
Board [Qd 5c 6h 9c Ad]
Seat 1: Strelo4ekk (small blind) showed [Kh 8h] and lost with high card=
 Ace
Seat 2: GypsyBaron (big blind) showed [Td Ac] and won ($0.04) with a pa=
ir of Aces
Seat 3: the_wickstar folded before Flop (didn't bet)
Seat 4: Ape50 mucked [3h 3c]
Seat 5: MISHKA2220 showed [Ah Th] and won ($0.04) with a pair of Aces
Seat 7: emmmetswe folded before Flop (didn't bet)
Seat 8: i2dv8 folded before Flop (didn't bet)
Seat 9: vartovij (button) folded before Flop (didn't bet)


*********** # 178 **************
PokerStars Hand #169529768090:  Hold'em No Limit ($0.01/$0.02 USD) - 20=
17/04/25 19:58:48 CUST [2017/04/25 5:58:48 ET]
Table 'El Djezair' 9-max Seat #7 is the button
Seat 1: Metridat ($0.80 in chips)=20
Seat 2: ramirasss ($1.17 in chips)=20
Seat 3: Lorhem ($0.89 in chips)=20
Seat 4: AND55REW ($2.08 in chips)=20
Seat 6: Chernovsky ($2.04 in chips)=20
Seat 7: tirapolisme ($1.91 in chips)=20
Seat 8: the_wickstar ($1.29 in chips)=20
Seat 9: Vladimir65 ($0.63 in chips)=20
the_wickstar: posts small blind $0.01
Vladimir65: posts big blind $0.02
*** HOLE CARDS ***
Dealt to the_wickstar [Tc 4s]
Metridat: folds=20
ramirasss: calls $0.02
Lorhem: folds=20
AND55REW: folds=20
Chernovsky: folds=20
tirapolisme: folds=20
the_wickstar: calls $0.01
Vladimir65: checks=20
*** FLOP *** [As Ad 8h]
the_wickstar: checks=20
Vladimir65: checks=20
ramirasss: bets $0.06
the_wickstar: folds=20
Vladimir65: folds=20
Uncalled bet ($0.06) returned to ramirasss
ramirasss collected $0.06 from pot
ramirasss: doesn't show hand=20
*** SUMMARY ***
Total pot $0.06 | Rake $0=20
Board [As Ad 8h]
Seat 1: Metridat folded before Flop (didn't bet)
Seat 2: ramirasss collected ($0.06)
Seat 3: Lorhem folded before Flop (didn't bet)
Seat 4: AND55REW folded before Flop (didn't bet)
Seat 6: Chernovsky folded before Flop (didn't bet)
Seat 7: tirapolisme (button) folded before Flop (didn't bet)
Seat 8: the_wickstar (small blind) folded on the Flop
Seat 9: Vladimir65 (big blind) folded on the Flop


*********** # 179 **************
PokerStars Hand #169529759032:  Hold'em No Limit ($0.01/$0.02 USD) - 20=
17/04/25 19:58:22 CUST [2017/04/25 5:58:22 ET]
Table 'Peneleos' 9-max Seat #8 is the button
Seat 1: Strelo4ekk ($2.13 in chips)=20
Seat 2: GypsyBaron ($2.05 in chips)=20
Seat 3: the_wickstar ($1.06 in chips)=20
Seat 4: Ape50 ($6.03 in chips)=20
Seat 5: MISHKA2220 ($2.28 in chips)=20
Seat 6: Fominoff76 ($0.67 in chips)=20
Seat 7: emmmetswe ($1.88 in chips)=20
Seat 8: i2dv8 ($1.15 in chips)=20
Seat 9: vartovij ($1.14 in chips)=20
vartovij: posts small blind $0.01
Strelo4ekk: posts big blind $0.02
*** HOLE CARDS ***
Dealt to the_wickstar [5c 8d]
GypsyBaron: folds=20
the_wickstar: folds=20
Ape50: folds=20
MISHKA2220: folds=20
Fominoff76: folds=20
emmmetswe: folds=20
i2dv8: calls $0.02
vartovij: folds=20
Strelo4ekk: checks=20
*** FLOP *** [Jc 9s 3h]
Strelo4ekk: checks=20
i2dv8: checks=20
*** TURN *** [Jc 9s 3h] [Jd]
Strelo4ekk: bets $0.05
i2dv8: calls $0.05
*** RIVER *** [Jc 9s 3h Jd] [7c]
Strelo4ekk: checks=20
i2dv8: checks=20
*** SHOW DOWN ***
Strelo4ekk: shows [Td Kh] (a pair of Jacks)
i2dv8: shows [Kc Th] (a pair of Jacks)
Strelo4ekk collected $0.07 from pot
i2dv8 collected $0.07 from pot
*** SUMMARY ***
Total pot $0.15 | Rake $0.01=20
Board [Jc 9s 3h Jd 7c]
Seat 1: Strelo4ekk (big blind) showed [Td Kh] and won ($0.07) with a pa=
ir of Jacks
Seat 2: GypsyBaron folded before Flop (didn't bet)
Seat 3: the_wickstar folded before Flop (didn't bet)
Seat 4: Ape50 folded before Flop (didn't bet)
Seat 5: MISHKA2220 folded before Flop (didn't bet)
Seat 6: Fominoff76 folded before Flop (didn't bet)
Seat 7: emmmetswe folded before Flop (didn't bet)
Seat 8: i2dv8 (button) showed [Kc Th] and won ($0.07) with a pair of Ja=
cks
Seat 9: vartovij (small blind) folded before Flop


*********** # 180 **************
PokerStars Hand #169529757973:  Hold'em No Limit ($0.01/$0.02 USD) - 20=
17/04/25 19:58:19 CUST [2017/04/25 5:58:19 ET]
Table 'El Djezair' 9-max Seat #6 is the button
Seat 1: Metridat ($0.80 in chips)=20
Seat 2: ramirasss ($1.14 in chips)=20
Seat 3: Lorhem ($0.89 in chips)=20
Seat 4: AND55REW ($2.08 in chips)=20
Seat 6: Chernovsky ($2.04 in chips)=20
Seat 7: tirapolisme ($1.92 in chips)=20
Seat 8: the_wickstar ($1.31 in chips)=20
Seat 9: Vladimir65 ($0.63 in chips)=20
tirapolisme: posts small blind $0.01
the_wickstar: posts big blind $0.02
*** HOLE CARDS ***
Dealt to the_wickstar [6d Kd]
Vladimir65: folds=20
Metridat: folds=20
ramirasss: raises $0.04 to $0.06
Lorhem: folds=20
AND55REW: folds=20
Chernovsky: folds=20
tirapolisme: folds=20
the_wickstar: folds=20
Uncalled bet ($0.04) returned to ramirasss
ramirasss collected $0.05 from pot
ramirasss: doesn't show hand=20
*** SUMMARY ***
Total pot $0.05 | Rake $0=20
Seat 1: Metridat folded before Flop (didn't bet)
Seat 2: ramirasss collected ($0.05)
Seat 3: Lorhem folded before Flop (didn't bet)
Seat 4: AND55REW folded before Flop (didn't bet)
Seat 6: Chernovsky (button) folded before Flop (didn't bet)
Seat 7: tirapolisme (small blind) folded before Flop
Seat 8: the_wickstar (big blind) folded before Flop
Seat 9: Vladimir65 folded before Flop (didn't bet)


*********** # 181 **************
PokerStars Hand #169529750986:  Hold'em No Limit ($0.01/$0.02 USD) - 20=
17/04/25 19:57:58 CUST [2017/04/25 5:57:58 ET]
Table 'Peneleos' 9-max Seat #7 is the button
Seat 1: Strelo4ekk ($2.13 in chips)=20
Seat 2: GypsyBaron ($2.05 in chips)=20
Seat 3: the_wickstar ($1.06 in chips)=20
Seat 4: Ape50 ($6.03 in chips)=20
Seat 5: MISHKA2220 ($2.28 in chips)=20
Seat 6: Fominoff76 ($0.64 in chips)=20
Seat 7: emmmetswe ($1.88 in chips)=20
Seat 8: i2dv8 ($1.16 in chips)=20
Seat 9: vartovij ($1.16 in chips)=20
i2dv8: posts small blind $0.01
vartovij: posts big blind $0.02
*** HOLE CARDS ***
Dealt to the_wickstar [9c 6d]
Strelo4ekk: folds=20
GypsyBaron: folds=20
the_wickstar: folds=20
Ape50: folds=20
MISHKA2220: folds=20
Fominoff76: raises $0.62 to $0.64 and is all-in
emmmetswe: folds=20
i2dv8: folds=20
vartovij: folds=20
Uncalled bet ($0.62) returned to Fominoff76
Fominoff76 collected $0.05 from pot
*** SUMMARY ***
Total pot $0.05 | Rake $0=20
Seat 1: Strelo4ekk folded before Flop (didn't bet)
Seat 2: GypsyBaron folded before Flop (didn't bet)
Seat 3: the_wickstar folded before Flop (didn't bet)
Seat 4: Ape50 folded before Flop (didn't bet)
Seat 5: MISHKA2220 folded before Flop (didn't bet)
Seat 6: Fominoff76 collected ($0.05)
Seat 7: emmmetswe (button) folded before Flop (didn't bet)
Seat 8: i2dv8 (small blind) folded before Flop
Seat 9: vartovij (big blind) folded before Flop


*********** # 182 **************
PokerStars Hand #169529742090:  Hold'em No Limit ($0.01/$0.02 USD) - 20=
17/04/25 19:57:33 CUST [2017/04/25 5:57:33 ET]
Table 'Peneleos' 9-max Seat #6 is the button
Seat 1: Strelo4ekk ($2.13 in chips)=20
Seat 2: GypsyBaron ($2.05 in chips)=20
Seat 3: the_wickstar ($1.06 in chips)=20
Seat 4: Ape50 ($6.03 in chips)=20
Seat 5: MISHKA2220 ($2.28 in chips)=20
Seat 6: Fominoff76 ($0.64 in chips)=20
Seat 7: emmmetswe ($1.89 in chips)=20
Seat 8: i2dv8 ($1.15 in chips)=20
Seat 9: vartovij ($1.16 in chips)=20
emmmetswe: posts small blind $0.01
i2dv8: posts big blind $0.02
*** HOLE CARDS ***
Dealt to the_wickstar [Kh 4c]
vartovij: folds=20
Strelo4ekk: folds=20
GypsyBaron: folds=20
the_wickstar: folds=20
Ape50: folds=20
MISHKA2220: folds=20
Fominoff76: folds=20
emmmetswe: folds=20
Uncalled bet ($0.01) returned to i2dv8
i2dv8 collected $0.02 from pot
i2dv8: doesn't show hand=20
*** SUMMARY ***
Total pot $0.02 | Rake $0=20
Seat 1: Strelo4ekk folded before Flop (didn't bet)
Seat 2: GypsyBaron folded before Flop (didn't bet)
Seat 3: the_wickstar folded before Flop (didn't bet)
Seat 4: Ape50 folded before Flop (didn't bet)
Seat 5: MISHKA2220 folded before Flop (didn't bet)
Seat 6: Fominoff76 (button) folded before Flop (didn't bet)
Seat 7: emmmetswe (small blind) folded before Flop
Seat 8: i2dv8 (big blind) collected ($0.02)
Seat 9: vartovij folded before Flop (didn't bet)


*********** # 183 **************
PokerStars Hand #169529740231:  Hold'em No Limit ($0.01/$0.02 USD) - 20=
17/04/25 19:57:27 CUST [2017/04/25 5:57:27 ET]
Table 'El Djezair' 9-max Seat #4 is the button
Seat 1: Metridat ($0.80 in chips)=20
Seat 2: ramirasss ($1.14 in chips)=20
Seat 3: Lorhem ($0.89 in chips)=20
Seat 4: AND55REW ($2.08 in chips)=20
Seat 6: Chernovsky ($2 in chips)=20
Seat 7: tirapolisme ($1.94 in chips)=20
Seat 8: the_wickstar ($1.33 in chips)=20
Seat 9: Vladimir65 ($0.63 in chips)=20
Chernovsky: posts small blind $0.01
tirapolisme: posts big blind $0.02
*** HOLE CARDS ***
Dealt to the_wickstar [Jc Qh]
the_wickstar: calls $0.02
Vladimir65: folds=20
Metridat: folds=20
ramirasss: folds=20
Lorhem: folds=20
AND55REW has timed out
AND55REW: folds=20
Chernovsky: calls $0.01
tirapolisme: checks=20
*** FLOP *** [8h 7d 9d]
Chernovsky: bets $0.04
tirapolisme: folds=20
the_wickstar: folds=20
Uncalled bet ($0.04) returned to Chernovsky
Chernovsky collected $0.06 from pot
Chernovsky: doesn't show hand=20
*** SUMMARY ***
Total pot $0.06 | Rake $0=20
Board [8h 7d 9d]
Seat 1: Metridat folded before Flop (didn't bet)
Seat 2: ramirasss folded before Flop (didn't bet)
Seat 3: Lorhem folded before Flop (didn't bet)
Seat 4: AND55REW (button) folded before Flop (didn't bet)
Seat 6: Chernovsky (small blind) collected ($0.06)
Seat 7: tirapolisme (big blind) folded on the Flop
Seat 8: the_wickstar folded on the Flop
Seat 9: Vladimir65 folded before Flop (didn't bet)


*********** # 184 **************
PokerStars Hand #169529723701:  Hold'em No Limit ($0.01/$0.02 USD) - 20=
17/04/25 19:56:39 CUST [2017/04/25 5:56:39 ET]
Table 'Peneleos' 9-max Seat #5 is the button
Seat 1: Strelo4ekk ($2.13 in chips)=20
Seat 2: GypsyBaron ($2.05 in chips)=20
Seat 3: the_wickstar ($1.06 in chips)=20
Seat 4: Ape50 ($6.03 in chips)=20
Seat 5: MISHKA2220 ($2 in chips)=20
Seat 6: Fominoff76 ($0.65 in chips)=20
Seat 7: emmmetswe ($1.91 in chips)=20
Seat 8: i2dv8 ($1.42 in chips)=20
Seat 9: vartovij ($1.16 in chips)=20
Fominoff76: posts small blind $0.01
emmmetswe: posts big blind $0.02
*** HOLE CARDS ***
Dealt to the_wickstar [3s 2s]
i2dv8: raises $0.04 to $0.06
vartovij: folds=20
Strelo4ekk: folds=20
GypsyBaron: folds=20
the_wickstar: folds=20
Ape50: folds=20
MISHKA2220: calls $0.06
Fominoff76: folds=20
emmmetswe: folds=20
*** FLOP *** [Kc 4s Td]
i2dv8: bets $0.07
MISHKA2220: calls $0.07
*** TURN *** [Kc 4s Td] [Ad]
i2dv8: checks=20
MISHKA2220: checks=20
*** RIVER *** [Kc 4s Td Ad] [Kd]
i2dv8: checks=20
MISHKA2220: bets $0.14
i2dv8: calls $0.14
*** SHOW DOWN ***
MISHKA2220: shows [Kh Qh] (three of a kind, Kings)
i2dv8: mucks hand=20
MISHKA2220 collected $0.55 from pot
*** SUMMARY ***
Total pot $0.57 | Rake $0.02=20
Board [Kc 4s Td Ad Kd]
Seat 1: Strelo4ekk folded before Flop (didn't bet)
Seat 2: GypsyBaron folded before Flop (didn't bet)
Seat 3: the_wickstar folded before Flop (didn't bet)
Seat 4: Ape50 folded before Flop (didn't bet)
Seat 5: MISHKA2220 (button) showed [Kh Qh] and won ($0.55) with three o=
f a kind, Kings
Seat 6: Fominoff76 (small blind) folded before Flop
Seat 7: emmmetswe (big blind) folded before Flop
Seat 8: i2dv8 mucked [5h 5s]
Seat 9: vartovij folded before Flop (didn't bet)


*********** # 185 **************
PokerStars Hand #169529723667:  Hold'em No Limit ($0.01/$0.02 USD) - 20=
17/04/25 19:56:39 CUST [2017/04/25 5:56:39 ET]
Table 'El Djezair' 9-max Seat #3 is the button
Seat 1: Metridat ($0.80 in chips)=20
Seat 2: ramirasss ($1.06 in chips)=20
Seat 3: Lorhem ($0.89 in chips)=20
Seat 4: AND55REW ($2.09 in chips)=20
Seat 6: Chernovsky ($2 in chips)=20
Seat 7: tirapolisme ($1.94 in chips)=20
Seat 8: the_wickstar ($1.33 in chips)=20
Seat 9: Vladimir65 ($0.69 in chips)=20
AND55REW: posts small blind $0.01
Chernovsky: posts big blind $0.02
*** HOLE CARDS ***
Dealt to the_wickstar [8h 6h]
tirapolisme: folds=20
the_wickstar: folds=20
Vladimir65: calls $0.02
Metridat: folds=20
ramirasss: raises $0.04 to $0.06
Lorhem: folds=20
AND55REW: folds=20
Chernovsky: folds=20
Vladimir65: calls $0.04
*** FLOP *** [3c 9c 9h]
Vladimir65: checks=20
ramirasss: checks=20
*** TURN *** [3c 9c 9h] [2s]
Vladimir65: checks=20
ramirasss: bets $0.08
Vladimir65: folds=20
Uncalled bet ($0.08) returned to ramirasss
ramirasss collected $0.14 from pot
ramirasss: doesn't show hand=20
*** SUMMARY ***
Total pot $0.15 | Rake $0.01=20
Board [3c 9c 9h 2s]
Seat 1: Metridat folded before Flop (didn't bet)
Seat 2: ramirasss collected ($0.14)
Seat 3: Lorhem (button) folded before Flop (didn't bet)
Seat 4: AND55REW (small blind) folded before Flop
Seat 6: Chernovsky (big blind) folded before Flop
Seat 7: tirapolisme folded before Flop (didn't bet)
Seat 8: the_wickstar folded before Flop (didn't bet)
Seat 9: Vladimir65 folded on the Turn


*********** # 186 **************
PokerStars Hand #169529707683:  Hold'em No Limit ($0.01/$0.02 USD) - 20=
17/04/25 19:55:51 CUST [2017/04/25 5:55:51 ET]
Table 'Peneleos' 9-max Seat #4 is the button
Seat 1: Strelo4ekk ($2.10 in chips)=20
Seat 2: GypsyBaron ($2.05 in chips)=20
Seat 3: the_wickstar ($1.06 in chips)=20
Seat 4: Ape50 ($6.03 in chips)=20
Seat 5: MISHKA2220 ($2 in chips)=20
Seat 6: Fominoff76 ($0.67 in chips)=20
Seat 7: emmmetswe ($1.91 in chips)=20
Seat 8: i2dv8 ($1.42 in chips)=20
Seat 9: vartovij ($1.16 in chips)=20
MISHKA2220: posts small blind $0.01
Fominoff76: posts big blind $0.02
*** HOLE CARDS ***
Dealt to the_wickstar [2c 9h]
emmmetswe: folds=20
i2dv8: folds=20
vartovij: folds=20
Strelo4ekk: raises $0.04 to $0.06
GypsyBaron: folds=20
the_wickstar: folds=20
Ape50: folds=20
MISHKA2220: folds=20
Fominoff76: folds=20
Uncalled bet ($0.04) returned to Strelo4ekk
Strelo4ekk collected $0.05 from pot
Strelo4ekk: doesn't show hand=20
*** SUMMARY ***
Total pot $0.05 | Rake $0=20
Seat 1: Strelo4ekk collected ($0.05)
Seat 2: GypsyBaron folded before Flop (didn't bet)
Seat 3: the_wickstar folded before Flop (didn't bet)
Seat 4: Ape50 (button) folded before Flop (didn't bet)
Seat 5: MISHKA2220 (small blind) folded before Flop
Seat 6: Fominoff76 (big blind) folded before Flop
Seat 7: emmmetswe folded before Flop (didn't bet)
Seat 8: i2dv8 folded before Flop (didn't bet)
Seat 9: vartovij folded before Flop (didn't bet)


*********** # 187 **************
PokerStars Hand #169529697446:  Hold'em No Limit ($0.01/$0.02 USD) - 20=
17/04/25 19:55:21 CUST [2017/04/25 5:55:21 ET]
Table 'El Djezair' 9-max Seat #2 is the button
Seat 1: Metridat ($0.80 in chips)=20
Seat 2: ramirasss ($1.13 in chips)=20
Seat 3: Lorhem ($0.90 in chips)=20
Seat 4: AND55REW ($2 in chips)=20
Seat 6: david pare ($2.76 in chips)=20
Seat 7: tirapolisme ($1.94 in chips)=20
Seat 8: the_wickstar ($1.35 in chips)=20
Seat 9: Vladimir65 ($0.69 in chips)=20
Lorhem: posts small blind $0.01
AND55REW: posts big blind $0.02
*** HOLE CARDS ***
Dealt to the_wickstar [4h Ah]
david pare: folds=20
tirapolisme: folds=20
the_wickstar: calls $0.02
Vladimir65: folds=20
Metridat: folds=20
david pare leaves the table
ramirasss: calls $0.02
Chernovsky joins the table at seat #6=20
Lorhem: folds=20
AND55REW: checks=20
*** FLOP *** [Qs 8c Th]
AND55REW: bets $0.05
the_wickstar: folds=20
ramirasss: calls $0.05
*** TURN *** [Qs 8c Th] [4c]
AND55REW: checks=20
ramirasss: checks=20
*** RIVER *** [Qs 8c Th 4c] [5h]
AND55REW: checks=20
ramirasss: checks=20
*** SHOW DOWN ***
AND55REW: shows [Qc 9h] (a pair of Queens)
ramirasss: mucks hand=20
AND55REW collected $0.16 from pot
*** SUMMARY ***
Total pot $0.17 | Rake $0.01=20
Board [Qs 8c Th 4c 5h]
Seat 1: Metridat folded before Flop (didn't bet)
Seat 2: ramirasss (button) mucked [Jc Ts]
Seat 3: Lorhem (small blind) folded before Flop
Seat 4: AND55REW (big blind) showed [Qc 9h] and won ($0.16) with a pair=
 of Queens
Seat 6: david pare folded before Flop (didn't bet)
Seat 7: tirapolisme folded before Flop (didn't bet)
Seat 8: the_wickstar folded on the Flop
Seat 9: Vladimir65 folded before Flop (didn't bet)


*********** # 188 **************
PokerStars Hand #169529690608:  Hold'em No Limit ($0.01/$0.02 USD) - 20=
17/04/25 19:55:01 CUST [2017/04/25 5:55:01 ET]
Table 'Peneleos' 9-max Seat #3 is the button
Seat 1: Strelo4ekk ($2 in chips)=20
Seat 2: GypsyBaron ($2.05 in chips)=20
Seat 3: the_wickstar ($1.06 in chips)=20
Seat 4: Ape50 ($6.04 in chips)=20
Seat 5: MISHKA2220 ($2.05 in chips)=20
Seat 6: Fominoff76 ($0.67 in chips)=20
Seat 7: emmmetswe ($1.91 in chips)=20
Seat 8: i2dv8 ($1.42 in chips)=20
Seat 9: vartovij ($1.16 in chips)=20
Ape50: posts small blind $0.01
MISHKA2220: posts big blind $0.02
*** HOLE CARDS ***
Dealt to the_wickstar [2s 3d]
Fominoff76: folds=20
emmmetswe: folds=20
i2dv8: folds=20
vartovij: folds=20
Strelo4ekk: raises $0.08 to $0.10
GypsyBaron: folds=20
the_wickstar: folds=20
Ape50: folds=20
MISHKA2220: calls $0.08
*** FLOP *** [4c 2d As]
MISHKA2220: checks=20
Strelo4ekk: bets $0.15
MISHKA2220: folds=20
Uncalled bet ($0.15) returned to Strelo4ekk
Strelo4ekk collected $0.20 from pot
Strelo4ekk: doesn't show hand=20
*** SUMMARY ***
Total pot $0.21 | Rake $0.01=20
Board [4c 2d As]
Seat 1: Strelo4ekk collected ($0.20)
Seat 2: GypsyBaron folded before Flop (didn't bet)
Seat 3: the_wickstar (button) folded before Flop (didn't bet)
Seat 4: Ape50 (small blind) folded before Flop
Seat 5: MISHKA2220 (big blind) folded on the Flop
Seat 6: Fominoff76 folded before Flop (didn't bet)
Seat 7: emmmetswe folded before Flop (didn't bet)
Seat 8: i2dv8 folded before Flop (didn't bet)
Seat 9: vartovij folded before Flop (didn't bet)


*********** # 189 **************
PokerStars Hand #169529684106:  Hold'em No Limit ($0.01/$0.02 USD) - 20=
17/04/25 19:54:44 CUST [2017/04/25 5:54:44 ET]
Table 'El Djezair' 9-max Seat #1 is the button
Seat 1: Metridat ($0.80 in chips)=20
Seat 2: ramirasss ($1.04 in chips)=20
Seat 3: Lorhem ($0.92 in chips)=20
Seat 4: AND55REW ($2 in chips)=20
Seat 6: david pare ($2.84 in chips)=20
Seat 7: tirapolisme ($1.94 in chips)=20
Seat 8: the_wickstar ($1.35 in chips)=20
Seat 9: Vladimir65 ($0.69 in chips)=20
ramirasss: posts small blind $0.01
Lorhem: posts big blind $0.02
*** HOLE CARDS ***
Dealt to the_wickstar [2d 9s]
AND55REW: folds=20
david pare: calls $0.02
tirapolisme: folds=20
the_wickstar: folds=20
Vladimir65: folds=20
Metridat: folds=20
ramirasss: raises $0.06 to $0.08
Lorhem: folds=20
david pare: calls $0.06
*** FLOP *** [Js 5h 4c]
ramirasss: bets $0.17
david pare: folds=20
Uncalled bet ($0.17) returned to ramirasss
ramirasss collected $0.17 from pot
ramirasss: doesn't show hand=20
*** SUMMARY ***
Total pot $0.18 | Rake $0.01=20
Board [Js 5h 4c]
Seat 1: Metridat (button) folded before Flop (didn't bet)
Seat 2: ramirasss (small blind) collected ($0.17)
Seat 3: Lorhem (big blind) folded before Flop
Seat 4: AND55REW folded before Flop (didn't bet)
Seat 6: david pare folded on the Flop
Seat 7: tirapolisme folded before Flop (didn't bet)
Seat 8: the_wickstar folded before Flop (didn't bet)
Seat 9: Vladimir65 folded before Flop (didn't bet)


*********** # 190 **************
PokerStars Hand #169529675606:  Hold'em No Limit ($0.01/$0.02 USD) - 20=
17/04/25 19:54:21 CUST [2017/04/25 5:54:21 ET]
Table 'Peneleos' 9-max Seat #2 is the button
Seat 1: Strelo4ekk ($2 in chips)=20
Seat 2: GypsyBaron ($2.05 in chips)=20
Seat 3: the_wickstar ($1.07 in chips)=20
Seat 4: Ape50 ($6.06 in chips)=20
Seat 5: MISHKA2220 ($2.05 in chips)=20
Seat 6: Fominoff76 ($0.64 in chips)=20
Seat 7: emmmetswe ($1.91 in chips)=20
Seat 8: i2dv8 ($1.42 in chips)=20
Seat 9: vartovij ($1.16 in chips)=20
the_wickstar: posts small blind $0.01
Ape50: posts big blind $0.02
*** HOLE CARDS ***
Dealt to the_wickstar [6h 2c]
MISHKA2220: folds=20
Fominoff76: raises $0.62 to $0.64 and is all-in
emmmetswe: folds=20
i2dv8: folds=20
vartovij: folds=20
Strelo4ekk: folds=20
GypsyBaron: folds=20
the_wickstar: folds=20
Ape50: folds=20
Uncalled bet ($0.62) returned to Fominoff76
Fominoff76 collected $0.05 from pot
*** SUMMARY ***
Total pot $0.05 | Rake $0=20
Seat 1: Strelo4ekk folded before Flop (didn't bet)
Seat 2: GypsyBaron (button) folded before Flop (didn't bet)
Seat 3: the_wickstar (small blind) folded before Flop
Seat 4: Ape50 (big blind) folded before Flop
Seat 5: MISHKA2220 folded before Flop (didn't bet)
Seat 6: Fominoff76 collected ($0.05)
Seat 7: emmmetswe folded before Flop (didn't bet)
Seat 8: i2dv8 folded before Flop (didn't bet)
Seat 9: vartovij folded before Flop (didn't bet)


*********** # 191 **************
PokerStars Hand #169529669605:  Hold'em No Limit ($0.01/$0.02 USD) - 20=
17/04/25 19:54:05 CUST [2017/04/25 5:54:05 ET]
Table 'El Djezair' 9-max Seat #9 is the button
Seat 1: Metridat ($0.80 in chips)=20
Seat 2: ramirasss ($1.06 in chips)=20
Seat 3: Lorhem ($0.92 in chips)=20
Seat 4: AND55REW ($2 in chips)=20
Seat 6: david pare ($2.86 in chips)=20
Seat 7: tirapolisme ($1.94 in chips)=20
Seat 8: the_wickstar ($1.30 in chips)=20
Seat 9: Vladimir65 ($0.69 in chips)=20
Metridat: posts small blind $0.01
ramirasss: posts big blind $0.02
*** HOLE CARDS ***
Dealt to the_wickstar [Ah Kh]
Lorhem: folds=20
AND55REW: folds=20
david pare: calls $0.02
tirapolisme: folds=20
the_wickstar: raises $0.04 to $0.06
Vladimir65: folds=20
Metridat: folds=20
ramirasss: folds=20
david pare: folds=20
Uncalled bet ($0.04) returned to the_wickstar
the_wickstar collected $0.07 from pot
*** SUMMARY ***
Total pot $0.07 | Rake $0=20
Seat 1: Metridat (small blind) folded before Flop
Seat 2: ramirasss (big blind) folded before Flop
Seat 3: Lorhem folded before Flop (didn't bet)
Seat 4: AND55REW folded before Flop (didn't bet)
Seat 6: david pare folded before Flop
Seat 7: tirapolisme folded before Flop (didn't bet)
Seat 8: the_wickstar collected ($0.07)
Seat 9: Vladimir65 (button) folded before Flop (didn't bet)


*********** # 192 **************
PokerStars Hand #169529655776:  Hold'em No Limit ($0.01/$0.02 USD) - 20=
17/04/25 19:53:29 CUST [2017/04/25 5:53:29 ET]
Table 'El Djezair' 9-max Seat #8 is the button
Seat 1: Metridat ($0.80 in chips)=20
Seat 2: ramirasss ($1.06 in chips)=20
Seat 3: Lorhem ($0.92 in chips)=20
Seat 4: AND55REW ($2 in chips)=20
Seat 6: david pare ($2.86 in chips)=20
Seat 7: tirapolisme ($1.94 in chips)=20
Seat 8: the_wickstar ($1.27 in chips)=20
Seat 9: Vladimir65 ($0.70 in chips)=20
Vladimir65: posts small blind $0.01
Metridat: posts big blind $0.02
*** HOLE CARDS ***
Dealt to the_wickstar [Jh Js]
ramirasss: folds=20
Lorhem: folds=20
AND55REW: folds=20
david pare: folds=20
tirapolisme: folds=20
the_wickstar: raises $0.04 to $0.06
Vladimir65: folds=20
Metridat: folds=20
Uncalled bet ($0.04) returned to the_wickstar
the_wickstar collected $0.05 from pot
*** SUMMARY ***
Total pot $0.05 | Rake $0=20
Seat 1: Metridat (big blind) folded before Flop
Seat 2: ramirasss folded before Flop (didn't bet)
Seat 3: Lorhem folded before Flop (didn't bet)
Seat 4: AND55REW folded before Flop (didn't bet)
Seat 6: david pare folded before Flop (didn't bet)
Seat 7: tirapolisme folded before Flop (didn't bet)
Seat 8: the_wickstar (button) collected ($0.05)
Seat 9: Vladimir65 (small blind) folded before Flop


*********** # 193 **************
PokerStars Hand #169529650561:  Hold'em No Limit ($0.01/$0.02 USD) - 20=
17/04/25 19:53:16 CUST [2017/04/25 5:53:16 ET]
Table 'Peneleos' 9-max Seat #1 is the button
Seat 1: Strelo4ekk ($2 in chips)=20
Seat 2: GypsyBaron ($2.06 in chips)=20
Seat 3: the_wickstar ($1 in chips)=20
Seat 4: Ape50 ($6.06 in chips)=20
Seat 5: MISHKA2220 ($2.05 in chips)=20
Seat 6: Fominoff76 ($0.70 in chips)=20
Seat 7: emmmetswe ($1.91 in chips)=20
Seat 8: i2dv8 ($1.42 in chips)=20
Seat 9: vartovij ($1.16 in chips)=20
GypsyBaron: posts small blind $0.01
the_wickstar: posts big blind $0.02
*** HOLE CARDS ***
Dealt to the_wickstar [Ah Jc]
Ape50: folds=20
MISHKA2220: folds=20
Fominoff76: calls $0.02
emmmetswe: folds=20
i2dv8: folds=20
vartovij: folds=20
Strelo4ekk: folds=20
GypsyBaron: folds=20
the_wickstar: raises $0.04 to $0.06
Fominoff76: calls $0.04
*** FLOP *** [Kh 8d Kc]
the_wickstar: checks=20
Fominoff76: checks=20
*** TURN *** [Kh 8d Kc] [2d]
the_wickstar: bets $0.08
Fominoff76: folds=20
Uncalled bet ($0.08) returned to the_wickstar
the_wickstar collected $0.13 from pot
*** SUMMARY ***
Total pot $0.13 | Rake $0=20
Board [Kh 8d Kc 2d]
Seat 1: Strelo4ekk (button) folded before Flop (didn't bet)
Seat 2: GypsyBaron (small blind) folded before Flop
Seat 3: the_wickstar (big blind) collected ($0.13)
Seat 4: Ape50 folded before Flop (didn't bet)
Seat 5: MISHKA2220 folded before Flop (didn't bet)
Seat 6: Fominoff76 folded on the Turn
Seat 7: emmmetswe folded before Flop (didn't bet)
Seat 8: i2dv8 folded before Flop (didn't bet)
Seat 9: vartovij folded before Flop (didn't bet)


*********** # 194 **************
PokerStars Hand #169529633499:  Hold'em No Limit ($0.01/$0.02 USD) - 20=
17/04/25 19:52:32 CUST [2017/04/25 5:52:32 ET]
Table 'El Djezair' 9-max Seat #7 is the button
Seat 1: esson450 ($2.70 in chips)=20
Seat 2: ramirasss ($1.06 in chips)=20
Seat 3: Lorhem ($0.92 in chips)=20
Seat 4: AND55REW ($2 in chips)=20
Seat 6: david pare ($2.86 in chips)=20
Seat 7: tirapolisme ($1.94 in chips)=20
Seat 8: the_wickstar ($1.25 in chips)=20
Seat 9: Vladimir65 ($0.72 in chips)=20
the_wickstar: posts small blind $0.01
Vladimir65: posts big blind $0.02
*** HOLE CARDS ***
Dealt to the_wickstar [Jc 5h]
esson450: folds=20
ramirasss: folds=20
Lorhem: folds=20
AND55REW: folds=20
david pare: folds=20
tirapolisme: folds=20
the_wickstar: calls $0.01
esson450 leaves the table
Vladimir65: checks=20
*** FLOP *** [4s 5d Qd]
Metridat joins the table at seat #1=20
the_wickstar: checks=20
Vladimir65: checks=20
*** TURN *** [4s 5d Qd] [9d]
the_wickstar: checks=20
Vladimir65: checks=20
*** RIVER *** [4s 5d Qd 9d] [As]
the_wickstar: checks=20
Vladimir65: checks=20
*** SHOW DOWN ***
the_wickstar: shows [Jc 5h] (a pair of Fives)
Vladimir65: mucks hand=20
the_wickstar collected $0.04 from pot
*** SUMMARY ***
Total pot $0.04 | Rake $0=20
Board [4s 5d Qd 9d As]
Seat 1: esson450 folded before Flop (didn't bet)
Seat 2: ramirasss folded before Flop (didn't bet)
Seat 3: Lorhem folded before Flop (didn't bet)
Seat 4: AND55REW folded before Flop (didn't bet)
Seat 6: david pare folded before Flop (didn't bet)
Seat 7: tirapolisme (button) folded before Flop (didn't bet)
Seat 8: the_wickstar (small blind) showed [Jc 5h] and won ($0.04) with =
a pair of Fives
Seat 9: Vladimir65 (big blind) mucked [3h 6d]


*********** # 195 **************
PokerStars Hand #169529625493:  Hold'em No Limit ($0.01/$0.02 USD) - 20=
17/04/25 19:52:11 CUST [2017/04/25 5:52:11 ET]
Table 'Peneleos' 9-max Seat #9 is the button
Seat 1: Strelo4ekk ($2 in chips)=20
Seat 2: GypsyBaron ($2.08 in chips)=20
Seat 3: the_wickstar ($1.10 in chips)=20
Seat 4: Ape50 ($6.06 in chips)=20
Seat 5: MISHKA2220 ($2.05 in chips)=20
Seat 6: Fominoff76 ($1.24 in chips)=20
Seat 7: emmmetswe ($1.91 in chips)=20
Seat 8: i2dv8 ($1.42 in chips)=20
Seat 9: vartovij ($0.53 in chips)=20
Strelo4ekk: posts small blind $0.01
GypsyBaron: posts big blind $0.02
Fominoff76: posts small & big blinds $0.03
*** HOLE CARDS ***
Dealt to the_wickstar [Js Kh]
the_wickstar: calls $0.02
Ape50: folds=20
MISHKA2220: folds=20
Fominoff76: raises $0.08 to $0.10
emmmetswe: folds=20
i2dv8: folds=20
vartovij: calls $0.10
Strelo4ekk: folds=20
GypsyBaron: folds=20
the_wickstar: calls $0.08
*** FLOP *** [6h 4d Ah]
the_wickstar: checks=20
Fominoff76: bets $0.17
vartovij: raises $0.26 to $0.43 and is all-in
the_wickstar: folds=20
Fominoff76: calls $0.26
*** TURN *** [6h 4d Ah] [5c]
*** RIVER *** [6h 4d Ah 5c] [9d]
*** SHOW DOWN ***
Fominoff76: shows [Th 7h] (high card Ace)
vartovij: shows [Ts As] (a pair of Aces)
vartovij collected $1.16 from pot
*** SUMMARY ***
Total pot $1.20 | Rake $0.04=20
Board [6h 4d Ah 5c 9d]
Seat 1: Strelo4ekk (small blind) folded before Flop
Seat 2: GypsyBaron (big blind) folded before Flop
Seat 3: the_wickstar folded on the Flop
Seat 4: Ape50 folded before Flop (didn't bet)
Seat 5: MISHKA2220 folded before Flop (didn't bet)
Seat 6: Fominoff76 showed [Th 7h] and lost with high card Ace
Seat 7: emmmetswe folded before Flop (didn't bet)
Seat 8: i2dv8 folded before Flop (didn't bet)
Seat 9: vartovij (button) showed [Ts As] and won ($1.16) with a pair of=
 Aces


*********** # 196 **************
PokerStars Hand #169529600189:  Hold'em No Limit ($0.01/$0.02 USD) - 20=
17/04/25 19:51:04 CUST [2017/04/25 5:51:04 ET]
Table 'El Djezair' 9-max Seat #6 is the button
Seat 1: esson450 ($2.80 in chips)=20
Seat 2: ramirasss ($0.94 in chips)=20
Seat 3: Lorhem ($0.92 in chips)=20
Seat 4: AND55REW ($2 in chips)=20
Seat 6: david pare ($2.86 in chips)=20
Seat 7: tirapolisme ($1.95 in chips)=20
Seat 8: the_wickstar ($1.27 in chips)=20
Seat 9: Vladimir65 ($0.72 in chips)=20
tirapolisme: posts small blind $0.01
the_wickstar: posts big blind $0.02
*** HOLE CARDS ***
Dealt to the_wickstar [7s 9s]
Vladimir65: folds=20
esson450: calls $0.02
ramirasss: raises $0.04 to $0.06
Lorhem: folds=20
AND55REW: folds=20
david pare: folds=20
tirapolisme: folds=20
the_wickstar: folds=20
esson450: calls $0.04
*** FLOP *** [5h 4d Th]
esson450: checks=20
ramirasss: checks=20
*** TURN *** [5h 4d Th] [3s]
esson450: checks=20
ramirasss: checks=20
*** RIVER *** [5h 4d Th 3s] [Kc]
esson450: checks=20
ramirasss: bets $0.04
esson450: calls $0.04
*** SHOW DOWN ***
ramirasss: shows [Ks 8h] (a pair of Kings)
esson450: mucks hand=20
ramirasss collected $0.22 from pot
*** SUMMARY ***
Total pot $0.23 | Rake $0.01=20
Board [5h 4d Th 3s Kc]
Seat 1: esson450 mucked [6h Kh]
Seat 2: ramirasss showed [Ks 8h] and won ($0.22) with a pair of Kings
Seat 3: Lorhem folded before Flop (didn't bet)
Seat 4: AND55REW folded before Flop (didn't bet)
Seat 6: david pare (button) folded before Flop (didn't bet)
Seat 7: tirapolisme (small blind) folded before Flop
Seat 8: the_wickstar (big blind) folded before Flop
Seat 9: Vladimir65 folded before Flop (didn't bet)


*********** # 197 **************
PokerStars Hand #169529585755:  Hold'em No Limit ($0.01/$0.02 USD) - 20=
17/04/25 19:50:27 CUST [2017/04/25 5:50:27 ET]
Table 'Peneleos' 9-max Seat #8 is the button
Seat 1: Strelo4ekk ($2 in chips)=20
Seat 2: GypsyBaron ($2.08 in chips)=20
Seat 3: the_wickstar ($0.80 in chips)=20
Seat 4: Ape50 ($6.06 in chips)=20
Seat 5: MISHKA2220 ($2.05 in chips)=20
Seat 7: emmmetswe ($1.97 in chips)=20
Seat 8: i2dv8 ($1.48 in chips)=20
Seat 9: vartovij ($0.71 in chips)=20
vartovij: posts small blind $0.01
Strelo4ekk: posts big blind $0.02
Fominoff76: sits out=20
*** HOLE CARDS ***
Dealt to the_wickstar [Ad 5h]
GypsyBaron: folds=20
the_wickstar: raises $0.04 to $0.06
Ape50: folds=20
MISHKA2220: folds=20
emmmetswe: calls $0.06
i2dv8: calls $0.06
vartovij: calls $0.05
Strelo4ekk: folds=20
*** FLOP *** [3h 6d Qd]
vartovij: checks=20
the_wickstar: bets $0.12
emmmetswe: folds=20
i2dv8: folds=20
vartovij: calls $0.12
*** TURN *** [3h 6d Qd] [Qc]
vartovij: checks=20
the_wickstar: bets $0.24
vartovij: folds=20
Uncalled bet ($0.24) returned to the_wickstar
the_wickstar collected $0.48 from pot
*** SUMMARY ***
Total pot $0.50 | Rake $0.02=20
Board [3h 6d Qd Qc]
Seat 1: Strelo4ekk (big blind) folded before Flop
Seat 2: GypsyBaron folded before Flop (didn't bet)
Seat 3: the_wickstar collected ($0.48)
Seat 4: Ape50 folded before Flop (didn't bet)
Seat 5: MISHKA2220 folded before Flop (didn't bet)
Seat 7: emmmetswe folded on the Flop
Seat 8: i2dv8 (button) folded on the Flop
Seat 9: vartovij (small blind) folded on the Turn


*********** # 198 **************
PokerStars Hand #169529567131:  Hold'em No Limit ($0.01/$0.02 USD) - 20=
17/04/25 19:49:38 CUST [2017/04/25 5:49:38 ET]
Table 'El Djezair' 9-max Seat #4 is the button
Seat 1: esson450 ($2.80 in chips)=20
Seat 2: ramirasss ($0.94 in chips)=20
Seat 3: Lorhem ($0.92 in chips)=20
Seat 4: AND55REW ($2 in chips)=20
Seat 6: david pare ($2.68 in chips)=20
Seat 7: tirapolisme ($1.97 in chips)=20
Seat 8: the_wickstar ($1.27 in chips)=20
Seat 9: Vladimir65 ($0.72 in chips)=20
david pare: posts small blind $0.01
tirapolisme: posts big blind $0.02
*** HOLE CARDS ***
Dealt to the_wickstar [Kc 3h]
the_wickstar: folds=20
Vladimir65: folds=20
esson450: folds=20
ramirasss: folds=20
Lorhem: folds=20
AND55REW: raises $0.04 to $0.06
david pare: calls $0.05
tirapolisme: folds=20
*** FLOP *** [8c Jd 6s]
david pare: checks=20
AND55REW: bets $0.11
david pare: calls $0.11
*** TURN *** [8c Jd 6s] [9s]
david pare: checks=20
AND55REW: checks=20
*** RIVER *** [8c Jd 6s 9s] [7h]
david pare: bets $0.20
AND55REW: folds=20
Uncalled bet ($0.20) returned to david pare
david pare collected $0.35 from pot
*** SUMMARY ***
Total pot $0.36 | Rake $0.01=20
Board [8c Jd 6s 9s 7h]
Seat 1: esson450 folded before Flop (didn't bet)
Seat 2: ramirasss folded before Flop (didn't bet)
Seat 3: Lorhem folded before Flop (didn't bet)
Seat 4: AND55REW (button) folded on the River
Seat 6: david pare (small blind) collected ($0.35)
Seat 7: tirapolisme (big blind) folded before Flop
Seat 8: the_wickstar folded before Flop (didn't bet)
Seat 9: Vladimir65 folded before Flop (didn't bet)


*********** # 199 **************
PokerStars Hand #169529566403:  Hold'em No Limit ($0.01/$0.02 USD) - 20=
17/04/25 19:49:36 CUST [2017/04/25 5:49:36 ET]
Table 'Peneleos' 9-max Seat #7 is the button
Seat 2: GypsyBaron ($2.08 in chips)=20
Seat 3: the_wickstar ($0.82 in chips)=20
Seat 4: Ape50 ($6.06 in chips)=20
Seat 5: MISHKA2220 ($2 in chips)=20
Seat 7: emmmetswe ($1.97 in chips)=20
Seat 8: i2dv8 ($1.49 in chips)=20
Seat 9: vartovij ($0.73 in chips)=20
i2dv8: posts small blind $0.01
vartovij: posts big blind $0.02
Strelo4ekk: sits out=20
Fominoff76 is connected=20
Fominoff76: sits out=20
*** HOLE CARDS ***
Dealt to the_wickstar [Js Qh]
GypsyBaron: folds=20
the_wickstar: calls $0.02
Ape50: folds=20
MISHKA2220: raises $0.08 to $0.10
emmmetswe: folds=20
i2dv8: folds=20
vartovij: folds=20
the_wickstar: folds=20
Uncalled bet ($0.08) returned to MISHKA2220
MISHKA2220 collected $0.07 from pot
*** SUMMARY ***
Total pot $0.07 | Rake $0=20
Seat 2: GypsyBaron folded before Flop (didn't bet)
Seat 3: the_wickstar folded before Flop
Seat 4: Ape50 folded before Flop (didn't bet)
Seat 5: MISHKA2220 collected ($0.07)
Seat 7: emmmetswe (button) folded before Flop (didn't bet)
Seat 8: i2dv8 (small blind) folded before Flop
Seat 9: vartovij (big blind) folded before Flop


*********** # 200 **************
PokerStars Hand #169529559921:  Hold'em No Limit ($0.01/$0.02 USD) - 20=
17/04/25 19:49:19 CUST [2017/04/25 5:49:19 ET]
Table 'Peneleos' 9-max Seat #5 is the button
Seat 2: GypsyBaron ($2.08 in chips)=20
Seat 3: the_wickstar ($0.82 in chips)=20
Seat 4: Ape50 ($6.06 in chips)=20
Seat 5: MISHKA2220 ($2 in chips)=20
Seat 7: emmmetswe ($1.98 in chips)=20
Seat 8: i2dv8 ($1.48 in chips)=20
Seat 9: vartovij ($0.73 in chips)=20
Fominoff76 will be allowed to play after the button
emmmetswe: posts small blind $0.01
i2dv8: posts big blind $0.02
Strelo4ekk: sits out=20
*** HOLE CARDS ***
Dealt to the_wickstar [7d 5d]
Fominoff76 is disconnected=20
vartovij: folds=20
GypsyBaron: folds=20
the_wickstar: folds=20
Ape50: folds=20
MISHKA2220: folds=20
emmmetswe: folds=20
Uncalled bet ($0.01) returned to i2dv8
i2dv8 collected $0.02 from pot
i2dv8: doesn't show hand=20
*** SUMMARY ***
Total pot $0.02 | Rake $0=20
Seat 2: GypsyBaron folded before Flop (didn't bet)
Seat 3: the_wickstar folded before Flop (didn't bet)
Seat 4: Ape50 folded before Flop (didn't bet)
Seat 5: MISHKA2220 (button) folded before Flop (didn't bet)
Seat 7: emmmetswe (small blind) folded before Flop
Seat 8: i2dv8 (big blind) collected ($0.02)
Seat 9: vartovij folded before Flop (didn't bet)



If you have any questions, please contact us at "PokerStars Support" <s=
upport@pokerstars.com>


