Delivered-To: sherhan.wicky@gmail.com
Received: by 10.79.162.140 with SMTP id k12csp733201ivh;
        Fri, 28 Apr 2017 19:23:20 -0700 (PDT)
X-Received: by 10.28.96.195 with SMTP id u186mr507585wmb.109.1493432600261;
        Fri, 28 Apr 2017 19:23:20 -0700 (PDT)
Return-Path: <support@pokerstars.com>
Received: from mx13.pokerstars.eu (mx13.pokerstars.eu. [77.87.179.125])
        by mx.google.com with ESMTPS id t4si7941352wra.71.2017.04.28.19.23.19
        for <sherhan.wicky@gmail.com>
        (version=TLS1_2 cipher=ECDHE-RSA-AES128-GCM-SHA256 bits=128/128);
        Fri, 28 Apr 2017 19:23:20 -0700 (PDT)
Received-SPF: pass (google.com: domain of support@pokerstars.com designates 77.87.179.125 as permitted sender) client-ip=77.87.179.125;
Authentication-Results: mx.google.com;
       dkim=pass (test mode) header.i=@pokerstars.com;
       spf=pass (google.com: domain of support@pokerstars.com designates 77.87.179.125 as permitted sender) smtp.mailfrom=support@pokerstars.com
Received: by mx13.pokerstars.eu (mailer, from userid 4004)
	id 6204414007C8; Fri, 28 Apr 2017 22:23:19 -0400 (EDT)
DKIM-Signature: v=1; a=rsa-sha1; c=relaxed; d=pokerstars.com; h=date
	:from:to:subject:message-id:mime-version:content-type
	:content-transfer-encoding; s=s1024; bh=4Ay0oNt6KYQ6jwgXKK11iGQj
	EwM=; b=LnyWwtx9La66BuI4KgpPuZ2B6BvEmCmJUjUBzX6khKzw/IA9NWaamXaq
	tIe7133mrxswrkoGiFYlhoNSgSoAKrMJWmTIPsNEXKhHYkk4J/pNwsKQ9czVCYKE
	31z75tngO7KZ5L0gsyTMvTFyNRXqd9AocCQM7TfiFJig9cEHSoA=
X-PS-ID: c2hlcmhhbi53aWNreUBnbWFpbC5jb20=
Received: from pokerstars.com (unknown [192.168.8.81])
	by mx13.pokerstars.eu (mailer) with SMTP id 469E7140086C
	for <sherhan.wicky@gmail.com>; Fri, 28 Apr 2017 22:23:19 -0400 (EDT)
Date: Fri, 28 Apr 2017 22:23:19 -0400
From: "PokerStars Support" <support@pokerstars.com>
To: sherhan.wicky@gmail.com
Subject: PokerStars Hand History Request - last 1 day of play
Message-Id: <5903F917.94520DD2F2ABFD@pokerstars.com>
MIME-Version: 1.0
Content-Type: text/plain;
 charset="windows-1252"
Content-Transfer-Encoding: quoted-printable


Transcript for last 1 day of play requested by the_wickstar (sherhan.wi=
cky@gmail.com)

*********** # 1 **************
PokerStars Hand #169698839410:  Hold'em No Limit ($0.01/$0.02 USD) - 20=
17/04/29 12:22:17 CUST [2017/04/28 22:22:17 ET]
Table 'Antilia' 9-max Seat #9 is the button
Seat 1: nakasan6 ($0.70 in chips)=20
Seat 2: the_wickstar ($1.39 in chips)=20
Seat 3: diment76 ($1.58 in chips)=20
Seat 4: agapee92 ($2 in chips)=20
Seat 5: tomashovka55 ($3.13 in chips)=20
Seat 6: themarfs ($2.29 in chips)=20
Seat 7: vini374 ($2.28 in chips)=20
Seat 9: rafaciarlini ($0.89 in chips)=20
nakasan6: posts small blind $0.01
murzik650 leaves the table
the_wickstar: posts big blind $0.02
*** HOLE CARDS ***
Dealt to the_wickstar [2c 9d]
diment76: folds=20
agapee92: folds=20
tomashovka55: folds=20
themarfs: folds=20
vini374: calls $0.02
rafaciarlini: folds=20
rafaciarlini leaves the table
hard nutss joins the table at seat #8=20
nakasan6: raises $0.04 to $0.06
the_wickstar: folds=20
vini374: calls $0.04
*** FLOP *** [Qh Qs 5c]
hard nutss leaves the table
nakasan6: checks=20
vini374: bets $0.06
nakasan6: raises $0.06 to $0.12
vini374: calls $0.06
*** TURN *** [Qh Qs 5c] [7h]
nakasan6: bets $0.19
vini374: folds=20
Uncalled bet ($0.19) returned to nakasan6
nakasan6 collected $0.37 from pot
*** SUMMARY ***
Total pot $0.38 | Rake $0.01=20
Board [Qh Qs 5c 7h]
Seat 1: nakasan6 (small blind) collected ($0.37)
Seat 2: the_wickstar (big blind) folded before Flop
Seat 3: diment76 folded before Flop (didn't bet)
Seat 4: agapee92 folded before Flop (didn't bet)
Seat 5: tomashovka55 folded before Flop (didn't bet)
Seat 6: themarfs folded before Flop (didn't bet)
Seat 7: vini374 folded on the Turn
Seat 9: rafaciarlini (button) folded before Flop (didn't bet)


*********** # 2 **************
PokerStars Hand #169698823639:  Hold'em No Limit ($0.01/$0.02 USD) - 20=
17/04/29 12:21:36 CUST [2017/04/28 22:21:36 ET]
Table 'Wilkens' 9-max Seat #2 is the button
Seat 1: saromano ($1.86 in chips)=20
Seat 2: 1Asthma1 ($2 in chips)=20
Seat 3: agapee92 ($2 in chips)=20
Seat 4: hieukta ($2.28 in chips)=20
Seat 5: SMUTJAN72 ($1.80 in chips)=20
Seat 7: the_wickstar ($2.38 in chips)=20
Seat 8: clasicos ($1.95 in chips)=20
Seat 9: breelzer ($2.12 in chips)=20
agapee92: posts small blind $0.01
hieukta: posts big blind $0.02
blac_jac 71: sits out=20
*** HOLE CARDS ***
Dealt to the_wickstar [4d Kc]
SMUTJAN72: folds=20
the_wickstar: folds=20
clasicos: folds=20
breelzer: folds=20
saromano: folds=20
1Asthma1: folds=20
agapee92: folds=20
Uncalled bet ($0.01) returned to hieukta
hieukta collected $0.02 from pot
hieukta: doesn't show hand=20
*** SUMMARY ***
Total pot $0.02 | Rake $0=20
Seat 1: saromano folded before Flop (didn't bet)
Seat 2: 1Asthma1 (button) folded before Flop (didn't bet)
Seat 3: agapee92 (small blind) folded before Flop
Seat 4: hieukta (big blind) collected ($0.02)
Seat 5: SMUTJAN72 folded before Flop (didn't bet)
Seat 7: the_wickstar folded before Flop (didn't bet)
Seat 8: clasicos folded before Flop (didn't bet)
Seat 9: breelzer folded before Flop (didn't bet)


*********** # 3 **************
PokerStars Hand #169698816373:  Hold'em No Limit ($0.01/$0.02 USD) - 20=
17/04/29 12:21:17 CUST [2017/04/28 22:21:17 ET]
Table 'Antilia' 9-max Seat #7 is the button
Seat 1: nakasan6 ($0.70 in chips)=20
Seat 2: the_wickstar ($1.41 in chips)=20
Seat 3: diment76 ($1.58 in chips)=20
Seat 4: agapee92 ($2 in chips)=20
Seat 5: tomashovka55 ($3.13 in chips)=20
Seat 6: themarfs ($2.18 in chips)=20
Seat 7: vini374 ($2.28 in chips)=20
Seat 8: murzik650 ($1.58 in chips)=20
Seat 9: rafaciarlini ($0.91 in chips)=20
murzik650: posts small blind $0.01
rafaciarlini: posts big blind $0.02
*** HOLE CARDS ***
Dealt to the_wickstar [4c 4s]
nakasan6: folds=20
the_wickstar: calls $0.02
diment76: folds=20
agapee92: raises $0.04 to $0.06
tomashovka55: folds=20
themarfs: raises $0.14 to $0.20
vini374: folds=20
murzik650: folds=20
rafaciarlini: folds=20
the_wickstar: folds=20
agapee92: folds=20
Uncalled bet ($0.14) returned to themarfs
themarfs collected $0.17 from pot
themarfs: doesn't show hand=20
*** SUMMARY ***
Total pot $0.17 | Rake $0=20
Seat 1: nakasan6 folded before Flop (didn't bet)
Seat 2: the_wickstar folded before Flop
Seat 3: diment76 folded before Flop (didn't bet)
Seat 4: agapee92 folded before Flop
Seat 5: tomashovka55 folded before Flop (didn't bet)
Seat 6: themarfs collected ($0.17)
Seat 7: vini374 (button) folded before Flop (didn't bet)
Seat 8: murzik650 (small blind) folded before Flop
Seat 9: rafaciarlini (big blind) folded before Flop


*********** # 4 **************
PokerStars Hand #169698804746:  Hold'em No Limit ($0.01/$0.02 USD) - 20=
17/04/29 12:20:46 CUST [2017/04/28 22:20:46 ET]
Table 'Wilkens' 9-max Seat #1 is the button
Seat 1: saromano ($1.86 in chips)=20
Seat 2: 1Asthma1 ($2 in chips)=20
Seat 3: agapee92 ($2 in chips)=20
Seat 4: hieukta ($2.28 in chips)=20
Seat 5: SMUTJAN72 ($1.80 in chips)=20
Seat 7: the_wickstar ($2.38 in chips)=20
Seat 8: clasicos ($1.92 in chips)=20
Seat 9: breelzer ($2.12 in chips)=20
1Asthma1: posts small blind $0.01
agapee92: posts big blind $0.02
blac_jac 71: sits out=20
*** HOLE CARDS ***
Dealt to the_wickstar [4s Ah]
hieukta: folds=20
SMUTJAN72: folds=20
the_wickstar: folds=20
clasicos: raises $0.04 to $0.06
breelzer: folds=20
saromano: folds=20
1Asthma1: folds=20
agapee92: folds=20
Uncalled bet ($0.04) returned to clasicos
clasicos collected $0.05 from pot
clasicos: doesn't show hand=20
*** SUMMARY ***
Total pot $0.05 | Rake $0=20
Seat 1: saromano (button) folded before Flop (didn't bet)
Seat 2: 1Asthma1 (small blind) folded before Flop
Seat 3: agapee92 (big blind) folded before Flop
Seat 4: hieukta folded before Flop (didn't bet)
Seat 5: SMUTJAN72 folded before Flop (didn't bet)
Seat 7: the_wickstar folded before Flop (didn't bet)
Seat 8: clasicos collected ($0.05)
Seat 9: breelzer folded before Flop (didn't bet)


*********** # 5 **************
PokerStars Hand #169698791277:  Hold'em No Limit ($0.01/$0.02 USD) - 20=
17/04/29 12:20:11 CUST [2017/04/28 22:20:11 ET]
Table 'Antilia' 9-max Seat #6 is the button
Seat 1: nakasan6 ($0.70 in chips)=20
Seat 2: the_wickstar ($1.55 in chips)=20
Seat 3: diment76 ($1.58 in chips)=20
Seat 4: agapee92 ($2 in chips)=20
Seat 5: tomashovka55 ($2.94 in chips)=20
Seat 6: themarfs ($2.18 in chips)=20
Seat 7: vini374 ($2.32 in chips)=20
Seat 8: murzik650 ($1.60 in chips)=20
Seat 9: rafaciarlini ($0.91 in chips)=20
vini374: posts small blind $0.01
murzik650: posts big blind $0.02
*** HOLE CARDS ***
Dealt to the_wickstar [Ad Jh]
rafaciarlini: folds=20
nakasan6: folds=20
the_wickstar: calls $0.02
diment76: folds=20
agapee92: folds=20
tomashovka55: raises $0.02 to $0.04
themarfs: folds=20
vini374: calls $0.03
murzik650: folds=20
the_wickstar: calls $0.02
*** FLOP *** [4d 8c 6h]
vini374: checks=20
the_wickstar: bets $0.10
tomashovka55: calls $0.10
vini374: folds=20
*** TURN *** [4d 8c 6h] [Ts]
the_wickstar: checks=20
tomashovka55: bets $0.17
the_wickstar: folds=20
Uncalled bet ($0.17) returned to tomashovka55
tomashovka55 collected $0.33 from pot
tomashovka55: doesn't show hand=20
*** SUMMARY ***
Total pot $0.34 | Rake $0.01=20
Board [4d 8c 6h Ts]
Seat 1: nakasan6 folded before Flop (didn't bet)
Seat 2: the_wickstar folded on the Turn
Seat 3: diment76 folded before Flop (didn't bet)
Seat 4: agapee92 folded before Flop (didn't bet)
Seat 5: tomashovka55 collected ($0.33)
Seat 6: themarfs (button) folded before Flop (didn't bet)
Seat 7: vini374 (small blind) folded on the Flop
Seat 8: murzik650 (big blind) folded before Flop
Seat 9: rafaciarlini folded before Flop (didn't bet)


*********** # 6 **************
PokerStars Hand #169698789410:  Hold'em No Limit ($0.01/$0.02 USD) - 20=
17/04/29 12:20:06 CUST [2017/04/28 22:20:06 ET]
Table 'Wilkens' 9-max Seat #9 is the button
Seat 1: saromano ($1.87 in chips)=20
Seat 2: 1Asthma1 ($2.02 in chips)=20
Seat 3: agapee92 ($2 in chips)=20
Seat 4: hieukta ($2.28 in chips)=20
Seat 5: SMUTJAN72 ($1.77 in chips)=20
Seat 7: the_wickstar ($2.38 in chips)=20
Seat 8: clasicos ($1.92 in chips)=20
Seat 9: breelzer ($2.12 in chips)=20
saromano: posts small blind $0.01
1Asthma1: posts big blind $0.02
blac_jac 71: sits out=20
*** HOLE CARDS ***
Dealt to the_wickstar [4h 7d]
agapee92: folds=20
hieukta: folds=20
SMUTJAN72: raises $0.03 to $0.05
the_wickstar: folds=20
clasicos: folds=20
breelzer: folds=20
saromano: folds=20
1Asthma1: folds=20
Uncalled bet ($0.03) returned to SMUTJAN72
SMUTJAN72 collected $0.05 from pot
SMUTJAN72: doesn't show hand=20
*** SUMMARY ***
Total pot $0.05 | Rake $0=20
Seat 1: saromano (small blind) folded before Flop
Seat 2: 1Asthma1 (big blind) folded before Flop
Seat 3: agapee92 folded before Flop (didn't bet)
Seat 4: hieukta folded before Flop (didn't bet)
Seat 5: SMUTJAN72 collected ($0.05)
Seat 7: the_wickstar folded before Flop (didn't bet)
Seat 8: clasicos folded before Flop (didn't bet)
Seat 9: breelzer (button) folded before Flop (didn't bet)


*********** # 7 **************
PokerStars Hand #169698782641:  Hold'em No Limit ($0.01/$0.02 USD) - 20=
17/04/29 12:19:49 CUST [2017/04/28 22:19:49 ET]
Table 'Antilia' 9-max Seat #5 is the button
Seat 1: nakasan6 ($0.70 in chips)=20
Seat 2: the_wickstar ($1.55 in chips)=20
Seat 3: diment76 ($1.58 in chips)=20
Seat 4: agapee92 ($2 in chips)=20
Seat 5: tomashovka55 ($2.94 in chips)=20
Seat 6: themarfs ($2.19 in chips)=20
Seat 7: vini374 ($2.31 in chips)=20
Seat 8: murzik650 ($1.60 in chips)=20
Seat 9: rafaciarlini ($0.91 in chips)=20
themarfs: posts small blind $0.01
vini374: posts big blind $0.02
*** HOLE CARDS ***
Dealt to the_wickstar [Kd 4d]
murzik650: folds=20
rafaciarlini: folds=20
nakasan6: folds=20
the_wickstar: folds=20
diment76: folds=20
agapee92: folds=20
tomashovka55: folds=20
themarfs: folds=20
Uncalled bet ($0.01) returned to vini374
vini374 collected $0.02 from pot
*** SUMMARY ***
Total pot $0.02 | Rake $0=20
Seat 1: nakasan6 folded before Flop (didn't bet)
Seat 2: the_wickstar folded before Flop (didn't bet)
Seat 3: diment76 folded before Flop (didn't bet)
Seat 4: agapee92 folded before Flop (didn't bet)
Seat 5: tomashovka55 (button) folded before Flop (didn't bet)
Seat 6: themarfs (small blind) folded before Flop
Seat 7: vini374 (big blind) collected ($0.02)
Seat 8: murzik650 folded before Flop (didn't bet)
Seat 9: rafaciarlini folded before Flop (didn't bet)


*********** # 8 **************
PokerStars Hand #169698768458:  Hold'em No Limit ($0.01/$0.02 USD) - 20=
17/04/29 12:19:12 CUST [2017/04/28 22:19:12 ET]
Table 'Wilkens' 9-max Seat #8 is the button
Seat 1: saromano ($1.89 in chips)=20
Seat 2: 1Asthma1 ($2.02 in chips)=20
Seat 3: agapee92 ($2 in chips)=20
Seat 4: hieukta ($2.28 in chips)=20
Seat 5: SMUTJAN72 ($1.77 in chips)=20
Seat 7: the_wickstar ($2.34 in chips)=20
Seat 8: clasicos ($1.92 in chips)=20
Seat 9: breelzer ($2.14 in chips)=20
breelzer: posts small blind $0.01
saromano: posts big blind $0.02
blac_jac 71: sits out=20
*** HOLE CARDS ***
Dealt to the_wickstar [5c 5h]
1Asthma1: folds=20
agapee92: folds=20
hieukta: folds=20
SMUTJAN72: folds=20
the_wickstar: calls $0.02
clasicos: folds=20
breelzer: calls $0.01
saromano: checks=20
*** FLOP *** [Ks Ah Kc]
breelzer: checks=20
saromano: checks=20
the_wickstar: bets $0.03
breelzer: folds=20
saromano: folds=20
Uncalled bet ($0.03) returned to the_wickstar
the_wickstar collected $0.06 from pot
*** SUMMARY ***
Total pot $0.06 | Rake $0=20
Board [Ks Ah Kc]
Seat 1: saromano (big blind) folded on the Flop
Seat 2: 1Asthma1 folded before Flop (didn't bet)
Seat 3: agapee92 folded before Flop (didn't bet)
Seat 4: hieukta folded before Flop (didn't bet)
Seat 5: SMUTJAN72 folded before Flop (didn't bet)
Seat 7: the_wickstar collected ($0.06)
Seat 8: clasicos (button) folded before Flop (didn't bet)
Seat 9: breelzer (small blind) folded on the Flop


*********** # 9 **************
PokerStars Hand #169698762949:  Hold'em No Limit ($0.01/$0.02 USD) - 20=
17/04/29 12:18:58 CUST [2017/04/28 22:18:58 ET]
Table 'Antilia' 9-max Seat #4 is the button
Seat 1: nakasan6 ($0.75 in chips)=20
Seat 2: the_wickstar ($1.55 in chips)=20
Seat 3: diment76 ($1.58 in chips)=20
Seat 4: agapee92 ($2 in chips)=20
Seat 5: tomashovka55 ($2.95 in chips)=20
Seat 6: themarfs ($2.21 in chips)=20
Seat 7: vini374 ($2.31 in chips)=20
Seat 8: murzik650 ($1.60 in chips)=20
Seat 9: rafaciarlini ($0.83 in chips)=20
tomashovka55: posts small blind $0.01
themarfs: posts big blind $0.02
*** HOLE CARDS ***
Dealt to the_wickstar [9s Ks]
vini374: folds=20
murzik650: folds=20
rafaciarlini: raises $0.03 to $0.05
nakasan6: calls $0.05
the_wickstar: folds=20
diment76: folds=20
agapee92: folds=20
tomashovka55: folds=20
themarfs: folds=20
*** FLOP *** [Jh 4d Ts]
rafaciarlini: bets $0.06
nakasan6: folds=20
Uncalled bet ($0.06) returned to rafaciarlini
rafaciarlini collected $0.13 from pot
*** SUMMARY ***
Total pot $0.13 | Rake $0=20
Board [Jh 4d Ts]
Seat 1: nakasan6 folded on the Flop
Seat 2: the_wickstar folded before Flop (didn't bet)
Seat 3: diment76 folded before Flop (didn't bet)
Seat 4: agapee92 (button) folded before Flop (didn't bet)
Seat 5: tomashovka55 (small blind) folded before Flop
Seat 6: themarfs (big blind) folded before Flop
Seat 7: vini374 folded before Flop (didn't bet)
Seat 8: murzik650 folded before Flop (didn't bet)
Seat 9: rafaciarlini collected ($0.13)


*********** # 10 **************
PokerStars Hand #169698750507:  Hold'em No Limit ($0.01/$0.02 USD) - 20=
17/04/29 12:18:25 CUST [2017/04/28 22:18:25 ET]
Table 'Wilkens' 9-max Seat #7 is the button
Seat 1: saromano ($1.89 in chips)=20
Seat 2: 1Asthma1 ($2.02 in chips)=20
Seat 3: agapee92 ($2 in chips)=20
Seat 4: hieukta ($2.28 in chips)=20
Seat 5: SMUTJAN72 ($1.77 in chips)=20
Seat 7: the_wickstar ($2.31 in chips)=20
Seat 8: clasicos ($1.93 in chips)=20
Seat 9: breelzer ($2.16 in chips)=20
clasicos: posts small blind $0.01
breelzer: posts big blind $0.02
blac_jac 71: sits out=20
*** HOLE CARDS ***
Dealt to the_wickstar [Jc 9h]
saromano: folds=20
1Asthma1: folds=20
agapee92: folds=20
hieukta: folds=20
SMUTJAN72: folds=20
the_wickstar: calls $0.02
clasicos: folds=20
breelzer: checks=20
*** FLOP *** [Kc 6h 9d]
breelzer: checks=20
the_wickstar: bets $0.02
breelzer: folds=20
Uncalled bet ($0.02) returned to the_wickstar
the_wickstar collected $0.05 from pot
*** SUMMARY ***
Total pot $0.05 | Rake $0=20
Board [Kc 6h 9d]
Seat 1: saromano folded before Flop (didn't bet)
Seat 2: 1Asthma1 folded before Flop (didn't bet)
Seat 3: agapee92 folded before Flop (didn't bet)
Seat 4: hieukta folded before Flop (didn't bet)
Seat 5: SMUTJAN72 folded before Flop (didn't bet)
Seat 7: the_wickstar (button) collected ($0.05)
Seat 8: clasicos (small blind) folded before Flop
Seat 9: breelzer (big blind) folded on the Flop


*********** # 11 **************
PokerStars Hand #169698750388:  Hold'em No Limit ($0.01/$0.02 USD) - 20=
17/04/29 12:18:25 CUST [2017/04/28 22:18:25 ET]
Table 'Antilia' 9-max Seat #3 is the button
Seat 1: nakasan6 ($0.75 in chips)=20
Seat 2: the_wickstar ($1.55 in chips)=20
Seat 3: diment76 ($1.58 in chips)=20
Seat 4: agapee92 ($2 in chips)=20
Seat 5: tomashovka55 ($2.97 in chips)=20
Seat 6: themarfs ($2.21 in chips)=20
Seat 7: vini374 ($2.31 in chips)=20
Seat 8: murzik650 ($1.57 in chips)=20
Seat 9: rafaciarlini ($0.83 in chips)=20
agapee92: posts small blind $0.01
tomashovka55: posts big blind $0.02
*** HOLE CARDS ***
Dealt to the_wickstar [Qc Th]
themarfs: folds=20
vini374: folds=20
murzik650: raises $0.12 to $0.14
rafaciarlini: folds=20
nakasan6: folds=20
the_wickstar: folds=20
diment76: folds=20
agapee92: folds=20
tomashovka55: folds=20
Uncalled bet ($0.12) returned to murzik650
murzik650 collected $0.05 from pot
murzik650: doesn't show hand=20
*** SUMMARY ***
Total pot $0.05 | Rake $0=20
Seat 1: nakasan6 folded before Flop (didn't bet)
Seat 2: the_wickstar folded before Flop (didn't bet)
Seat 3: diment76 (button) folded before Flop (didn't bet)
Seat 4: agapee92 (small blind) folded before Flop
Seat 5: tomashovka55 (big blind) folded before Flop
Seat 6: themarfs folded before Flop (didn't bet)
Seat 7: vini374 folded before Flop (didn't bet)
Seat 8: murzik650 collected ($0.05)
Seat 9: rafaciarlini folded before Flop (didn't bet)


*********** # 12 **************
PokerStars Hand #169698738930:  Hold'em No Limit ($0.01/$0.02 USD) - 20=
17/04/29 12:17:55 CUST [2017/04/28 22:17:55 ET]
Table 'Wilkens' 9-max Seat #5 is the button
Seat 1: saromano ($1.89 in chips)=20
Seat 2: 1Asthma1 ($2.02 in chips)=20
Seat 3: agapee92 ($2 in chips)=20
Seat 4: hieukta ($2.28 in chips)=20
Seat 5: SMUTJAN72 ($1.77 in chips)=20
Seat 7: the_wickstar ($2.33 in chips)=20
Seat 8: clasicos ($1.89 in chips)=20
Seat 9: breelzer ($2.18 in chips)=20
blac_jac 71 will be allowed to play after the button
the_wickstar: posts small blind $0.01
clasicos: posts big blind $0.02
*** HOLE CARDS ***
Dealt to the_wickstar [7d 5d]
breelzer: calls $0.02
saromano: folds=20
1Asthma1: folds=20
agapee92: folds=20
hieukta: folds=20
SMUTJAN72: folds=20
the_wickstar: calls $0.01
clasicos: raises $0.08 to $0.10
breelzer: folds=20
the_wickstar: folds=20
Uncalled bet ($0.08) returned to clasicos
clasicos collected $0.06 from pot
clasicos: doesn't show hand=20
*** SUMMARY ***
Total pot $0.06 | Rake $0=20
Seat 1: saromano folded before Flop (didn't bet)
Seat 2: 1Asthma1 folded before Flop (didn't bet)
Seat 3: agapee92 folded before Flop (didn't bet)
Seat 4: hieukta folded before Flop (didn't bet)
Seat 5: SMUTJAN72 (button) folded before Flop (didn't bet)
Seat 7: the_wickstar (small blind) folded before Flop
Seat 8: clasicos (big blind) collected ($0.06)
Seat 9: breelzer folded before Flop


*********** # 13 **************
PokerStars Hand #169698712009:  Hold'em No Limit ($0.01/$0.02 USD) - 20=
17/04/29 12:16:45 CUST [2017/04/28 22:16:45 ET]
Table 'Antilia' 9-max Seat #2 is the button
Seat 1: nakasan6 ($0.75 in chips)=20
Seat 2: the_wickstar ($1.38 in chips)=20
Seat 3: diment76 ($1.59 in chips)=20
Seat 4: agapee92 ($2 in chips)=20
Seat 5: ErdgofrGG ($2.91 in chips)=20
Seat 6: themarfs ($2.21 in chips)=20
Seat 7: vini374 ($2.31 in chips)=20
Seat 8: murzik650 ($1.57 in chips)=20
Seat 9: rafaciarlini ($0.98 in chips)=20
diment76: posts small blind $0.01
agapee92: posts big blind $0.02
*** HOLE CARDS ***
Dealt to the_wickstar [Qc Js]
ErdgofrGG: folds=20
ErdgofrGG leaves the table
tomashovka55 joins the table at seat #5=20
themarfs: folds=20
vini374: folds=20
murzik650: folds=20
rafaciarlini: raises $0.03 to $0.05
nakasan6: folds=20
the_wickstar: calls $0.05
diment76: folds=20
agapee92: folds=20
*** FLOP *** [Jh 2d 8d]
rafaciarlini: checks=20
the_wickstar: bets $0.10
rafaciarlini: calls $0.10
*** TURN *** [Jh 2d 8d] [5s]
rafaciarlini: checks=20
the_wickstar: bets $0.15
rafaciarlini: folds=20
Uncalled bet ($0.15) returned to the_wickstar
the_wickstar collected $0.32 from pot
*** SUMMARY ***
Total pot $0.33 | Rake $0.01=20
Board [Jh 2d 8d 5s]
Seat 1: nakasan6 folded before Flop (didn't bet)
Seat 2: the_wickstar (button) collected ($0.32)
Seat 3: diment76 (small blind) folded before Flop
Seat 4: agapee92 (big blind) folded before Flop
Seat 5: ErdgofrGG folded before Flop (didn't bet)
Seat 6: themarfs folded before Flop (didn't bet)
Seat 7: vini374 folded before Flop (didn't bet)
Seat 8: murzik650 folded before Flop (didn't bet)
Seat 9: rafaciarlini folded on the Turn


*********** # 14 **************
PokerStars Hand #169698701636:  Hold'em No Limit ($0.01/$0.02 USD) - 20=
17/04/29 12:16:18 CUST [2017/04/28 22:16:18 ET]
Table 'Wilkens' 9-max Seat #4 is the button
Seat 1: saromano ($1.97 in chips)=20
Seat 2: 1Asthma1 ($2.02 in chips)=20
Seat 3: agapee92 ($2 in chips)=20
Seat 4: hieukta ($2.28 in chips)=20
Seat 5: SMUTJAN72 ($1.78 in chips)=20
Seat 7: the_wickstar ($2.35 in chips)=20
Seat 8: clasicos ($1.89 in chips)=20
Seat 9: breelzer ($2.08 in chips)=20
SMUTJAN72: posts small blind $0.01
ybczq: is sitting out=20
the_wickstar: posts big blind $0.02
*** HOLE CARDS ***
Dealt to the_wickstar [4s 2s]
ybczq leaves the table
clasicos: folds=20
blac_jac 71 joins the table at seat #6=20
breelzer: calls $0.02
saromano: calls $0.02
1Asthma1: folds=20
agapee92: folds=20
hieukta: folds=20
SMUTJAN72: folds=20
the_wickstar: checks=20
*** FLOP *** [5d 8h 7s]
the_wickstar: checks=20
breelzer: checks=20
saromano: bets $0.06
the_wickstar: folds=20
breelzer: calls $0.06
*** TURN *** [5d 8h 7s] [4h]
breelzer: checks=20
saromano: checks=20
*** RIVER *** [5d 8h 7s 4h] [8s]
breelzer: bets $0.04
saromano: folds=20
Uncalled bet ($0.04) returned to breelzer
breelzer collected $0.18 from pot
breelzer: doesn't show hand=20
*** SUMMARY ***
Total pot $0.19 | Rake $0.01=20
Board [5d 8h 7s 4h 8s]
Seat 1: saromano folded on the River
Seat 2: 1Asthma1 folded before Flop (didn't bet)
Seat 3: agapee92 folded before Flop (didn't bet)
Seat 4: hieukta (button) folded before Flop (didn't bet)
Seat 5: SMUTJAN72 (small blind) folded before Flop
Seat 7: the_wickstar (big blind) folded on the Flop
Seat 8: clasicos folded before Flop (didn't bet)
Seat 9: breelzer collected ($0.18)


*********** # 15 **************
PokerStars Hand #169698685458:  Hold'em No Limit ($0.01/$0.02 USD) - 20=
17/04/29 12:15:36 CUST [2017/04/28 22:15:36 ET]
Table 'Wilkens' 9-max Seat #3 is the button
Seat 1: saromano ($1.97 in chips)=20
Seat 2: 1Asthma1 ($2.02 in chips)=20
Seat 3: agapee92 ($2 in chips)=20
Seat 4: hieukta ($2.29 in chips)=20
Seat 5: SMUTJAN72 ($1.82 in chips)=20
Seat 6: ybczq ($2.08 in chips)=20
Seat 7: the_wickstar ($2.30 in chips)=20
Seat 8: clasicos ($1.89 in chips)=20
Seat 9: breelzer ($2.08 in chips)=20
hieukta: posts small blind $0.01
SMUTJAN72: posts big blind $0.02
*** HOLE CARDS ***
Dealt to the_wickstar [Kc Ad]
ybczq: folds=20
the_wickstar: calls $0.02
clasicos: folds=20
breelzer: folds=20
saromano: folds=20
1Asthma1: folds=20
agapee92: folds=20
hieukta: folds=20
SMUTJAN72: checks=20
*** FLOP *** [6d Kh Ac]
SMUTJAN72: bets $0.02
the_wickstar: calls $0.02
*** TURN *** [6d Kh Ac] [7c]
SMUTJAN72: checks=20
the_wickstar: bets $0.02
SMUTJAN72: folds=20
Uncalled bet ($0.02) returned to the_wickstar
the_wickstar collected $0.09 from pot
*** SUMMARY ***
Total pot $0.09 | Rake $0=20
Board [6d Kh Ac 7c]
Seat 1: saromano folded before Flop (didn't bet)
Seat 2: 1Asthma1 folded before Flop (didn't bet)
Seat 3: agapee92 (button) folded before Flop (didn't bet)
Seat 4: hieukta (small blind) folded before Flop
Seat 5: SMUTJAN72 (big blind) folded on the Turn
Seat 6: ybczq folded before Flop (didn't bet)
Seat 7: the_wickstar collected ($0.09)
Seat 8: clasicos folded before Flop (didn't bet)
Seat 9: breelzer folded before Flop (didn't bet)


*********** # 16 **************
PokerStars Hand #169698680955:  Hold'em No Limit ($0.01/$0.02 USD) - 20=
17/04/29 12:15:25 CUST [2017/04/28 22:15:25 ET]
Table 'Antilia' 9-max Seat #1 is the button
Seat 1: nakasan6 ($0.97 in chips)=20
Seat 2: the_wickstar ($1.39 in chips)=20
Seat 3: diment76 ($1.61 in chips)=20
Seat 4: agapee92 ($2 in chips)=20
Seat 5: ErdgofrGG ($2.62 in chips)=20
Seat 6: themarfs ($2.27 in chips)=20
Seat 7: vini374 ($2.31 in chips)=20
Seat 8: murzik650 ($1.57 in chips)=20
Seat 9: rafaciarlini ($0.98 in chips)=20
the_wickstar: posts small blind $0.01
diment76: posts big blind $0.02
*** HOLE CARDS ***
Dealt to the_wickstar [5s Tc]
agapee92: folds=20
ErdgofrGG: raises $0.04 to $0.06
themarfs: calls $0.06
vini374: folds=20
murzik650: folds=20
rafaciarlini: folds=20
nakasan6: raises $0.16 to $0.22
the_wickstar: folds=20
diment76: folds=20
ErdgofrGG: calls $0.16
themarfs: folds=20
*** FLOP *** [5d Td 6h]
ErdgofrGG: checks=20
nakasan6: checks=20
*** TURN *** [5d Td 6h] [2d]
ErdgofrGG: checks=20
nakasan6: checks=20
*** RIVER *** [5d Td 6h 2d] [9h]
ErdgofrGG: checks=20
nakasan6: checks=20
*** SHOW DOWN ***
ErdgofrGG: shows [8d 8c] (a pair of Eights)
nakasan6: mucks hand=20
ErdgofrGG collected $0.51 from pot
*** SUMMARY ***
Total pot $0.53 | Rake $0.02=20
Board [5d Td 6h 2d 9h]
Seat 1: nakasan6 (button) mucked [Qc Ad]
Seat 2: the_wickstar (small blind) folded before Flop
Seat 3: diment76 (big blind) folded before Flop
Seat 4: agapee92 folded before Flop (didn't bet)
Seat 5: ErdgofrGG showed [8d 8c] and won ($0.51) with a pair of Eights
Seat 6: themarfs folded before Flop
Seat 7: vini374 folded before Flop (didn't bet)
Seat 8: murzik650 folded before Flop (didn't bet)
Seat 9: rafaciarlini folded before Flop (didn't bet)


*********** # 17 **************
PokerStars Hand #169698672743:  Hold'em No Limit ($0.01/$0.02 USD) - 20=
17/04/29 12:15:04 CUST [2017/04/28 22:15:04 ET]
Table 'Wilkens' 9-max Seat #2 is the button
Seat 1: saromano ($1.97 in chips)=20
Seat 2: 1Asthma1 ($2.02 in chips)=20
Seat 3: agapee92 ($2 in chips)=20
Seat 4: hieukta ($2.31 in chips)=20
Seat 5: SMUTJAN72 ($1.82 in chips)=20
Seat 6: ybczq ($2 in chips)=20
Seat 7: the_wickstar ($2.30 in chips)=20
Seat 8: clasicos ($1.89 in chips)=20
Seat 9: breelzer ($2.14 in chips)=20
agapee92: posts small blind $0.01
hieukta: posts big blind $0.02
*** HOLE CARDS ***
Dealt to the_wickstar [5h 4d]
SMUTJAN72: folds=20
ybczq: raises $0.04 to $0.06
the_wickstar: folds=20
clasicos: folds=20
breelzer: calls $0.06
saromano: folds=20
1Asthma1: folds=20
agapee92: folds=20
hieukta: folds=20
*** FLOP *** [Qc 9s Js]
ybczq: bets $0.07
breelzer: folds=20
Uncalled bet ($0.07) returned to ybczq
ybczq collected $0.14 from pot
ybczq: doesn't show hand=20
*** SUMMARY ***
Total pot $0.15 | Rake $0.01=20
Board [Qc 9s Js]
Seat 1: saromano folded before Flop (didn't bet)
Seat 2: 1Asthma1 (button) folded before Flop (didn't bet)
Seat 3: agapee92 (small blind) folded before Flop
Seat 4: hieukta (big blind) folded before Flop
Seat 5: SMUTJAN72 folded before Flop (didn't bet)
Seat 6: ybczq collected ($0.14)
Seat 7: the_wickstar folded before Flop (didn't bet)
Seat 8: clasicos folded before Flop (didn't bet)
Seat 9: breelzer folded on the Flop


*********** # 18 **************
PokerStars Hand #169698663491:  Hold'em No Limit ($0.01/$0.02 USD) - 20=
17/04/29 12:14:40 CUST [2017/04/28 22:14:40 ET]
Table 'Antilia' 9-max Seat #9 is the button
Seat 1: nakasan6 ($0.98 in chips)=20
Seat 2: the_wickstar ($1.41 in chips)=20
Seat 3: diment76 ($1.61 in chips)=20
Seat 4: agapee92 ($2 in chips)=20
Seat 5: ErdgofrGG ($2.59 in chips)=20
Seat 6: themarfs ($2.27 in chips)=20
Seat 7: vini374 ($2.31 in chips)=20
Seat 8: murzik650 ($1.57 in chips)=20
Seat 9: rafaciarlini ($0.98 in chips)=20
nakasan6: posts small blind $0.01
the_wickstar: posts big blind $0.02
*** HOLE CARDS ***
Dealt to the_wickstar [Ks 7d]
diment76: folds=20
agapee92: folds=20
ErdgofrGG: raises $0.04 to $0.06
themarfs: folds=20
vini374: folds=20
murzik650: folds=20
rafaciarlini: folds=20
nakasan6: folds=20
the_wickstar: folds=20
Uncalled bet ($0.04) returned to ErdgofrGG
ErdgofrGG collected $0.05 from pot
ErdgofrGG: doesn't show hand=20
*** SUMMARY ***
Total pot $0.05 | Rake $0=20
Seat 1: nakasan6 (small blind) folded before Flop
Seat 2: the_wickstar (big blind) folded before Flop
Seat 3: diment76 folded before Flop (didn't bet)
Seat 4: agapee92 folded before Flop (didn't bet)
Seat 5: ErdgofrGG collected ($0.05)
Seat 6: themarfs folded before Flop (didn't bet)
Seat 7: vini374 folded before Flop (didn't bet)
Seat 8: murzik650 folded before Flop (didn't bet)
Seat 9: rafaciarlini (button) folded before Flop (didn't bet)


*********** # 19 **************
PokerStars Hand #169698660257:  Hold'em No Limit ($0.01/$0.02 USD) - 20=
17/04/29 12:14:32 CUST [2017/04/28 22:14:32 ET]
Table 'Wilkens' 9-max Seat #1 is the button
Seat 1: saromano ($1.97 in chips)=20
Seat 2: 1Asthma1 ($2 in chips)=20
Seat 3: agapee92 ($2 in chips)=20
Seat 4: hieukta ($2.31 in chips)=20
Seat 5: SMUTJAN72 ($1.82 in chips)=20
Seat 6: ybczq ($2 in chips)=20
Seat 7: the_wickstar ($2.30 in chips)=20
Seat 8: clasicos ($1.89 in chips)=20
Seat 9: breelzer ($2.14 in chips)=20
1Asthma1: posts small blind $0.01
agapee92: posts big blind $0.02
*** HOLE CARDS ***
Dealt to the_wickstar [4c Ts]
hieukta: folds=20
SMUTJAN72: folds=20
ybczq: folds=20
the_wickstar: folds=20
clasicos: folds=20
breelzer: folds=20
saromano: folds=20
1Asthma1: raises $0.04 to $0.06
agapee92: folds=20
Uncalled bet ($0.04) returned to 1Asthma1
1Asthma1 collected $0.04 from pot
*** SUMMARY ***
Total pot $0.04 | Rake $0=20
Seat 1: saromano (button) folded before Flop (didn't bet)
Seat 2: 1Asthma1 (small blind) collected ($0.04)
Seat 3: agapee92 (big blind) folded before Flop
Seat 4: hieukta folded before Flop (didn't bet)
Seat 5: SMUTJAN72 folded before Flop (didn't bet)
Seat 6: ybczq folded before Flop (didn't bet)
Seat 7: the_wickstar folded before Flop (didn't bet)
Seat 8: clasicos folded before Flop (didn't bet)
Seat 9: breelzer folded before Flop (didn't bet)


*********** # 20 **************
PokerStars Hand #169698641073:  Hold'em No Limit ($0.01/$0.02 USD) - 20=
17/04/29 12:13:42 CUST [2017/04/28 22:13:42 ET]
Table 'Wilkens' 9-max Seat #9 is the button
Seat 1: saromano ($1.98 in chips)=20
Seat 2: 1Asthma1 ($2 in chips)=20
Seat 3: agapee92 ($2 in chips)=20
Seat 4: hieukta ($2.31 in chips)=20
Seat 5: SMUTJAN72 ($2.19 in chips)=20
Seat 6: ybczq ($2 in chips)=20
Seat 7: the_wickstar ($2.30 in chips)=20
Seat 8: clasicos ($1.89 in chips)=20
Seat 9: breelzer ($1.77 in chips)=20
saromano: posts small blind $0.01
1Asthma1: posts big blind $0.02
*** HOLE CARDS ***
Dealt to the_wickstar [3c Ks]
agapee92: folds=20
hieukta: folds=20
SMUTJAN72: raises $0.03 to $0.05
ybczq: folds=20
the_wickstar: folds=20
clasicos: folds=20
breelzer: calls $0.05
saromano: folds=20
1Asthma1: folds=20
*** FLOP *** [9c 3d Jh]
SMUTJAN72: bets $0.06
breelzer: calls $0.06
*** TURN *** [9c 3d Jh] [9d]
SMUTJAN72: bets $0.06
breelzer: calls $0.06
*** RIVER *** [9c 3d Jh 9d] [Td]
SMUTJAN72: bets $0.10
breelzer: raises $0.10 to $0.20
SMUTJAN72: calls $0.10
*** SHOW DOWN ***
breelzer: shows [Th 9h] (a full house, Nines full of Tens)
SMUTJAN72: mucks hand=20
breelzer collected $0.74 from pot
*** SUMMARY ***
Total pot $0.77 | Rake $0.03=20
Board [9c 3d Jh 9d Td]
Seat 1: saromano (small blind) folded before Flop
Seat 2: 1Asthma1 (big blind) folded before Flop
Seat 3: agapee92 folded before Flop (didn't bet)
Seat 4: hieukta folded before Flop (didn't bet)
Seat 5: SMUTJAN72 mucked [Tc Jc]
Seat 6: ybczq folded before Flop (didn't bet)
Seat 7: the_wickstar folded before Flop (didn't bet)
Seat 8: clasicos folded before Flop (didn't bet)
Seat 9: breelzer (button) showed [Th 9h] and won ($0.74) with a full ho=
use, Nines full of Tens


*********** # 21 **************
PokerStars Hand #169698640654:  Hold'em No Limit ($0.01/$0.02 USD) - 20=
17/04/29 12:13:41 CUST [2017/04/28 22:13:41 ET]
Table 'Antilia' 9-max Seat #8 is the button
Seat 1: nakasan6 ($1 in chips)=20
Seat 2: the_wickstar ($1.41 in chips)=20
Seat 3: diment76 ($1.61 in chips)=20
Seat 4: agapee92 ($2 in chips)=20
Seat 5: ErdgofrGG ($2.59 in chips)=20
Seat 6: themarfs ($2.27 in chips)=20
Seat 7: vini374 ($2.31 in chips)=20
Seat 8: murzik650 ($1.57 in chips)=20
Seat 9: rafaciarlini ($0.96 in chips)=20
rafaciarlini: posts small blind $0.01
nakasan6: posts big blind $0.02
*** HOLE CARDS ***
Dealt to the_wickstar [Td 9c]
the_wickstar: folds=20
diment76: folds=20
agapee92: folds=20
ErdgofrGG: folds=20
themarfs: folds=20
vini374 has timed out
vini374: folds=20
murzik650: folds=20
rafaciarlini: raises $0.03 to $0.05
nakasan6: folds=20
Uncalled bet ($0.03) returned to rafaciarlini
rafaciarlini collected $0.04 from pot
*** SUMMARY ***
Total pot $0.04 | Rake $0=20
Seat 1: nakasan6 (big blind) folded before Flop
Seat 2: the_wickstar folded before Flop (didn't bet)
Seat 3: diment76 folded before Flop (didn't bet)
Seat 4: agapee92 folded before Flop (didn't bet)
Seat 5: ErdgofrGG folded before Flop (didn't bet)
Seat 6: themarfs folded before Flop (didn't bet)
Seat 7: vini374 folded before Flop (didn't bet)
Seat 8: murzik650 (button) folded before Flop (didn't bet)
Seat 9: rafaciarlini (small blind) collected ($0.04)


*********** # 22 **************
PokerStars Hand #169698626287:  Hold'em No Limit ($0.01/$0.02 USD) - 20=
17/04/29 12:13:05 CUST [2017/04/28 22:13:05 ET]
Table 'Antilia' 9-max Seat #7 is the button
Seat 1: nakasan6 ($1 in chips)=20
Seat 2: the_wickstar ($1.41 in chips)=20
Seat 3: diment76 ($1.61 in chips)=20
Seat 4: agapee92 ($2 in chips)=20
Seat 5: ErdgofrGG ($2.59 in chips)=20
Seat 6: themarfs ($2.24 in chips)=20
Seat 7: vini374 ($2.31 in chips)=20
Seat 8: murzik650 ($1.58 in chips)=20
Seat 9: rafaciarlini ($0.98 in chips)=20
murzik650: posts small blind $0.01
rafaciarlini: posts big blind $0.02
*** HOLE CARDS ***
Dealt to the_wickstar [6d 4c]
nakasan6: folds=20
the_wickstar: folds=20
diment76: folds=20
agapee92: folds=20
ErdgofrGG: folds=20
themarfs: raises $0.04 to $0.06
vini374: folds=20
murzik650: folds=20
rafaciarlini: folds=20
Uncalled bet ($0.04) returned to themarfs
themarfs collected $0.05 from pot
themarfs: doesn't show hand=20
*** SUMMARY ***
Total pot $0.05 | Rake $0=20
Seat 1: nakasan6 folded before Flop (didn't bet)
Seat 2: the_wickstar folded before Flop (didn't bet)
Seat 3: diment76 folded before Flop (didn't bet)
Seat 4: agapee92 folded before Flop (didn't bet)
Seat 5: ErdgofrGG folded before Flop (didn't bet)
Seat 6: themarfs collected ($0.05)
Seat 7: vini374 (button) folded before Flop (didn't bet)
Seat 8: murzik650 (small blind) folded before Flop
Seat 9: rafaciarlini (big blind) folded before Flop


*********** # 23 **************
PokerStars Hand #169698619626:  Hold'em No Limit ($0.01/$0.02 USD) - 20=
17/04/29 12:12:47 CUST [2017/04/28 22:12:47 ET]
Table 'Wilkens' 9-max Seat #8 is the button
Seat 1: saromano ($2 in chips)=20
Seat 2: 1Asthma1 ($2 in chips)=20
Seat 3: agapee92 ($2 in chips)=20
Seat 4: hieukta ($2.31 in chips)=20
Seat 5: SMUTJAN72 ($2.19 in chips)=20
Seat 6: ybczq ($2 in chips)=20
Seat 7: the_wickstar ($2.17 in chips)=20
Seat 8: clasicos ($1.95 in chips)=20
Seat 9: breelzer ($1.83 in chips)=20
breelzer: posts small blind $0.01
saromano: posts big blind $0.02
*** HOLE CARDS ***
Dealt to the_wickstar [Ah 5h]
1Asthma1: folds=20
agapee92: folds=20
hieukta: folds=20
SMUTJAN72: folds=20
ybczq: folds=20
the_wickstar: calls $0.02
clasicos: raises $0.04 to $0.06
breelzer: calls $0.05
saromano: folds=20
the_wickstar: calls $0.04
*** FLOP *** [8d 2c 5c]
breelzer: checks=20
the_wickstar: checks=20
clasicos: checks=20
*** TURN *** [8d 2c 5c] [As]
breelzer: checks=20
the_wickstar: bets $0.12
clasicos: folds=20
breelzer: folds=20
Uncalled bet ($0.12) returned to the_wickstar
the_wickstar collected $0.19 from pot
*** SUMMARY ***
Total pot $0.20 | Rake $0.01=20
Board [8d 2c 5c As]
Seat 1: saromano (big blind) folded before Flop
Seat 2: 1Asthma1 folded before Flop (didn't bet)
Seat 3: agapee92 folded before Flop (didn't bet)
Seat 4: hieukta folded before Flop (didn't bet)
Seat 5: SMUTJAN72 folded before Flop (didn't bet)
Seat 6: ybczq folded before Flop (didn't bet)
Seat 7: the_wickstar collected ($0.19)
Seat 8: clasicos (button) folded on the Turn
Seat 9: breelzer (small blind) folded on the Turn


*********** # 24 **************
PokerStars Hand #169698611077:  Hold'em No Limit ($0.01/$0.02 USD) - 20=
17/04/29 12:12:25 CUST [2017/04/28 22:12:25 ET]
Table 'Antilia' 9-max Seat #6 is the button
Seat 1: nakasan6 ($1 in chips)=20
Seat 2: the_wickstar ($1.41 in chips)=20
Seat 3: diment76 ($1.61 in chips)=20
Seat 4: agapee92 ($2 in chips)=20
Seat 5: ErdgofrGG ($2.59 in chips)=20
Seat 6: themarfs ($2.21 in chips)=20
Seat 7: vini374 ($2.32 in chips)=20
Seat 8: murzik650 ($1.60 in chips)=20
Seat 9: rafaciarlini ($0.98 in chips)=20
vini374: posts small blind $0.01
murzik650: posts big blind $0.02
*** HOLE CARDS ***
Dealt to the_wickstar [3c Ks]
rafaciarlini: folds=20
nakasan6: folds=20
the_wickstar: folds=20
diment76: folds=20
agapee92: folds=20
ErdgofrGG: folds=20
themarfs: raises $0.04 to $0.06
vini374: folds=20
murzik650: folds=20
Uncalled bet ($0.04) returned to themarfs
themarfs collected $0.05 from pot
themarfs: doesn't show hand=20
*** SUMMARY ***
Total pot $0.05 | Rake $0=20
Seat 1: nakasan6 folded before Flop (didn't bet)
Seat 2: the_wickstar folded before Flop (didn't bet)
Seat 3: diment76 folded before Flop (didn't bet)
Seat 4: agapee92 folded before Flop (didn't bet)
Seat 5: ErdgofrGG folded before Flop (didn't bet)
Seat 6: themarfs (button) collected ($0.05)
Seat 7: vini374 (small blind) folded before Flop
Seat 8: murzik650 (big blind) folded before Flop
Seat 9: rafaciarlini folded before Flop (didn't bet)


*********** # 25 **************
PokerStars Hand #169698594383:  Hold'em No Limit ($0.01/$0.02 USD) - 20=
17/04/29 12:11:42 CUST [2017/04/28 22:11:42 ET]
Table 'Wilkens' 9-max Seat #7 is the button
Seat 2: 1Asthma1 ($2 in chips)=20
Seat 3: agapee92 ($2 in chips)=20
Seat 4: hieukta ($2.31 in chips)=20
Seat 5: SMUTJAN72 ($2.19 in chips)=20
Seat 6: ybczq ($2 in chips)=20
Seat 7: the_wickstar ($2.17 in chips)=20
Seat 8: clasicos ($1.96 in chips)=20
Seat 9: breelzer ($1.58 in chips)=20
clasicos: posts small blind $0.01
breelzer: posts big blind $0.02
*** HOLE CARDS ***
Dealt to the_wickstar [4d 9h]
1Asthma1: folds=20
agapee92: folds=20
hieukta: folds=20
SMUTJAN72: folds=20
ybczq: raises $0.04 to $0.06
the_wickstar: folds=20
clasicos: folds=20
saromano joins the table at seat #1=20
breelzer: calls $0.04
*** FLOP *** [5h 8h Qc]
breelzer: checks=20
ybczq: bets $0.07
breelzer: calls $0.07
*** TURN *** [5h 8h Qc] [3d]
breelzer: checks=20
ybczq: bets $0.13
breelzer: calls $0.13
*** RIVER *** [5h 8h Qc 3d] [Th]
breelzer: checks=20
ybczq: checks=20
*** SHOW DOWN ***
breelzer: shows [Jh 3h] (a flush, Jack high)
ybczq: mucks hand=20
breelzer collected $0.51 from pot
*** SUMMARY ***
Total pot $0.53 | Rake $0.02=20
Board [5h 8h Qc 3d Th]
Seat 2: 1Asthma1 folded before Flop (didn't bet)
Seat 3: agapee92 folded before Flop (didn't bet)
Seat 4: hieukta folded before Flop (didn't bet)
Seat 5: SMUTJAN72 folded before Flop (didn't bet)
Seat 6: ybczq mucked [Ac 8d]
Seat 7: the_wickstar (button) folded before Flop (didn't bet)
Seat 8: clasicos (small blind) folded before Flop
Seat 9: breelzer (big blind) showed [Jh 3h] and won ($0.51) with a flus=
h, Jack high


*********** # 26 **************
PokerStars Hand #169698590332:  Hold'em No Limit ($0.01/$0.02 USD) - 20=
17/04/29 12:11:32 CUST [2017/04/28 22:11:32 ET]
Table 'Antilia' 9-max Seat #5 is the button
Seat 1: nakasan6 ($0.97 in chips)=20
Seat 2: the_wickstar ($1.41 in chips)=20
Seat 3: diment76 ($1.61 in chips)=20
Seat 4: agapee92 ($2 in chips)=20
Seat 5: ErdgofrGG ($2.59 in chips)=20
Seat 6: themarfs ($2.22 in chips)=20
Seat 7: vini374 ($2.34 in chips)=20
Seat 9: rafaciarlini ($0.98 in chips)=20
themarfs: posts small blind $0.01
vini374: posts big blind $0.02
murzik650: sits out=20
*** HOLE CARDS ***
Dealt to the_wickstar [7h 4h]
rafaciarlini: folds=20
nakasan6: raises $0.04 to $0.06
the_wickstar: folds=20
diment76: folds=20
agapee92: folds=20
ErdgofrGG: folds=20
themarfs: folds=20
vini374: folds=20
Uncalled bet ($0.04) returned to nakasan6
nakasan6 collected $0.05 from pot
*** SUMMARY ***
Total pot $0.05 | Rake $0=20
Seat 1: nakasan6 collected ($0.05)
Seat 2: the_wickstar folded before Flop (didn't bet)
Seat 3: diment76 folded before Flop (didn't bet)
Seat 4: agapee92 folded before Flop (didn't bet)
Seat 5: ErdgofrGG (button) folded before Flop (didn't bet)
Seat 6: themarfs (small blind) folded before Flop
Seat 7: vini374 (big blind) folded before Flop
Seat 9: rafaciarlini folded before Flop (didn't bet)


*********** # 27 **************
PokerStars Hand #169698578435:  Hold'em No Limit ($0.01/$0.02 USD) - 20=
17/04/29 12:11:01 CUST [2017/04/28 22:11:01 ET]
Table 'Antilia' 9-max Seat #4 is the button
Seat 1: nakasan6 ($0.97 in chips)=20
Seat 2: the_wickstar ($1.41 in chips)=20
Seat 3: diment76 ($1.63 in chips)=20
Seat 4: agapee92 ($2 in chips)=20
Seat 5: ErdgofrGG ($2.55 in chips)=20
Seat 6: themarfs ($2.24 in chips)=20
Seat 7: vini374 ($2.34 in chips)=20
Seat 9: rafaciarlini ($0.98 in chips)=20
ErdgofrGG: posts small blind $0.01
themarfs: posts big blind $0.02
murzik650: sits out=20
*** HOLE CARDS ***
Dealt to the_wickstar [4s 8c]
vini374: folds=20
rafaciarlini: folds=20
nakasan6: folds=20
the_wickstar: folds=20
diment76: calls $0.02
agapee92: folds=20
ErdgofrGG: raises $0.08 to $0.10
themarfs: folds=20
diment76: folds=20
Uncalled bet ($0.08) returned to ErdgofrGG
ErdgofrGG collected $0.06 from pot
ErdgofrGG: doesn't show hand=20
*** SUMMARY ***
Total pot $0.06 | Rake $0=20
Seat 1: nakasan6 folded before Flop (didn't bet)
Seat 2: the_wickstar folded before Flop (didn't bet)
Seat 3: diment76 folded before Flop
Seat 4: agapee92 (button) folded before Flop (didn't bet)
Seat 5: ErdgofrGG (small blind) collected ($0.06)
Seat 6: themarfs (big blind) folded before Flop
Seat 7: vini374 folded before Flop (didn't bet)
Seat 9: rafaciarlini folded before Flop (didn't bet)


*********** # 28 **************
PokerStars Hand #169698575671:  Hold'em No Limit ($0.01/$0.02 USD) - 20=
17/04/29 12:10:54 CUST [2017/04/28 22:10:54 ET]
Table 'Wilkens' 9-max Seat #6 is the button
Seat 2: 1Asthma1 ($2 in chips)=20
Seat 3: agapee92 ($2 in chips)=20
Seat 4: hieukta ($2.31 in chips)=20
Seat 5: SMUTJAN72 ($2.19 in chips)=20
Seat 6: ybczq ($2 in chips)=20
Seat 7: the_wickstar ($2.22 in chips)=20
Seat 8: clasicos ($1.89 in chips)=20
Seat 9: breelzer ($1.60 in chips)=20
the_wickstar: posts small blind $0.01
clasicos: posts big blind $0.02
breelzer: posts big blind $0.02
*** HOLE CARDS ***
Dealt to the_wickstar [5c Th]
breelzer: checks=20
1Asthma1: folds=20
agapee92: folds=20
hieukta: folds=20
SMUTJAN72: folds=20
ybczq: folds=20
the_wickstar: calls $0.01
clasicos: checks=20
*** FLOP *** [Td Qc 8c]
LAILAH M leaves the table
the_wickstar: bets $0.03
clasicos: raises $0.08 to $0.11
breelzer: folds=20
the_wickstar: folds=20
Uncalled bet ($0.08) returned to clasicos
clasicos collected $0.12 from pot
clasicos: doesn't show hand=20
*** SUMMARY ***
Total pot $0.12 | Rake $0=20
Board [Td Qc 8c]
Seat 2: 1Asthma1 folded before Flop (didn't bet)
Seat 3: agapee92 folded before Flop (didn't bet)
Seat 4: hieukta folded before Flop (didn't bet)
Seat 5: SMUTJAN72 folded before Flop (didn't bet)
Seat 6: ybczq (button) folded before Flop (didn't bet)
Seat 7: the_wickstar (small blind) folded on the Flop
Seat 8: clasicos (big blind) collected ($0.12)
Seat 9: breelzer folded on the Flop


*********** # 29 **************
PokerStars Hand #169698559082:  Hold'em No Limit ($0.01/$0.02 USD) - 20=
17/04/29 12:10:12 CUST [2017/04/28 22:10:12 ET]
Table 'Wilkens' 9-max Seat #5 is the button
Seat 2: 1Asthma1 ($2.03 in chips)=20
Seat 3: agapee92 ($2 in chips)=20
Seat 4: hieukta ($2.17 in chips)=20
Seat 5: SMUTJAN72 ($2.19 in chips)=20
Seat 6: ybczq ($2 in chips)=20
Seat 7: the_wickstar ($2.24 in chips)=20
Seat 8: clasicos ($1.89 in chips)=20
ybczq: posts small blind $0.01
the_wickstar: posts big blind $0.02
*** HOLE CARDS ***
Dealt to the_wickstar [Kh 3h]
clasicos: folds=20
1Asthma1: raises $0.04 to $0.06
agapee92: calls $0.06
hieukta: calls $0.06
SMUTJAN72: folds=20
ybczq: folds=20
the_wickstar: folds=20
*** FLOP *** [9h Ad 4c]
1Asthma1: checks=20
agapee92: checks=20
breelzer joins the table at seat #9=20
hieukta: bets $0.12
1Asthma1: folds=20
agapee92: folds=20
Uncalled bet ($0.12) returned to hieukta
hieukta collected $0.20 from pot
hieukta: doesn't show hand=20
*** SUMMARY ***
Total pot $0.21 | Rake $0.01=20
Board [9h Ad 4c]
Seat 2: 1Asthma1 folded on the Flop
Seat 3: agapee92 folded on the Flop
Seat 4: hieukta collected ($0.20)
Seat 5: SMUTJAN72 (button) folded before Flop (didn't bet)
Seat 6: ybczq (small blind) folded before Flop
Seat 7: the_wickstar (big blind) folded before Flop
Seat 8: clasicos folded before Flop (didn't bet)


*********** # 30 **************
PokerStars Hand #169698549141:  Hold'em No Limit ($0.01/$0.02 USD) - 20=
17/04/29 12:09:47 CUST [2017/04/28 22:09:47 ET]
Table 'Antilia' 9-max Seat #3 is the button
Seat 1: nakasan6 ($0.97 in chips)=20
Seat 2: the_wickstar ($1.33 in chips)=20
Seat 3: diment76 ($1.63 in chips)=20
Seat 4: agapee92 ($2 in chips)=20
Seat 5: ErdgofrGG ($2.57 in chips)=20
Seat 6: themarfs ($2.24 in chips)=20
Seat 7: vini374 ($2.40 in chips)=20
Seat 9: rafaciarlini ($0.98 in chips)=20
agapee92: posts small blind $0.01
ErdgofrGG: posts big blind $0.02
murzik650: sits out=20
*** HOLE CARDS ***
Dealt to the_wickstar [Ks Ts]
themarfs: folds=20
vini374: calls $0.02
rafaciarlini: folds=20
nakasan6: folds=20
the_wickstar: raises $0.04 to $0.06
diment76: folds=20
agapee92: folds=20
ErdgofrGG: folds=20
vini374: calls $0.04
*** FLOP *** [6s As Qc]
vini374: checks=20
the_wickstar: bets $0.10
vini374: folds=20
Uncalled bet ($0.10) returned to the_wickstar
the_wickstar collected $0.14 from pot
*** SUMMARY ***
Total pot $0.15 | Rake $0.01=20
Board [6s As Qc]
Seat 1: nakasan6 folded before Flop (didn't bet)
Seat 2: the_wickstar collected ($0.14)
Seat 3: diment76 (button) folded before Flop (didn't bet)
Seat 4: agapee92 (small blind) folded before Flop
Seat 5: ErdgofrGG (big blind) folded before Flop
Seat 6: themarfs folded before Flop (didn't bet)
Seat 7: vini374 folded on the Flop
Seat 9: rafaciarlini folded before Flop (didn't bet)


*********** # 31 **************
PokerStars Hand #169698536629:  Hold'em No Limit ($0.01/$0.02 USD) - 20=
17/04/29 12:09:15 CUST [2017/04/28 22:09:15 ET]
Table 'Antilia' 9-max Seat #2 is the button
Seat 1: nakasan6 ($0.97 in chips)=20
Seat 2: the_wickstar ($1.33 in chips)=20
Seat 3: diment76 ($1.64 in chips)=20
Seat 4: agapee92 ($2 in chips)=20
Seat 5: ErdgofrGG ($2.54 in chips)=20
Seat 6: themarfs ($2.24 in chips)=20
Seat 7: vini374 ($2.40 in chips)=20
Seat 9: rafaciarlini ($0.98 in chips)=20
diment76: posts small blind $0.01
agapee92: posts big blind $0.02
murzik650: sits out=20
*** HOLE CARDS ***
Dealt to the_wickstar [Kd 8d]
ErdgofrGG: raises $0.04 to $0.06
themarfs: folds=20
vini374: folds=20
rafaciarlini: folds=20
nakasan6: folds=20
the_wickstar: folds=20
diment76: folds=20
agapee92: folds=20
Uncalled bet ($0.04) returned to ErdgofrGG
ErdgofrGG collected $0.05 from pot
ErdgofrGG: doesn't show hand=20
*** SUMMARY ***
Total pot $0.05 | Rake $0=20
Seat 1: nakasan6 folded before Flop (didn't bet)
Seat 2: the_wickstar (button) folded before Flop (didn't bet)
Seat 3: diment76 (small blind) folded before Flop
Seat 4: agapee92 (big blind) folded before Flop
Seat 5: ErdgofrGG collected ($0.05)
Seat 6: themarfs folded before Flop (didn't bet)
Seat 7: vini374 folded before Flop (didn't bet)
Seat 9: rafaciarlini folded before Flop (didn't bet)


*********** # 32 **************
PokerStars Hand #169698529608:  Hold'em No Limit ($0.01/$0.02 USD) - 20=
17/04/29 12:08:57 CUST [2017/04/28 22:08:57 ET]
Table 'Wilkens' 9-max Seat #4 is the button
Seat 2: 1Asthma1 ($2.18 in chips)=20
Seat 3: agapee92 ($2 in chips)=20
Seat 4: hieukta ($2 in chips)=20
Seat 5: SMUTJAN72 ($2.20 in chips)=20
Seat 6: ybczq ($2.01 in chips)=20
Seat 7: the_wickstar ($2.24 in chips)=20
Seat 8: clasicos ($1.89 in chips)=20
SMUTJAN72: posts small blind $0.01
ybczq: posts big blind $0.02
*** HOLE CARDS ***
Dealt to the_wickstar [4h 2d]
the_wickstar: folds=20
clasicos: folds=20
1Asthma1: raises $0.04 to $0.06
agapee92: folds=20
hieukta: calls $0.06
daisuke0928 joins the table at seat #9=20
SMUTJAN72: folds=20
ybczq: folds=20
*** FLOP *** [5s Js Ah]
1Asthma1: bets $0.09
hieukta: calls $0.09
*** TURN *** [5s Js Ah] [3c]
1Asthma1: checks=20
daisuke0928 leaves the table
hieukta: bets $0.20
1Asthma1: folds=20
Uncalled bet ($0.20) returned to hieukta
hieukta collected $0.32 from pot
hieukta: doesn't show hand=20
*** SUMMARY ***
Total pot $0.33 | Rake $0.01=20
Board [5s Js Ah 3c]
Seat 2: 1Asthma1 folded on the Turn
Seat 3: agapee92 folded before Flop (didn't bet)
Seat 4: hieukta (button) collected ($0.32)
Seat 5: SMUTJAN72 (small blind) folded before Flop
Seat 6: ybczq (big blind) folded before Flop
Seat 7: the_wickstar folded before Flop (didn't bet)
Seat 8: clasicos folded before Flop (didn't bet)


*********** # 33 **************
PokerStars Hand #169698517430:  Hold'em No Limit ($0.01/$0.02 USD) - 20=
17/04/29 12:08:26 CUST [2017/04/28 22:08:26 ET]
Table 'Wilkens' 9-max Seat #3 is the button
Seat 2: 1Asthma1 ($2.18 in chips)=20
Seat 3: agapee92 ($2 in chips)=20
Seat 4: hieukta ($2 in chips)=20
Seat 5: SMUTJAN72 ($2.19 in chips)=20
Seat 6: ybczq ($2.01 in chips)=20
Seat 7: the_wickstar ($2.24 in chips)=20
Seat 8: clasicos ($1.89 in chips)=20
hieukta: posts small blind $0.01
SMUTJAN72: posts big blind $0.02
*** HOLE CARDS ***
Dealt to the_wickstar [7h Ah]
ybczq: folds=20
the_wickstar: folds=20
clasicos: folds=20
1Asthma1: folds=20
agapee92: folds=20
hieukta: folds=20
Uncalled bet ($0.01) returned to SMUTJAN72
SMUTJAN72 collected $0.02 from pot
SMUTJAN72: doesn't show hand=20
*** SUMMARY ***
Total pot $0.02 | Rake $0=20
Seat 2: 1Asthma1 folded before Flop (didn't bet)
Seat 3: agapee92 (button) folded before Flop (didn't bet)
Seat 4: hieukta (small blind) folded before Flop
Seat 5: SMUTJAN72 (big blind) collected ($0.02)
Seat 6: ybczq folded before Flop (didn't bet)
Seat 7: the_wickstar folded before Flop (didn't bet)
Seat 8: clasicos folded before Flop (didn't bet)


*********** # 34 **************
PokerStars Hand #169698516048:  Hold'em No Limit ($0.01/$0.02 USD) - 20=
17/04/29 12:08:22 CUST [2017/04/28 22:08:22 ET]
Table 'Antilia' 9-max Seat #1 is the button
Seat 1: nakasan6 ($0.97 in chips)=20
Seat 2: the_wickstar ($1.34 in chips)=20
Seat 3: diment76 ($1.66 in chips)=20
Seat 4: agapee92 ($2 in chips)=20
Seat 5: ErdgofrGG ($2.54 in chips)=20
Seat 6: themarfs ($2.04 in chips)=20
Seat 7: vini374 ($2.40 in chips)=20
Seat 9: rafaciarlini ($1 in chips)=20
the_wickstar: posts small blind $0.01
diment76: posts big blind $0.02
murzik650: sits out=20
rafaciarlini: posts big blind $0.02
*** HOLE CARDS ***
Dealt to the_wickstar [4d 3h]
agapee92: raises $0.04 to $0.06
ErdgofrGG: folds=20
themarfs: calls $0.06
vini374: folds=20
rafaciarlini: folds=20
nakasan6: folds=20
the_wickstar: folds=20
diment76: folds=20
*** FLOP *** [5c 6d Ks]
agapee92: bets $0.10
themarfs: calls $0.10
*** TURN *** [5c 6d Ks] [3d]
agapee92: checks=20
themarfs: bets $0.27
agapee92: folds=20
Uncalled bet ($0.27) returned to themarfs
themarfs collected $0.36 from pot
themarfs: doesn't show hand=20
*** SUMMARY ***
Total pot $0.37 | Rake $0.01=20
Board [5c 6d Ks 3d]
Seat 1: nakasan6 (button) folded before Flop (didn't bet)
Seat 2: the_wickstar (small blind) folded before Flop
Seat 3: diment76 (big blind) folded before Flop
Seat 4: agapee92 folded on the Turn
Seat 5: ErdgofrGG folded before Flop (didn't bet)
Seat 6: themarfs collected ($0.36)
Seat 7: vini374 folded before Flop (didn't bet)
Seat 9: rafaciarlini folded before Flop


*********** # 35 **************
PokerStars Hand #169698495305:  Hold'em No Limit ($0.01/$0.02 USD) - 20=
17/04/29 12:07:30 CUST [2017/04/28 22:07:30 ET]
Table 'Antilia' 9-max Seat #7 is the button
Seat 1: nakasan6 ($0.98 in chips)=20
Seat 2: the_wickstar ($1.36 in chips)=20
Seat 3: diment76 ($1.66 in chips)=20
Seat 4: agapee92 ($2 in chips)=20
Seat 5: ErdgofrGG ($2.54 in chips)=20
Seat 6: themarfs ($2.04 in chips)=20
Seat 7: vini374 ($2.37 in chips)=20
murzik650 will be allowed to play after the button
nakasan6: posts small blind $0.01
the_wickstar: posts big blind $0.02
*** HOLE CARDS ***
Dealt to the_wickstar [Ah 3c]
diment76: folds=20
agapee92: folds=20
rafaciarlini joins the table at seat #9=20
ErdgofrGG has timed out
ErdgofrGG: folds=20
themarfs: folds=20
vini374: raises $0.14 to $0.16
nakasan6: folds=20
the_wickstar: folds=20
Uncalled bet ($0.14) returned to vini374
vini374 collected $0.05 from pot
*** SUMMARY ***
Total pot $0.05 | Rake $0=20
Seat 1: nakasan6 (small blind) folded before Flop
Seat 2: the_wickstar (big blind) folded before Flop
Seat 3: diment76 folded before Flop (didn't bet)
Seat 4: agapee92 folded before Flop (didn't bet)
Seat 5: ErdgofrGG folded before Flop (didn't bet)
Seat 6: themarfs folded before Flop (didn't bet)
Seat 7: vini374 (button) collected ($0.05)


*********** # 36 **************
PokerStars Hand #169698493921:  Hold'em No Limit ($0.01/$0.02 USD) - 20=
17/04/29 12:07:26 CUST [2017/04/28 22:07:26 ET]
Table 'Wilkens' 9-max Seat #2 is the button
Seat 2: 1Asthma1 ($2.18 in chips)=20
Seat 3: agapee92 ($2 in chips)=20
Seat 4: hieukta ($2 in chips)=20
Seat 5: SMUTJAN72 ($2.19 in chips)=20
Seat 6: ybczq ($2.01 in chips)=20
Seat 7: the_wickstar ($2.15 in chips)=20
Seat 8: clasicos ($1.96 in chips)=20
Seat 9: jginebra55 ($0.55 in chips)=20
agapee92: posts small blind $0.01
hieukta: posts big blind $0.02
*** HOLE CARDS ***
Dealt to the_wickstar [Tc Jh]
SMUTJAN72: folds=20
ybczq: folds=20
the_wickstar: calls $0.02
clasicos: raises $0.05 to $0.07
jginebra55: folds=20
jginebra55 leaves the table
1Asthma1: folds=20
agapee92: folds=20
hieukta: folds=20
the_wickstar: calls $0.05
*** FLOP *** [4h 2s 5h]
the_wickstar: bets $0.10
clasicos: folds=20
Uncalled bet ($0.10) returned to the_wickstar
the_wickstar collected $0.16 from pot
*** SUMMARY ***
Total pot $0.17 | Rake $0.01=20
Board [4h 2s 5h]
Seat 2: 1Asthma1 (button) folded before Flop (didn't bet)
Seat 3: agapee92 (small blind) folded before Flop
Seat 4: hieukta (big blind) folded before Flop
Seat 5: SMUTJAN72 folded before Flop (didn't bet)
Seat 6: ybczq folded before Flop (didn't bet)
Seat 7: the_wickstar collected ($0.16)
Seat 8: clasicos folded on the Flop
Seat 9: jginebra55 folded before Flop (didn't bet)


*********** # 37 **************
PokerStars Hand #169698478915:  Hold'em No Limit ($0.01/$0.02 USD) - 20=
17/04/29 12:06:48 CUST [2017/04/28 22:06:48 ET]
Table 'Antilia' 9-max Seat #6 is the button
Seat 1: nakasan6 ($1 in chips)=20
Seat 2: the_wickstar ($1.36 in chips)=20
Seat 3: diment76 ($1.66 in chips)=20
Seat 4: agapee92 ($2 in chips)=20
Seat 5: ErdgofrGG ($2.54 in chips)=20
Seat 6: themarfs ($2.04 in chips)=20
Seat 7: vini374 ($2.35 in chips)=20
vini374: posts small blind $0.01
flyperety: is sitting out=20
nakasan6: posts big blind $0.02
flyperety leaves the table
*** HOLE CARDS ***
Dealt to the_wickstar [Qs 3h]
the_wickstar: folds=20
diment76: folds=20
agapee92: folds=20
ErdgofrGG: folds=20
themarfs: folds=20
murzik650 joins the table at seat #8=20
vini374: calls $0.01
nakasan6: checks=20
*** FLOP *** [2s 7d 4h]
vini374: checks=20
nakasan6: checks=20
*** TURN *** [2s 7d 4h] [Ac]
vini374: checks=20
nakasan6: checks=20
*** RIVER *** [2s 7d 4h Ac] [3s]
vini374: bets $0.04
nakasan6: folds=20
Uncalled bet ($0.04) returned to vini374
vini374 collected $0.04 from pot
*** SUMMARY ***
Total pot $0.04 | Rake $0=20
Board [2s 7d 4h Ac 3s]
Seat 1: nakasan6 (big blind) folded on the River
Seat 2: the_wickstar folded before Flop (didn't bet)
Seat 3: diment76 folded before Flop (didn't bet)
Seat 4: agapee92 folded before Flop (didn't bet)
Seat 5: ErdgofrGG folded before Flop (didn't bet)
Seat 6: themarfs (button) folded before Flop (didn't bet)
Seat 7: vini374 (small blind) collected ($0.04)


*********** # 38 **************
PokerStars Hand #169698465942:  Hold'em No Limit ($0.01/$0.02 USD) - 20=
17/04/29 12:06:15 CUST [2017/04/28 22:06:15 ET]
Table 'Antilia' 9-max Seat #5 is the button
Seat 2: the_wickstar ($1.36 in chips)=20
Seat 3: diment76 ($1.66 in chips)=20
Seat 4: agapee92 ($2 in chips)=20
Seat 5: ErdgofrGG ($2.54 in chips)=20
Seat 6: themarfs ($2.05 in chips)=20
Seat 7: vini374 ($2.34 in chips)=20
Seat 9: flyperety ($2.63 in chips)=20
themarfs: posts small blind $0.01
vini374: posts big blind $0.02
shirleypo503: sits out=20
nakasan6: sits out=20
*** HOLE CARDS ***
Dealt to the_wickstar [2h 6s]
shirleypo503 leaves the table
flyperety: folds=20
the_wickstar: folds=20
diment76: folds=20
agapee92: folds=20
ErdgofrGG: folds=20
themarfs: folds=20
Uncalled bet ($0.01) returned to vini374
vini374 collected $0.02 from pot
*** SUMMARY ***
Total pot $0.02 | Rake $0=20
Seat 2: the_wickstar folded before Flop (didn't bet)
Seat 3: diment76 folded before Flop (didn't bet)
Seat 4: agapee92 folded before Flop (didn't bet)
Seat 5: ErdgofrGG (button) folded before Flop (didn't bet)
Seat 6: themarfs (small blind) folded before Flop
Seat 7: vini374 (big blind) collected ($0.02)
Seat 9: flyperety folded before Flop (didn't bet)


*********** # 39 **************
PokerStars Hand #169698451961:  Hold'em No Limit ($0.01/$0.02 USD) - 20=
17/04/29 12:05:40 CUST [2017/04/28 22:05:40 ET]
Table 'Wilkens' 9-max Seat #9 is the button
Seat 2: 1Asthma1 ($2.19 in chips)=20
Seat 3: agapee92 ($2 in chips)=20
Seat 4: hieukta ($2 in chips)=20
Seat 5: SMUTJAN72 ($1.12 in chips)=20
Seat 6: ybczq ($2.01 in chips)=20
Seat 7: the_wickstar ($2.15 in chips)=20
Seat 8: clasicos ($1.96 in chips)=20
Seat 9: jginebra55 ($1.67 in chips)=20
1Asthma1: posts small blind $0.01
agapee92: posts big blind $0.02
*** HOLE CARDS ***
Dealt to the_wickstar [8d 6h]
hieukta: folds=20
SMUTJAN72: raises $0.04 to $0.06
ybczq: folds=20
the_wickstar: folds=20
clasicos: folds=20
jginebra55: calls $0.06
1Asthma1: folds=20
agapee92: folds=20
*** FLOP *** [2d Qd 6s]
SMUTJAN72: bets $0.06
jginebra55: raises $0.06 to $0.12
SMUTJAN72: calls $0.06
*** TURN *** [2d Qd 6s] [Th]
SMUTJAN72: checks=20
jginebra55: bets $0.08
SMUTJAN72: calls $0.08
*** RIVER *** [2d Qd 6s Th] [Jh]
SMUTJAN72: bets $0.24
jginebra55: raises $1.17 to $1.41 and is all-in
SMUTJAN72: calls $0.62 and is all-in
Uncalled bet ($0.55) returned to jginebra55
*** SHOW DOWN ***
jginebra55: shows [Ts Ac] (a pair of Tens)
SMUTJAN72: shows [Ah Ks] (a straight, Ten to Ace)
SMUTJAN72 collected $2.19 from pot
*** SUMMARY ***
Total pot $2.27 | Rake $0.08=20
Board [2d Qd 6s Th Jh]
Seat 2: 1Asthma1 (small blind) folded before Flop
Seat 3: agapee92 (big blind) folded before Flop
Seat 4: hieukta folded before Flop (didn't bet)
Seat 5: SMUTJAN72 showed [Ah Ks] and won ($2.19) with a straight, Ten t=
o Ace
Seat 6: ybczq folded before Flop (didn't bet)
Seat 7: the_wickstar folded before Flop (didn't bet)
Seat 8: clasicos folded before Flop (didn't bet)
Seat 9: jginebra55 (button) showed [Ts Ac] and lost with a pair of Tens


*********** # 40 **************
PokerStars Hand #169698433732:  Hold'em No Limit ($0.01/$0.02 USD) - 20=
17/04/29 12:04:54 CUST [2017/04/28 22:04:54 ET]
Table 'Antilia' 9-max Seat #4 is the button
Seat 2: the_wickstar ($1.48 in chips)=20
Seat 3: diment76 ($1.66 in chips)=20
Seat 4: agapee92 ($2.33 in chips)=20
Seat 5: ErdgofrGG ($2.55 in chips)=20
Seat 6: themarfs ($2.07 in chips)=20
Seat 7: vini374 ($1.73 in chips)=20
Seat 9: flyperety ($2.63 in chips)=20
ErdgofrGG: posts small blind $0.01
themarfs: posts big blind $0.02
nakasan6: sits out=20
*** HOLE CARDS ***
Dealt to the_wickstar [9c Ac]
vini374: calls $0.02
flyperety: folds=20
the_wickstar: calls $0.02
diment76: folds=20
agapee92: raises $0.04 to $0.06
ErdgofrGG: folds=20
themarfs: folds=20
vini374: calls $0.04
the_wickstar: calls $0.04
*** FLOP *** [3h 4c 6h]
vini374: bets $0.02
the_wickstar: calls $0.02
agapee92: raises $0.04 to $0.06
vini374: calls $0.04
the_wickstar: calls $0.04
*** TURN *** [3h 4c 6h] [7h]
vini374: checks=20
the_wickstar: checks=20
agapee92: checks=20
*** RIVER *** [3h 4c 6h 7h] [5c]
vini374: bets $0.38
the_wickstar: folds=20
agapee92: calls $0.38
*** SHOW DOWN ***
vini374: shows [Th Jh] (a flush, Jack high)
agapee92: mucks hand=20
vini374 collected $1.11 from pot
*** SUMMARY ***
Total pot $1.15 | Rake $0.04=20
Board [3h 4c 6h 7h 5c]
Seat 2: the_wickstar folded on the River
Seat 3: diment76 folded before Flop (didn't bet)
Seat 4: agapee92 (button) mucked [4d 4s]
Seat 5: ErdgofrGG (small blind) folded before Flop
Seat 6: themarfs (big blind) folded before Flop
Seat 7: vini374 showed [Th Jh] and won ($1.11) with a flush, Jack high
Seat 9: flyperety folded before Flop (didn't bet)


*********** # 41 **************
PokerStars Hand #169698429998:  Hold'em No Limit ($0.01/$0.02 USD) - 20=
17/04/29 12:04:45 CUST [2017/04/28 22:04:45 ET]
Table 'Wilkens' 9-max Seat #8 is the button
Seat 2: 1Asthma1 ($2.21 in chips)=20
Seat 3: agapee92 ($2 in chips)=20
Seat 4: hieukta ($2 in chips)=20
Seat 5: SMUTJAN72 ($1.12 in chips)=20
Seat 6: ybczq ($2.01 in chips)=20
Seat 7: the_wickstar ($2.12 in chips)=20
Seat 8: clasicos ($1.96 in chips)=20
Seat 9: jginebra55 ($1.68 in chips)=20
jginebra55: posts small blind $0.01
1Asthma1: posts big blind $0.02
*** HOLE CARDS ***
Dealt to the_wickstar [Qd 2c]
agapee92: folds=20
hieukta: folds=20
SMUTJAN72: folds=20
ybczq: folds=20
the_wickstar: calls $0.02
clasicos: folds=20
jginebra55: folds=20
1Asthma1: checks=20
*** FLOP *** [6h Ts Qs]
1Asthma1: checks=20
the_wickstar: bets $0.03
1Asthma1: folds=20
Uncalled bet ($0.03) returned to the_wickstar
the_wickstar collected $0.05 from pot
*** SUMMARY ***
Total pot $0.05 | Rake $0=20
Board [6h Ts Qs]
Seat 2: 1Asthma1 (big blind) folded on the Flop
Seat 3: agapee92 folded before Flop (didn't bet)
Seat 4: hieukta folded before Flop (didn't bet)
Seat 5: SMUTJAN72 folded before Flop (didn't bet)
Seat 6: ybczq folded before Flop (didn't bet)
Seat 7: the_wickstar collected ($0.05)
Seat 8: clasicos (button) folded before Flop (didn't bet)
Seat 9: jginebra55 (small blind) folded before Flop


*********** # 42 **************
PokerStars Hand #169698420286:  Hold'em No Limit ($0.01/$0.02 USD) - 20=
17/04/29 12:04:21 CUST [2017/04/28 22:04:21 ET]
Table 'Antilia' 9-max Seat #3 is the button
Seat 2: the_wickstar ($1.48 in chips)=20
Seat 3: diment76 ($1.66 in chips)=20
Seat 4: agapee92 ($2.34 in chips)=20
Seat 5: ErdgofrGG ($2.54 in chips)=20
Seat 6: themarfs ($2.07 in chips)=20
Seat 7: vini374 ($1.73 in chips)=20
Seat 9: flyperety ($2.63 in chips)=20
agapee92: posts small blind $0.01
ErdgofrGG: posts big blind $0.02
nakasan6: sits out=20
*** HOLE CARDS ***
Dealt to the_wickstar [5h 9d]
themarfs: folds=20
vini374: folds=20
flyperety: folds=20
the_wickstar: folds=20
diment76: folds=20
agapee92: folds=20
Uncalled bet ($0.01) returned to ErdgofrGG
ErdgofrGG collected $0.02 from pot
ErdgofrGG: doesn't show hand=20
*** SUMMARY ***
Total pot $0.02 | Rake $0=20
Seat 2: the_wickstar folded before Flop (didn't bet)
Seat 3: diment76 (button) folded before Flop (didn't bet)
Seat 4: agapee92 (small blind) folded before Flop
Seat 5: ErdgofrGG (big blind) collected ($0.02)
Seat 6: themarfs folded before Flop (didn't bet)
Seat 7: vini374 folded before Flop (didn't bet)
Seat 9: flyperety folded before Flop (didn't bet)


*********** # 43 **************
PokerStars Hand #169698406806:  Hold'em No Limit ($0.01/$0.02 USD) - 20=
17/04/29 12:03:47 CUST [2017/04/28 22:03:47 ET]
Table 'Antilia' 9-max Seat #2 is the button
Seat 2: the_wickstar ($1.45 in chips)=20
Seat 3: diment76 ($1.67 in chips)=20
Seat 4: agapee92 ($2.36 in chips)=20
Seat 5: ErdgofrGG ($2.54 in chips)=20
Seat 6: themarfs ($2.07 in chips)=20
Seat 7: vini374 ($1.73 in chips)=20
Seat 9: flyperety ($2.63 in chips)=20
diment76: posts small blind $0.01
agapee92: posts big blind $0.02
nakasan6: sits out=20
*** HOLE CARDS ***
Dealt to the_wickstar [Jc Jd]
ErdgofrGG: folds=20
themarfs: folds=20
vini374: folds=20
flyperety: folds=20
the_wickstar: raises $0.04 to $0.06
diment76: folds=20
agapee92: folds=20
Uncalled bet ($0.04) returned to the_wickstar
the_wickstar collected $0.05 from pot
*** SUMMARY ***
Total pot $0.05 | Rake $0=20
Seat 2: the_wickstar (button) collected ($0.05)
Seat 3: diment76 (small blind) folded before Flop
Seat 4: agapee92 (big blind) folded before Flop
Seat 5: ErdgofrGG folded before Flop (didn't bet)
Seat 6: themarfs folded before Flop (didn't bet)
Seat 7: vini374 folded before Flop (didn't bet)
Seat 9: flyperety folded before Flop (didn't bet)


*********** # 44 **************
PokerStars Hand #169698405824:  Hold'em No Limit ($0.01/$0.02 USD) - 20=
17/04/29 12:03:45 CUST [2017/04/28 22:03:45 ET]
Table 'Wilkens' 9-max Seat #7 is the button
Seat 1: LAILAH M ($1.89 in chips)=20
Seat 2: 1Asthma1 ($2.21 in chips)=20
Seat 3: agapee92 ($2 in chips)=20
Seat 4: hieukta ($2 in chips)=20
Seat 5: SMUTJAN72 ($1.12 in chips)=20
Seat 6: ybczq ($2.01 in chips)=20
Seat 7: the_wickstar ($2.12 in chips)=20
Seat 8: clasicos ($2.01 in chips)=20
Seat 9: jginebra55 ($1.63 in chips)=20
clasicos: posts small blind $0.01
jginebra55: posts big blind $0.02
*** HOLE CARDS ***
Dealt to the_wickstar [5d Jd]
LAILAH M: folds=20
1Asthma1: folds=20
agapee92: folds=20
hieukta: folds=20
SMUTJAN72: folds=20
ybczq: folds=20
the_wickstar: folds=20
clasicos: raises $0.03 to $0.05
jginebra55: calls $0.03
*** FLOP *** [3c 5h 6c]
clasicos: checks=20
jginebra55: bets $0.05
clasicos: folds=20
Uncalled bet ($0.05) returned to jginebra55
jginebra55 collected $0.10 from pot
jginebra55: doesn't show hand=20
*** SUMMARY ***
Total pot $0.10 | Rake $0=20
Board [3c 5h 6c]
Seat 1: LAILAH M folded before Flop (didn't bet)
Seat 2: 1Asthma1 folded before Flop (didn't bet)
Seat 3: agapee92 folded before Flop (didn't bet)
Seat 4: hieukta folded before Flop (didn't bet)
Seat 5: SMUTJAN72 folded before Flop (didn't bet)
Seat 6: ybczq folded before Flop (didn't bet)
Seat 7: the_wickstar (button) folded before Flop (didn't bet)
Seat 8: clasicos (small blind) folded on the Flop
Seat 9: jginebra55 (big blind) collected ($0.10)


*********** # 45 **************
PokerStars Hand #169698390172:  Hold'em No Limit ($0.01/$0.02 USD) - 20=
17/04/29 12:03:05 CUST [2017/04/28 22:03:05 ET]
Table 'Wilkens' 9-max Seat #6 is the button
Seat 1: LAILAH M ($1.89 in chips)=20
Seat 2: 1Asthma1 ($2.21 in chips)=20
Seat 3: agapee92 ($2 in chips)=20
Seat 4: hieukta ($2 in chips)=20
Seat 5: SMUTJAN72 ($1.12 in chips)=20
Seat 6: ybczq ($2.01 in chips)=20
Seat 7: the_wickstar ($2.13 in chips)=20
Seat 8: clasicos ($2 in chips)=20
Seat 9: jginebra55 ($1.63 in chips)=20
the_wickstar: posts small blind $0.01
clasicos: posts big blind $0.02
*** HOLE CARDS ***
Dealt to the_wickstar [8c 7s]
jginebra55: folds=20
LAILAH M: folds=20
1Asthma1: folds=20
agapee92: folds=20
hieukta: folds=20
SMUTJAN72: folds=20
ybczq: folds=20
the_wickstar: folds=20
Uncalled bet ($0.01) returned to clasicos
clasicos collected $0.02 from pot
clasicos: doesn't show hand=20
*** SUMMARY ***
Total pot $0.02 | Rake $0=20
Seat 1: LAILAH M folded before Flop (didn't bet)
Seat 2: 1Asthma1 folded before Flop (didn't bet)
Seat 3: agapee92 folded before Flop (didn't bet)
Seat 4: hieukta folded before Flop (didn't bet)
Seat 5: SMUTJAN72 folded before Flop (didn't bet)
Seat 6: ybczq (button) folded before Flop (didn't bet)
Seat 7: the_wickstar (small blind) folded before Flop
Seat 8: clasicos (big blind) collected ($0.02)
Seat 9: jginebra55 folded before Flop (didn't bet)


*********** # 46 **************
PokerStars Hand #169698370103:  Hold'em No Limit ($0.01/$0.02 USD) - 20=
17/04/29 12:02:29 CUST [2017/04/28 22:02:29 ET]
Table 'Antilia' 9-max Seat #9 is the button
Seat 2: the_wickstar ($1.39 in chips)=20
Seat 3: diment76 ($1.69 in chips)=20
Seat 4: agapee92 ($2.36 in chips)=20
Seat 5: ErdgofrGG ($2.54 in chips)=20
Seat 6: themarfs ($2.07 in chips)=20
Seat 7: vini374 ($1.75 in chips)=20
Seat 9: flyperety ($2.65 in chips)=20
nakasan6 will be allowed to play after the button
the_wickstar: posts small blind $0.01
diment76: posts big blind $0.02
*** HOLE CARDS ***
Dealt to the_wickstar [9s Kc]
agapee92: folds=20
ErdgofrGG: folds=20
themarfs: folds=20
vini374: calls $0.02
flyperety: calls $0.02
the_wickstar: calls $0.01
diment76: checks=20
*** FLOP *** [6h Ac 4d]
the_wickstar: checks=20
diment76: checks=20
vini374: checks=20
flyperety: checks=20
*** TURN *** [6h Ac 4d] [Qd]
the_wickstar: checks=20
diment76: checks=20
vini374: checks=20
flyperety: checks=20
*** RIVER *** [6h Ac 4d Qd] [2s]
the_wickstar: bets $0.08
diment76: folds=20
vini374: folds=20
flyperety: folds=20
Uncalled bet ($0.08) returned to the_wickstar
the_wickstar collected $0.08 from pot
*** SUMMARY ***
Total pot $0.08 | Rake $0=20
Board [6h Ac 4d Qd 2s]
Seat 2: the_wickstar (small blind) collected ($0.08)
Seat 3: diment76 (big blind) folded on the River
Seat 4: agapee92 folded before Flop (didn't bet)
Seat 5: ErdgofrGG folded before Flop (didn't bet)
Seat 6: themarfs folded before Flop (didn't bet)
Seat 7: vini374 folded on the River
Seat 9: flyperety (button) folded on the River


*********** # 47 **************
PokerStars Hand #169698369828:  Hold'em No Limit ($0.01/$0.02 USD) - 20=
17/04/29 12:02:28 CUST [2017/04/28 22:02:28 ET]
Table 'Wilkens' 9-max Seat #5 is the button
Seat 1: LAILAH M ($1.89 in chips)=20
Seat 2: 1Asthma1 ($2.21 in chips)=20
Seat 3: agapee92 ($2 in chips)=20
Seat 4: hieukta ($2 in chips)=20
Seat 5: SMUTJAN72 ($1.12 in chips)=20
Seat 6: ybczq ($2.02 in chips)=20
Seat 7: the_wickstar ($2.15 in chips)=20
Seat 8: AldSantalo ($2.03 in chips)=20
Seat 9: jginebra55 ($1.55 in chips)=20
ybczq: posts small blind $0.01
the_wickstar: posts big blind $0.02
*** HOLE CARDS ***
Dealt to the_wickstar [4s 8c]
AldSantalo: folds=20
AldSantalo leaves the table
clasicos joins the table at seat #8=20
jginebra55: raises $0.04 to $0.06
LAILAH M: folds=20
1Asthma1: folds=20
agapee92: calls $0.06
hieukta: folds=20
SMUTJAN72: folds=20
ybczq: folds=20
the_wickstar: folds=20
*** FLOP *** [Qd Kc 6s]
jginebra55: bets $0.06
agapee92: folds=20
Uncalled bet ($0.06) returned to jginebra55
jginebra55 collected $0.14 from pot
jginebra55: doesn't show hand=20
*** SUMMARY ***
Total pot $0.15 | Rake $0.01=20
Board [Qd Kc 6s]
Seat 1: LAILAH M folded before Flop (didn't bet)
Seat 2: 1Asthma1 folded before Flop (didn't bet)
Seat 3: agapee92 folded on the Flop
Seat 4: hieukta folded before Flop (didn't bet)
Seat 5: SMUTJAN72 (button) folded before Flop (didn't bet)
Seat 6: ybczq (small blind) folded before Flop
Seat 7: the_wickstar (big blind) folded before Flop
Seat 8: AldSantalo folded before Flop (didn't bet)
Seat 9: jginebra55 collected ($0.14)


*********** # 48 **************
PokerStars Hand #169698360074:  Hold'em No Limit ($0.01/$0.02 USD) - 20=
17/04/29 12:02:03 CUST [2017/04/28 22:02:03 ET]
Table 'Antilia' 9-max Seat #7 is the button
Seat 2: the_wickstar ($1.41 in chips)=20
Seat 3: diment76 ($1.69 in chips)=20
Seat 4: agapee92 ($2.36 in chips)=20
Seat 5: ErdgofrGG ($2.54 in chips)=20
Seat 6: themarfs ($2.04 in chips)=20
Seat 7: vini374 ($1.75 in chips)=20
Seat 9: flyperety ($2.66 in chips)=20
flyperety: posts small blind $0.01
Veraz147: is sitting out=20
Veraz147 leaves the table
the_wickstar: posts big blind $0.02
*** HOLE CARDS ***
Dealt to the_wickstar [9s 8h]
diment76: folds=20
agapee92: folds=20
nakasan6 joins the table at seat #1=20
ErdgofrGG: folds=20
themarfs: raises $0.04 to $0.06
vini374: folds=20
flyperety: folds=20
the_wickstar: folds=20
Uncalled bet ($0.04) returned to themarfs
themarfs collected $0.05 from pot
themarfs: doesn't show hand=20
*** SUMMARY ***
Total pot $0.05 | Rake $0=20
Seat 2: the_wickstar (big blind) folded before Flop
Seat 3: diment76 folded before Flop (didn't bet)
Seat 4: agapee92 folded before Flop (didn't bet)
Seat 5: ErdgofrGG folded before Flop (didn't bet)
Seat 6: themarfs collected ($0.05)
Seat 7: vini374 (button) folded before Flop (didn't bet)
Seat 9: flyperety (small blind) folded before Flop


*********** # 49 **************
PokerStars Hand #169698344071:  Hold'em No Limit ($0.01/$0.02 USD) - 20=
17/04/29 12:01:24 CUST [2017/04/28 22:01:24 ET]
Table 'Wilkens' 9-max Seat #3 is the button
Seat 1: LAILAH M ($1.89 in chips)=20
Seat 2: 1Asthma1 ($2.21 in chips)=20
Seat 3: agapee92 ($2 in chips)=20
Seat 4: hieukta ($2.01 in chips)=20
Seat 5: SMUTJAN72 ($1.13 in chips)=20
Seat 7: the_wickstar ($2.15 in chips)=20
Seat 8: AldSantalo ($2.03 in chips)=20
Seat 9: jginebra55 ($1.55 in chips)=20
hieukta: posts small blind $0.01
SMUTJAN72: posts big blind $0.02
ybczq: sits out=20
*** HOLE CARDS ***
Dealt to the_wickstar [4h Qc]
the_wickstar has timed out
the_wickstar: folds=20
AldSantalo: folds=20
jginebra55: folds=20
LAILAH M: folds=20
1Asthma1: folds=20
agapee92: folds=20
hieukta: folds=20
Uncalled bet ($0.01) returned to SMUTJAN72
SMUTJAN72 collected $0.02 from pot
SMUTJAN72: doesn't show hand=20
*** SUMMARY ***
Total pot $0.02 | Rake $0=20
Seat 1: LAILAH M folded before Flop (didn't bet)
Seat 2: 1Asthma1 folded before Flop (didn't bet)
Seat 3: agapee92 (button) folded before Flop (didn't bet)
Seat 4: hieukta (small blind) folded before Flop
Seat 5: SMUTJAN72 (big blind) collected ($0.02)
Seat 7: the_wickstar folded before Flop (didn't bet)
Seat 8: AldSantalo folded before Flop (didn't bet)
Seat 9: jginebra55 folded before Flop (didn't bet)


*********** # 50 **************
PokerStars Hand #169698336816:  Hold'em No Limit ($0.01/$0.02 USD) - 20=
17/04/29 12:01:06 CUST [2017/04/28 22:01:06 ET]
Table 'Wilkens' 9-max Seat #2 is the button
Seat 1: LAILAH M ($1.89 in chips)=20
Seat 2: 1Asthma1 ($2.21 in chips)=20
Seat 3: agapee92 ($2.01 in chips)=20
Seat 4: hieukta ($2 in chips)=20
Seat 5: SMUTJAN72 ($1.13 in chips)=20
Seat 7: the_wickstar ($2.15 in chips)=20
Seat 8: AldSantalo ($2.03 in chips)=20
Seat 9: jginebra55 ($1.55 in chips)=20
agapee92: posts small blind $0.01
hieukta: posts big blind $0.02
ybczq: sits out=20
*** HOLE CARDS ***
Dealt to the_wickstar [8c Ks]
SMUTJAN72: folds=20
the_wickstar: folds=20
AldSantalo: folds=20
jginebra55: folds=20
LAILAH M: folds=20
1Asthma1: folds=20
agapee92: folds=20
Uncalled bet ($0.01) returned to hieukta
hieukta collected $0.02 from pot
hieukta: doesn't show hand=20
*** SUMMARY ***
Total pot $0.02 | Rake $0=20
Seat 1: LAILAH M folded before Flop (didn't bet)
Seat 2: 1Asthma1 (button) folded before Flop (didn't bet)
Seat 3: agapee92 (small blind) folded before Flop
Seat 4: hieukta (big blind) collected ($0.02)
Seat 5: SMUTJAN72 folded before Flop (didn't bet)
Seat 7: the_wickstar folded before Flop (didn't bet)
Seat 8: AldSantalo folded before Flop (didn't bet)
Seat 9: jginebra55 folded before Flop (didn't bet)


*********** # 51 **************
PokerStars Hand #169698323836:  Hold'em No Limit ($0.01/$0.02 USD) - 20=
17/04/29 12:00:32 CUST [2017/04/28 22:00:32 ET]
Table 'Wilkens' 9-max Seat #1 is the button
Seat 1: LAILAH M ($1.89 in chips)=20
Seat 2: 1Asthma1 ($2.19 in chips)=20
Seat 3: agapee92 ($2.03 in chips)=20
Seat 5: SMUTJAN72 ($1.13 in chips)=20
Seat 7: the_wickstar ($2.15 in chips)=20
Seat 8: AldSantalo ($2.03 in chips)=20
Seat 9: jginebra55 ($1.55 in chips)=20
1Asthma1: posts small blind $0.01
agapee92: posts big blind $0.02
ybczq: sits out=20
*** HOLE CARDS ***
Dealt to the_wickstar [6d Ts]
SMUTJAN72: folds=20
the_wickstar: folds=20
AldSantalo: folds=20
jginebra55: folds=20
LAILAH M: folds=20
hieukta joins the table at seat #4=20
1Asthma1: raises $0.04 to $0.06
agapee92: folds=20
Uncalled bet ($0.04) returned to 1Asthma1
1Asthma1 collected $0.04 from pot
*** SUMMARY ***
Total pot $0.04 | Rake $0=20
Seat 1: LAILAH M (button) folded before Flop (didn't bet)
Seat 2: 1Asthma1 (small blind) collected ($0.04)
Seat 3: agapee92 (big blind) folded before Flop
Seat 5: SMUTJAN72 folded before Flop (didn't bet)
Seat 7: the_wickstar folded before Flop (didn't bet)
Seat 8: AldSantalo folded before Flop (didn't bet)
Seat 9: jginebra55 folded before Flop (didn't bet)


*********** # 52 **************
PokerStars Hand #169698310170:  Hold'em No Limit ($0.01/$0.02 USD) - 20=
17/04/29 11:59:55 CUST [2017/04/28 21:59:55 ET]
Table 'Wilkens' 9-max Seat #9 is the button
Seat 1: LAILAH M ($1.90 in chips)=20
Seat 2: 1Asthma1 ($2.21 in chips)=20
Seat 3: agapee92 ($2 in chips)=20
Seat 5: SMUTJAN72 ($1.13 in chips)=20
Seat 7: the_wickstar ($2.15 in chips)=20
Seat 8: AldSantalo ($2.03 in chips)=20
Seat 9: jginebra55 ($1.55 in chips)=20
LAILAH M: posts small blind $0.01
1Asthma1: posts big blind $0.02
ybczq: sits out=20
*** HOLE CARDS ***
Dealt to the_wickstar [4s 9d]
agapee92: raises $0.04 to $0.06
SMUTJAN72: folds=20
the_wickstar: folds=20
AldSantalo: folds=20
jginebra55: folds=20
LAILAH M: folds=20
1Asthma1: folds=20
Uncalled bet ($0.04) returned to agapee92
agapee92 collected $0.05 from pot
agapee92: doesn't show hand=20
*** SUMMARY ***
Total pot $0.05 | Rake $0=20
Seat 1: LAILAH M (small blind) folded before Flop
Seat 2: 1Asthma1 (big blind) folded before Flop
Seat 3: agapee92 collected ($0.05)
Seat 5: SMUTJAN72 folded before Flop (didn't bet)
Seat 7: the_wickstar folded before Flop (didn't bet)
Seat 8: AldSantalo folded before Flop (didn't bet)
Seat 9: jginebra55 (button) folded before Flop (didn't bet)


*********** # 53 **************
PokerStars Hand #169698297323:  Hold'em No Limit ($0.01/$0.02 USD) - 20=
17/04/29 11:59:19 CUST [2017/04/28 21:59:19 ET]
Table 'Wilkens' 9-max Seat #8 is the button
Seat 1: LAILAH M ($1.92 in chips)=20
Seat 2: 1Asthma1 ($2.21 in chips)=20
Seat 3: agapee92 ($2 in chips)=20
Seat 5: SMUTJAN72 ($1.13 in chips)=20
Seat 7: the_wickstar ($2.15 in chips)=20
Seat 8: AldSantalo ($2.03 in chips)=20
Seat 9: jginebra55 ($1.53 in chips)=20
jginebra55: posts small blind $0.01
LAILAH M: posts big blind $0.02
*** HOLE CARDS ***
Dealt to the_wickstar [7s 3s]
1Asthma1: folds=20
agapee92: folds=20
SMUTJAN72: folds=20
the_wickstar: folds=20
AldSantalo: folds=20
ybczq joins the table at seat #6=20
jginebra55: raises $0.04 to $0.06
LAILAH M: folds=20
Uncalled bet ($0.04) returned to jginebra55
jginebra55 collected $0.04 from pot
jginebra55: doesn't show hand=20
*** SUMMARY ***
Total pot $0.04 | Rake $0=20
Seat 1: LAILAH M (big blind) folded before Flop
Seat 2: 1Asthma1 folded before Flop (didn't bet)
Seat 3: agapee92 folded before Flop (didn't bet)
Seat 5: SMUTJAN72 folded before Flop (didn't bet)
Seat 7: the_wickstar folded before Flop (didn't bet)
Seat 8: AldSantalo (button) folded before Flop (didn't bet)
Seat 9: jginebra55 (small blind) collected ($0.04)


*********** # 54 **************
PokerStars Hand #169698296297:  Hold'em No Limit ($0.01/$0.02 USD) - 20=
17/04/29 11:59:16 CUST [2017/04/28 21:59:16 ET]
Table 'Antilia' 9-max Seat #6 is the button
Seat 1: Veraz147 ($2.05 in chips)=20
Seat 2: the_wickstar ($1.66 in chips)=20
Seat 3: diment76 ($1.69 in chips)=20
Seat 4: agapee92 ($2.36 in chips)=20
Seat 5: ErdgofrGG ($2.54 in chips)=20
Seat 6: themarfs ($2.04 in chips)=20
Seat 7: vini374 ($1.50 in chips)=20
Seat 8: shirleypo503 ($0.53 in chips)=20
Seat 9: flyperety ($2.66 in chips)=20
vini374: posts small blind $0.01
shirleypo503: posts big blind $0.02
*** HOLE CARDS ***
Dealt to the_wickstar [Ac Jh]
flyperety: folds=20
Veraz147: folds=20
themarfs is disconnected=20
the_wickstar: calls $0.02
diment76: folds=20
agapee92: folds=20
ErdgofrGG: folds=20
shirleypo503 is disconnected=20
themarfs has timed out while disconnected
themarfs: folds=20
vini374: calls $0.01
shirleypo503 has timed out while disconnected
shirleypo503: checks=20
*** FLOP *** [8s Qc 2s]
vini374: bets $0.02
shirleypo503 has timed out while disconnected
shirleypo503: folds=20
the_wickstar: raises $0.04 to $0.06
vini374: calls $0.04
*** TURN *** [8s Qc 2s] [Td]
vini374: checks=20
the_wickstar: bets $0.17
vini374: calls $0.17
*** RIVER *** [8s Qc 2s Td] [2c]
vini374: checks=20
the_wickstar: checks=20
*** SHOW DOWN ***
vini374: shows [Ts 7s] (two pair, Tens and Deuces)
the_wickstar: mucks hand=20
vini374 collected $0.50 from pot
*** SUMMARY ***
Total pot $0.52 | Rake $0.02=20
Board [8s Qc 2s Td 2c]
Seat 1: Veraz147 folded before Flop (didn't bet)
Seat 2: the_wickstar mucked [Ac Jh]
Seat 3: diment76 folded before Flop (didn't bet)
Seat 4: agapee92 folded before Flop (didn't bet)
Seat 5: ErdgofrGG folded before Flop (didn't bet)
Seat 6: themarfs (button) folded before Flop (didn't bet)
Seat 7: vini374 (small blind) showed [Ts 7s] and won ($0.50) with two p=
air, Tens and Deuces
Seat 8: shirleypo503 (big blind) folded on the Flop
Seat 9: flyperety folded before Flop (didn't bet)


*********** # 55 **************
PokerStars Hand #169698274943:  Hold'em No Limit ($0.01/$0.02 USD) - 20=
17/04/29 11:58:17 CUST [2017/04/28 21:58:17 ET]
Table 'Antilia' 9-max Seat #5 is the button
Seat 1: Veraz147 ($2.05 in chips)=20
Seat 2: the_wickstar ($1.66 in chips)=20
Seat 3: diment76 ($1.69 in chips)=20
Seat 4: agapee92 ($2.36 in chips)=20
Seat 5: ErdgofrGG ($2.36 in chips)=20
Seat 6: themarfs ($2.05 in chips)=20
Seat 7: vini374 ($1.52 in chips)=20
Seat 8: shirleypo503 ($0.69 in chips)=20
Seat 9: flyperety ($2.66 in chips)=20
themarfs: posts small blind $0.01
vini374: posts big blind $0.02
*** HOLE CARDS ***
Dealt to the_wickstar [2c 3s]
shirleypo503: calls $0.02
flyperety: folds=20
Veraz147: folds=20
the_wickstar: folds=20
diment76: folds=20
agapee92: folds=20
ErdgofrGG: raises $0.07 to $0.09
themarfs: folds=20
vini374: folds=20
shirleypo503: raises $0.07 to $0.16
ErdgofrGG: calls $0.07
*** FLOP *** [9d 4c 6c]
shirleypo503: checks=20
ErdgofrGG: bets $0.02
shirleypo503: folds=20
Uncalled bet ($0.02) returned to ErdgofrGG
ErdgofrGG collected $0.34 from pot
ErdgofrGG: doesn't show hand=20
*** SUMMARY ***
Total pot $0.35 | Rake $0.01=20
Board [9d 4c 6c]
Seat 1: Veraz147 folded before Flop (didn't bet)
Seat 2: the_wickstar folded before Flop (didn't bet)
Seat 3: diment76 folded before Flop (didn't bet)
Seat 4: agapee92 folded before Flop (didn't bet)
Seat 5: ErdgofrGG (button) collected ($0.34)
Seat 6: themarfs (small blind) folded before Flop
Seat 7: vini374 (big blind) folded before Flop
Seat 8: shirleypo503 folded on the Flop
Seat 9: flyperety folded before Flop (didn't bet)


*********** # 56 **************
PokerStars Hand #169698270264:  Hold'em No Limit ($0.01/$0.02 USD) - 20=
17/04/29 11:58:04 CUST [2017/04/28 21:58:04 ET]
Table 'Wilkens' 9-max Seat #7 is the button
Seat 1: LAILAH M ($1.94 in chips)=20
Seat 2: 1Asthma1 ($2.21 in chips)=20
Seat 3: agapee92 ($2 in chips)=20
Seat 5: SMUTJAN72 ($1.62 in chips)=20
Seat 7: the_wickstar ($1.65 in chips)=20
Seat 8: AldSantalo ($2.04 in chips)=20
Seat 9: jginebra55 ($1.55 in chips)=20
AldSantalo: posts small blind $0.01
jginebra55: posts big blind $0.02
*** HOLE CARDS ***
Dealt to the_wickstar [Qd Ac]
LAILAH M: calls $0.02
1Asthma1: folds=20
agapee92: folds=20
SMUTJAN72: raises $0.03 to $0.05
the_wickstar: raises $0.03 to $0.08
AldSantalo: folds=20
jginebra55: folds=20
LAILAH M: folds=20
SMUTJAN72: calls $0.03
*** FLOP *** [6s Js 9h]
SMUTJAN72: checks=20
the_wickstar: bets $0.16
SMUTJAN72: calls $0.16
*** TURN *** [6s Js 9h] [3d]
SMUTJAN72: checks=20
the_wickstar: checks=20
*** RIVER *** [6s Js 9h 3d] [Qh]
SMUTJAN72: checks=20
the_wickstar: bets $0.25
SMUTJAN72: calls $0.25
*** SHOW DOWN ***
the_wickstar: shows [Qd Ac] (a pair of Queens)
SMUTJAN72: mucks hand=20
the_wickstar collected $0.99 from pot
*** SUMMARY ***
Total pot $1.03 | Rake $0.04=20
Board [6s Js 9h 3d Qh]
Seat 1: LAILAH M folded before Flop
Seat 2: 1Asthma1 folded before Flop (didn't bet)
Seat 3: agapee92 folded before Flop (didn't bet)
Seat 5: SMUTJAN72 mucked [Jh Tc]
Seat 7: the_wickstar (button) showed [Qd Ac] and won ($0.99) with a pai=
r of Queens
Seat 8: AldSantalo (small blind) folded before Flop
Seat 9: jginebra55 (big blind) folded before Flop


*********** # 57 **************
PokerStars Hand #169698262571:  Hold'em No Limit ($0.01/$0.02 USD) - 20=
17/04/29 11:57:42 CUST [2017/04/28 21:57:42 ET]
Table 'Antilia' 9-max Seat #4 is the button
Seat 1: Veraz147 ($2.05 in chips)=20
Seat 2: the_wickstar ($1.66 in chips)=20
Seat 3: diment76 ($1.69 in chips)=20
Seat 4: agapee92 ($2.33 in chips)=20
Seat 5: ErdgofrGG ($2.37 in chips)=20
Seat 6: themarfs ($2.07 in chips)=20
Seat 7: vini374 ($1.52 in chips)=20
Seat 8: shirleypo503 ($0.69 in chips)=20
Seat 9: flyperety ($2.66 in chips)=20
ErdgofrGG: posts small blind $0.01
themarfs: posts big blind $0.02
*** HOLE CARDS ***
Dealt to the_wickstar [Kc 7h]
vini374: folds=20
shirleypo503: folds=20
flyperety: folds=20
Veraz147: folds=20
the_wickstar: folds=20
diment76: folds=20
agapee92: raises $0.04 to $0.06
ErdgofrGG: folds=20
themarfs: folds=20
Uncalled bet ($0.04) returned to agapee92
agapee92 collected $0.05 from pot
agapee92: doesn't show hand=20
*** SUMMARY ***
Total pot $0.05 | Rake $0=20
Seat 1: Veraz147 folded before Flop (didn't bet)
Seat 2: the_wickstar folded before Flop (didn't bet)
Seat 3: diment76 folded before Flop (didn't bet)
Seat 4: agapee92 (button) collected ($0.05)
Seat 5: ErdgofrGG (small blind) folded before Flop
Seat 6: themarfs (big blind) folded before Flop
Seat 7: vini374 folded before Flop (didn't bet)
Seat 8: shirleypo503 folded before Flop (didn't bet)
Seat 9: flyperety folded before Flop (didn't bet)


*********** # 58 **************
PokerStars Hand #169698260825:  Hold'em No Limit ($0.01/$0.02 USD) - 20=
17/04/29 11:57:38 CUST [2017/04/28 21:57:38 ET]
Table 'Wilkens' 9-max Seat #5 is the button
Seat 1: LAILAH M ($1.94 in chips)=20
Seat 2: 1Asthma1 ($2.21 in chips)=20
Seat 3: agapee92 ($2 in chips)=20
Seat 5: SMUTJAN72 ($1.62 in chips)=20
Seat 7: the_wickstar ($1.66 in chips)=20
Seat 8: AldSantalo ($2.03 in chips)=20
Seat 9: jginebra55 ($1.55 in chips)=20
the_wickstar: posts small blind $0.01
AldSantalo: posts big blind $0.02
*** HOLE CARDS ***
Dealt to the_wickstar [3s 2h]
jginebra55: folds=20
LAILAH M: folds=20
1Asthma1: folds=20
agapee92: folds=20
SMUTJAN72: folds=20
the_wickstar: folds=20
Uncalled bet ($0.01) returned to AldSantalo
AldSantalo collected $0.02 from pot
AldSantalo: doesn't show hand=20
*** SUMMARY ***
Total pot $0.02 | Rake $0=20
Seat 1: LAILAH M folded before Flop (didn't bet)
Seat 2: 1Asthma1 folded before Flop (didn't bet)
Seat 3: agapee92 folded before Flop (didn't bet)
Seat 5: SMUTJAN72 (button) folded before Flop (didn't bet)
Seat 7: the_wickstar (small blind) folded before Flop
Seat 8: AldSantalo (big blind) collected ($0.02)
Seat 9: jginebra55 folded before Flop (didn't bet)


*********** # 59 **************
PokerStars Hand #169698244404:  Hold'em No Limit ($0.01/$0.02 USD) - 20=
17/04/29 11:56:55 CUST [2017/04/28 21:56:55 ET]
Table 'Antilia' 9-max Seat #3 is the button
Seat 1: Veraz147 ($2.05 in chips)=20
Seat 2: the_wickstar ($1.66 in chips)=20
Seat 3: diment76 ($1.69 in chips)=20
Seat 4: agapee92 ($2.34 in chips)=20
Seat 5: ErdgofrGG ($2.39 in chips)=20
Seat 6: themarfs ($2.07 in chips)=20
Seat 7: vini374 ($1.52 in chips)=20
Seat 8: shirleypo503 ($0.66 in chips)=20
Seat 9: flyperety ($2.66 in chips)=20
agapee92: posts small blind $0.01
ErdgofrGG: posts big blind $0.02
shirleypo503: posts small & big blinds $0.03
*** HOLE CARDS ***
Dealt to the_wickstar [3c Kc]
themarfs: folds=20
vini374: folds=20
shirleypo503: raises $0.02 to $0.04
flyperety: folds=20
Veraz147: folds=20
the_wickstar: folds=20
diment76: folds=20
agapee92: folds=20
ErdgofrGG: folds=20
Uncalled bet ($0.02) returned to shirleypo503
shirleypo503 collected $0.06 from pot
*** SUMMARY ***
Total pot $0.06 | Rake $0=20
Seat 1: Veraz147 folded before Flop (didn't bet)
Seat 2: the_wickstar folded before Flop (didn't bet)
Seat 3: diment76 (button) folded before Flop (didn't bet)
Seat 4: agapee92 (small blind) folded before Flop
Seat 5: ErdgofrGG (big blind) folded before Flop
Seat 6: themarfs folded before Flop (didn't bet)
Seat 7: vini374 folded before Flop (didn't bet)
Seat 8: shirleypo503 collected ($0.06)
Seat 9: flyperety folded before Flop (didn't bet)


*********** # 60 **************
PokerStars Hand #169698244160:  Hold'em No Limit ($0.01/$0.02 USD) - 20=
17/04/29 11:56:54 CUST [2017/04/28 21:56:54 ET]
Table 'Wilkens' 9-max Seat #3 is the button
Seat 1: LAILAH M ($1.94 in chips)=20
Seat 2: 1Asthma1 ($2.21 in chips)=20
Seat 3: agapee92 ($2 in chips)=20
Seat 5: SMUTJAN72 ($1.63 in chips)=20
Seat 7: the_wickstar ($1.68 in chips)=20
Seat 8: AldSantalo ($2.03 in chips)=20
Seat 9: jginebra55 ($1.52 in chips)=20
SMUTJAN72: posts small blind $0.01
flyperety: is sitting out=20
flyperety leaves the table
the_wickstar: posts big blind $0.02
*** HOLE CARDS ***
Dealt to the_wickstar [7d 8s]
AldSantalo: folds=20
jginebra55: raises $0.04 to $0.06
LAILAH M: folds=20
1Asthma1: folds=20
agapee92: folds=20
SMUTJAN72: folds=20
the_wickstar: folds=20
Uncalled bet ($0.04) returned to jginebra55
jginebra55 collected $0.05 from pot
jginebra55: doesn't show hand=20
*** SUMMARY ***
Total pot $0.05 | Rake $0=20
Seat 1: LAILAH M folded before Flop (didn't bet)
Seat 2: 1Asthma1 folded before Flop (didn't bet)
Seat 3: agapee92 (button) folded before Flop (didn't bet)
Seat 5: SMUTJAN72 (small blind) folded before Flop
Seat 7: the_wickstar (big blind) folded before Flop
Seat 8: AldSantalo folded before Flop (didn't bet)
Seat 9: jginebra55 collected ($0.05)


*********** # 61 **************
PokerStars Hand #169698231427:  Hold'em No Limit ($0.01/$0.02 USD) - 20=
17/04/29 11:56:19 CUST [2017/04/28 21:56:19 ET]
Table 'Antilia' 9-max Seat #2 is the button
Seat 1: Veraz147 ($2.05 in chips)=20
Seat 2: the_wickstar ($1.66 in chips)=20
Seat 3: diment76 ($1.70 in chips)=20
Seat 4: agapee92 ($2.36 in chips)=20
Seat 5: ErdgofrGG ($2.39 in chips)=20
Seat 6: themarfs ($2.04 in chips)=20
Seat 7: vini374 ($1.52 in chips)=20
Seat 9: flyperety ($2.66 in chips)=20
diment76: posts small blind $0.01
agapee92: posts big blind $0.02
*** HOLE CARDS ***
Dealt to the_wickstar [Th 7h]
ErdgofrGG: folds=20
themarfs: raises $0.04 to $0.06
vini374: folds=20
flyperety: folds=20
Veraz147: folds=20
the_wickstar: folds=20
diment76: folds=20
agapee92: folds=20
Uncalled bet ($0.04) returned to themarfs
themarfs collected $0.05 from pot
themarfs: doesn't show hand=20
*** SUMMARY ***
Total pot $0.05 | Rake $0=20
Seat 1: Veraz147 folded before Flop (didn't bet)
Seat 2: the_wickstar (button) folded before Flop (didn't bet)
Seat 3: diment76 (small blind) folded before Flop
Seat 4: agapee92 (big blind) folded before Flop
Seat 5: ErdgofrGG folded before Flop (didn't bet)
Seat 6: themarfs collected ($0.05)
Seat 7: vini374 folded before Flop (didn't bet)
Seat 9: flyperety folded before Flop (didn't bet)


*********** # 62 **************
PokerStars Hand #169698224873:  Hold'em No Limit ($0.01/$0.02 USD) - 20=
17/04/29 11:56:00 CUST [2017/04/28 21:56:00 ET]
Table 'Antilia' 9-max Seat #1 is the button
Seat 1: Veraz147 ($2.05 in chips)=20
Seat 2: the_wickstar ($1.67 in chips)=20
Seat 3: diment76 ($1.69 in chips)=20
Seat 4: agapee92 ($2.36 in chips)=20
Seat 5: ErdgofrGG ($2.39 in chips)=20
Seat 6: themarfs ($2.04 in chips)=20
Seat 7: vini374 ($1.52 in chips)=20
Seat 9: flyperety ($2.66 in chips)=20
the_wickstar: posts small blind $0.01
diment76: posts big blind $0.02
*** HOLE CARDS ***
Dealt to the_wickstar [5s 6h]
agapee92: folds=20
ErdgofrGG: folds=20
themarfs: folds=20
vini374: folds=20
flyperety: folds=20
Veraz147: folds=20
the_wickstar: folds=20
Uncalled bet ($0.01) returned to diment76
diment76 collected $0.02 from pot
*** SUMMARY ***
Total pot $0.02 | Rake $0=20
Seat 1: Veraz147 (button) folded before Flop (didn't bet)
Seat 2: the_wickstar (small blind) folded before Flop
Seat 3: diment76 (big blind) collected ($0.02)
Seat 4: agapee92 folded before Flop (didn't bet)
Seat 5: ErdgofrGG folded before Flop (didn't bet)
Seat 6: themarfs folded before Flop (didn't bet)
Seat 7: vini374 folded before Flop (didn't bet)
Seat 9: flyperety folded before Flop (didn't bet)


*********** # 63 **************
PokerStars Hand #169698222633:  Hold'em No Limit ($0.01/$0.02 USD) - 20=
17/04/29 11:55:54 CUST [2017/04/28 21:55:54 ET]
Table 'Wilkens' 9-max Seat #2 is the button
Seat 1: LAILAH M ($1.94 in chips)=20
Seat 2: 1Asthma1 ($2.05 in chips)=20
Seat 3: agapee92 ($2 in chips)=20
Seat 5: SMUTJAN72 ($1.79 in chips)=20
Seat 6: flyperety ($2.16 in chips)=20
Seat 7: the_wickstar ($1.68 in chips)=20
Seat 8: AldSantalo ($2.03 in chips)=20
Seat 9: jginebra55 ($1.52 in chips)=20
agapee92: posts small blind $0.01
ynwmbiwf was removed from the table for failing to post
SMUTJAN72: posts big blind $0.02
*** HOLE CARDS ***
Dealt to the_wickstar [9c Tc]
flyperety: folds=20
the_wickstar: folds=20
AldSantalo: folds=20
jginebra55: folds=20
LAILAH M: folds=20
1Asthma1: raises $0.03 to $0.05
agapee92: folds=20
SMUTJAN72: raises $0.11 to $0.16
1Asthma1: calls $0.11
*** FLOP *** [Ac 3c 6h]
SMUTJAN72: checks=20
1Asthma1: checks=20
*** TURN *** [Ac 3c 6h] [Qs]
SMUTJAN72: checks=20
1Asthma1: bets $0.25
SMUTJAN72: folds=20
Uncalled bet ($0.25) returned to 1Asthma1
1Asthma1 collected $0.32 from pot
*** SUMMARY ***
Total pot $0.33 | Rake $0.01=20
Board [Ac 3c 6h Qs]
Seat 1: LAILAH M folded before Flop (didn't bet)
Seat 2: 1Asthma1 (button) collected ($0.32)
Seat 3: agapee92 (small blind) folded before Flop
Seat 5: SMUTJAN72 (big blind) folded on the Turn
Seat 6: flyperety folded before Flop (didn't bet)
Seat 7: the_wickstar folded before Flop (didn't bet)
Seat 8: AldSantalo folded before Flop (didn't bet)
Seat 9: jginebra55 folded before Flop (didn't bet)


*********** # 64 **************
PokerStars Hand #169698204406:  Hold'em No Limit ($0.01/$0.02 USD) - 20=
17/04/29 11:55:03 CUST [2017/04/28 21:55:03 ET]
Table 'Wilkens' 9-max Seat #1 is the button
Seat 1: LAILAH M ($1.94 in chips)=20
Seat 2: 1Asthma1 ($2.06 in chips)=20
Seat 3: agapee92 ($2 in chips)=20
Seat 5: SMUTJAN72 ($1.79 in chips)=20
Seat 6: flyperety ($2.16 in chips)=20
Seat 7: the_wickstar ($1.61 in chips)=20
Seat 8: AldSantalo ($2.03 in chips)=20
Seat 9: jginebra55 ($1.52 in chips)=20
1Asthma1: posts small blind $0.01
agapee92: posts big blind $0.02
*** HOLE CARDS ***
Dealt to the_wickstar [As Kd]
SMUTJAN72: folds=20
flyperety: folds=20
the_wickstar: raises $0.04 to $0.06
AldSantalo: folds=20
jginebra55: folds=20
LAILAH M: folds=20
1Asthma1: folds=20
agapee92: calls $0.04
*** FLOP *** [4d Ks 7s]
agapee92: checks=20
the_wickstar: bets $0.10
agapee92: folds=20
Uncalled bet ($0.10) returned to the_wickstar
the_wickstar collected $0.13 from pot
*** SUMMARY ***
Total pot $0.13 | Rake $0=20
Board [4d Ks 7s]
Seat 1: LAILAH M (button) folded before Flop (didn't bet)
Seat 2: 1Asthma1 (small blind) folded before Flop
Seat 3: agapee92 (big blind) folded on the Flop
Seat 5: SMUTJAN72 folded before Flop (didn't bet)
Seat 6: flyperety folded before Flop (didn't bet)
Seat 7: the_wickstar collected ($0.13)
Seat 8: AldSantalo folded before Flop (didn't bet)
Seat 9: jginebra55 folded before Flop (didn't bet)


*********** # 65 **************
PokerStars Hand #169698203533:  Hold'em No Limit ($0.01/$0.02 USD) - 20=
17/04/29 11:55:00 CUST [2017/04/28 21:55:00 ET]
Table 'Antilia' 9-max Seat #9 is the button
Seat 1: Veraz147 ($2.06 in chips)=20
Seat 2: the_wickstar ($1.69 in chips)=20
Seat 3: diment76 ($1.69 in chips)=20
Seat 4: agapee92 ($2.36 in chips)=20
Seat 5: ErdgofrGG ($2.39 in chips)=20
Seat 6: themarfs ($2.01 in chips)=20
Seat 7: vini374 ($1.52 in chips)=20
Seat 9: flyperety ($2.66 in chips)=20
Veraz147: posts small blind $0.01
the_wickstar: posts big blind $0.02
*** HOLE CARDS ***
Dealt to the_wickstar [3d Qh]
diment76: folds=20
agapee92: folds=20
ErdgofrGG: folds=20
themarfs: raises $0.04 to $0.06
vini374: folds=20
flyperety: folds=20
Veraz147: folds=20
the_wickstar: folds=20
Uncalled bet ($0.04) returned to themarfs
themarfs collected $0.05 from pot
themarfs: doesn't show hand=20
*** SUMMARY ***
Total pot $0.05 | Rake $0=20
Seat 1: Veraz147 (small blind) folded before Flop
Seat 2: the_wickstar (big blind) folded before Flop
Seat 3: diment76 folded before Flop (didn't bet)
Seat 4: agapee92 folded before Flop (didn't bet)
Seat 5: ErdgofrGG folded before Flop (didn't bet)
Seat 6: themarfs collected ($0.05)
Seat 7: vini374 folded before Flop (didn't bet)
Seat 9: flyperety (button) folded before Flop (didn't bet)


*********** # 66 **************
PokerStars Hand #169698187678:  Hold'em No Limit ($0.01/$0.02 USD) - 20=
17/04/29 11:54:21 CUST [2017/04/28 21:54:21 ET]
Table 'Antilia' 9-max Seat #7 is the button
Seat 1: Veraz147 ($2.08 in chips)=20
Seat 2: the_wickstar ($1.69 in chips)=20
Seat 3: diment76 ($1.66 in chips)=20
Seat 4: agapee92 ($2.36 in chips)=20
Seat 5: ErdgofrGG ($2.39 in chips)=20
Seat 6: themarfs ($2.01 in chips)=20
Seat 7: vini374 ($1.52 in chips)=20
Seat 9: flyperety ($2.67 in chips)=20
flyperety: posts small blind $0.01
Veraz147: posts big blind $0.02
*** HOLE CARDS ***
Dealt to the_wickstar [8s 9h]
the_wickstar: folds=20
diment76: raises $0.04 to $0.06
agapee92: folds=20
ErdgofrGG: folds=20
themarfs: folds=20
vini374: folds=20
flyperety: folds=20
Veraz147: folds=20
Uncalled bet ($0.04) returned to diment76
diment76 collected $0.05 from pot
*** SUMMARY ***
Total pot $0.05 | Rake $0=20
Seat 1: Veraz147 (big blind) folded before Flop
Seat 2: the_wickstar folded before Flop (didn't bet)
Seat 3: diment76 collected ($0.05)
Seat 4: agapee92 folded before Flop (didn't bet)
Seat 5: ErdgofrGG folded before Flop (didn't bet)
Seat 6: themarfs folded before Flop (didn't bet)
Seat 7: vini374 (button) folded before Flop (didn't bet)
Seat 9: flyperety (small blind) folded before Flop


*********** # 67 **************
PokerStars Hand #169698182269:  Hold'em No Limit ($0.01/$0.02 USD) - 20=
17/04/29 11:54:08 CUST [2017/04/28 21:54:08 ET]
Table 'Wilkens' 9-max Seat #9 is the button
Seat 1: LAILAH M ($1.98 in chips)=20
Seat 2: 1Asthma1 ($2 in chips)=20
Seat 3: goofnewf616 ($4.11 in chips)=20
Seat 5: SMUTJAN72 ($1.79 in chips)=20
Seat 6: flyperety ($2.16 in chips)=20
Seat 7: the_wickstar ($1.63 in chips)=20
Seat 8: AldSantalo ($2.03 in chips)=20
Seat 9: jginebra55 ($1.52 in chips)=20
LAILAH M: posts small blind $0.01
1Asthma1: posts big blind $0.02
*** HOLE CARDS ***
Dealt to the_wickstar [Tc Ks]
goofnewf616: folds=20
SMUTJAN72: folds=20
flyperety: folds=20
goofnewf616 leaves the table
agapee92 joins the table at seat #3=20
the_wickstar: calls $0.02
AldSantalo: folds=20
jginebra55: folds=20
LAILAH M: calls $0.01
1Asthma1: checks=20
*** FLOP *** [Ad 9c 5d]
LAILAH M: bets $0.02
1Asthma1: raises $0.06 to $0.08
the_wickstar: folds=20
LAILAH M: folds=20
Uncalled bet ($0.06) returned to 1Asthma1
1Asthma1 collected $0.10 from pot
*** SUMMARY ***
Total pot $0.10 | Rake $0=20
Board [Ad 9c 5d]
Seat 1: LAILAH M (small blind) folded on the Flop
Seat 2: 1Asthma1 (big blind) collected ($0.10)
Seat 3: goofnewf616 folded before Flop (didn't bet)
Seat 5: SMUTJAN72 folded before Flop (didn't bet)
Seat 6: flyperety folded before Flop (didn't bet)
Seat 7: the_wickstar folded on the Flop
Seat 8: AldSantalo folded before Flop (didn't bet)
Seat 9: jginebra55 (button) folded before Flop (didn't bet)


*********** # 68 **************
PokerStars Hand #169698166178:  Hold'em No Limit ($0.01/$0.02 USD) - 20=
17/04/29 11:53:29 CUST [2017/04/28 21:53:29 ET]
Table 'Antilia' 9-max Seat #6 is the button
Seat 1: Veraz147 ($2.14 in chips)=20
Seat 2: the_wickstar ($1.69 in chips)=20
Seat 3: diment76 ($1.66 in chips)=20
Seat 4: agapee92 ($2.36 in chips)=20
Seat 5: ErdgofrGG ($2.39 in chips)=20
Seat 6: themarfs ($2.07 in chips)=20
Seat 7: vini374 ($1.38 in chips)=20
Seat 9: flyperety ($2.69 in chips)=20
vini374: posts small blind $0.01
flyperety: posts big blind $0.02
*** HOLE CARDS ***
Dealt to the_wickstar [Ad 4h]
Veraz147: raises $0.04 to $0.06
the_wickstar: folds=20
diment76: folds=20
agapee92: folds=20
ErdgofrGG: folds=20
themarfs: calls $0.06
vini374: raises $0.20 to $0.26
flyperety: folds=20
Veraz147: folds=20
themarfs: folds=20
Uncalled bet ($0.20) returned to vini374
vini374 collected $0.20 from pot
*** SUMMARY ***
Total pot $0.20 | Rake $0=20
Seat 1: Veraz147 folded before Flop
Seat 2: the_wickstar folded before Flop (didn't bet)
Seat 3: diment76 folded before Flop (didn't bet)
Seat 4: agapee92 folded before Flop (didn't bet)
Seat 5: ErdgofrGG folded before Flop (didn't bet)
Seat 6: themarfs (button) folded before Flop
Seat 7: vini374 (small blind) collected ($0.20)
Seat 9: flyperety (big blind) folded before Flop


*********** # 69 **************
PokerStars Hand #169698148683:  Hold'em No Limit ($0.01/$0.02 USD) - 20=
17/04/29 11:52:46 CUST [2017/04/28 21:52:46 ET]
Table 'Wilkens' 9-max Seat #8 is the button
Seat 1: LAILAH M ($2 in chips)=20
Seat 3: goofnewf616 ($4.17 in chips)=20
Seat 5: SMUTJAN72 ($1.79 in chips)=20
Seat 6: flyperety ($2.16 in chips)=20
Seat 7: the_wickstar ($1.63 in chips)=20
Seat 8: AldSantalo ($1.94 in chips)=20
Seat 9: jginebra55 ($1.54 in chips)=20
jginebra55: posts small blind $0.01
LAILAH M: posts big blind $0.02
1Asthma1: sits out=20
*** HOLE CARDS ***
Dealt to the_wickstar [2d Jc]
goofnewf616: calls $0.02
SMUTJAN72: folds=20
flyperety: folds=20
the_wickstar: folds=20
AldSantalo: calls $0.02
jginebra55: calls $0.01
LAILAH M: checks=20
*** FLOP *** [2h 4c 3c]
jginebra55: checks=20
LAILAH M: checks=20
goofnewf616: checks=20
AldSantalo: checks=20
*** TURN *** [2h 4c 3c] [Ks]
jginebra55: checks=20
LAILAH M: checks=20
goofnewf616: bets $0.02
AldSantalo: calls $0.02
jginebra55: folds=20
LAILAH M: folds=20
*** RIVER *** [2h 4c 3c Ks] [3h]
goofnewf616: bets $0.02
AldSantalo: calls $0.02
*** SHOW DOWN ***
goofnewf616: shows [5d 4h] (two pair, Fours and Threes)
AldSantalo: shows [Td Kc] (two pair, Kings and Threes)
AldSantalo collected $0.15 from pot
*** SUMMARY ***
Total pot $0.16 | Rake $0.01=20
Board [2h 4c 3c Ks 3h]
Seat 1: LAILAH M (big blind) folded on the Turn
Seat 3: goofnewf616 showed [5d 4h] and lost with two pair, Fours and Th=
rees
Seat 5: SMUTJAN72 folded before Flop (didn't bet)
Seat 6: flyperety folded before Flop (didn't bet)
Seat 7: the_wickstar folded before Flop (didn't bet)
Seat 8: AldSantalo (button) showed [Td Kc] and won ($0.15) with two pai=
r, Kings and Threes
Seat 9: jginebra55 (small blind) folded on the Turn


*********** # 70 **************
PokerStars Hand #169698148281:  Hold'em No Limit ($0.01/$0.02 USD) - 20=
17/04/29 11:52:45 CUST [2017/04/28 21:52:45 ET]
Table 'Antilia' 9-max Seat #5 is the button
Seat 1: Veraz147 ($2.14 in chips)=20
Seat 2: the_wickstar ($1.69 in chips)=20
Seat 3: diment76 ($1.66 in chips)=20
Seat 4: agapee92 ($2.33 in chips)=20
Seat 5: ErdgofrGG ($2.39 in chips)=20
Seat 6: themarfs ($2.08 in chips)=20
Seat 7: vini374 ($1.40 in chips)=20
Seat 9: flyperety ($2.69 in chips)=20
themarfs: posts small blind $0.01
vini374: posts big blind $0.02
*** HOLE CARDS ***
Dealt to the_wickstar [5c Tc]
flyperety: folds=20
Veraz147: folds=20
the_wickstar: folds=20
diment76: folds=20
agapee92: raises $0.04 to $0.06
ErdgofrGG: folds=20
themarfs: folds=20
vini374: folds=20
Uncalled bet ($0.04) returned to agapee92
agapee92 collected $0.05 from pot
agapee92: doesn't show hand=20
*** SUMMARY ***
Total pot $0.05 | Rake $0=20
Seat 1: Veraz147 folded before Flop (didn't bet)
Seat 2: the_wickstar folded before Flop (didn't bet)
Seat 3: diment76 folded before Flop (didn't bet)
Seat 4: agapee92 collected ($0.05)
Seat 5: ErdgofrGG (button) folded before Flop (didn't bet)
Seat 6: themarfs (small blind) folded before Flop
Seat 7: vini374 (big blind) folded before Flop
Seat 9: flyperety folded before Flop (didn't bet)


*********** # 71 **************
PokerStars Hand #169698137585:  Hold'em No Limit ($0.01/$0.02 USD) - 20=
17/04/29 11:52:18 CUST [2017/04/28 21:52:18 ET]
Table 'Antilia' 9-max Seat #4 is the button
Seat 1: Veraz147 ($2.14 in chips)=20
Seat 2: the_wickstar ($1.69 in chips)=20
Seat 3: diment76 ($1.66 in chips)=20
Seat 4: agapee92 ($2.33 in chips)=20
Seat 5: ErdgofrGG ($2.40 in chips)=20
Seat 6: themarfs ($2.10 in chips)=20
Seat 7: vini374 ($1.37 in chips)=20
Seat 9: flyperety ($2.69 in chips)=20
ErdgofrGG: posts small blind $0.01
themarfs: posts big blind $0.02
*** HOLE CARDS ***
Dealt to the_wickstar [Tc 3s]
vini374: raises $0.20 to $0.22
flyperety: folds=20
Veraz147: folds=20
the_wickstar: folds=20
diment76: folds=20
agapee92: folds=20
ErdgofrGG: folds=20
themarfs: folds=20
Uncalled bet ($0.20) returned to vini374
vini374 collected $0.05 from pot
*** SUMMARY ***
Total pot $0.05 | Rake $0=20
Seat 1: Veraz147 folded before Flop (didn't bet)
Seat 2: the_wickstar folded before Flop (didn't bet)
Seat 3: diment76 folded before Flop (didn't bet)
Seat 4: agapee92 (button) folded before Flop (didn't bet)
Seat 5: ErdgofrGG (small blind) folded before Flop
Seat 6: themarfs (big blind) folded before Flop
Seat 7: vini374 collected ($0.05)
Seat 9: flyperety folded before Flop (didn't bet)


*********** # 72 **************
PokerStars Hand #169698118408:  Hold'em No Limit ($0.01/$0.02 USD) - 20=
17/04/29 11:51:32 CUST [2017/04/28 21:51:32 ET]
Table 'Antilia' 9-max Seat #3 is the button
Seat 1: Veraz147 ($2.14 in chips)=20
Seat 2: the_wickstar ($1.69 in chips)=20
Seat 3: diment76 ($1.63 in chips)=20
Seat 4: agapee92 ($2.34 in chips)=20
Seat 5: ErdgofrGG ($2.42 in chips)=20
Seat 6: themarfs ($2.10 in chips)=20
Seat 7: vini374 ($1.37 in chips)=20
Seat 9: flyperety ($2.69 in chips)=20
agapee92: posts small blind $0.01
ErdgofrGG: posts big blind $0.02
*** HOLE CARDS ***
Dealt to the_wickstar [9h 2c]
themarfs: folds=20
vini374: folds=20
flyperety has timed out
flyperety: folds=20
Veraz147: folds=20
the_wickstar: folds=20
diment76: raises $0.04 to $0.06
agapee92: folds=20
ErdgofrGG: folds=20
Uncalled bet ($0.04) returned to diment76
diment76 collected $0.05 from pot
*** SUMMARY ***
Total pot $0.05 | Rake $0=20
Seat 1: Veraz147 folded before Flop (didn't bet)
Seat 2: the_wickstar folded before Flop (didn't bet)
Seat 3: diment76 (button) collected ($0.05)
Seat 4: agapee92 (small blind) folded before Flop
Seat 5: ErdgofrGG (big blind) folded before Flop
Seat 6: themarfs folded before Flop (didn't bet)
Seat 7: vini374 folded before Flop (didn't bet)
Seat 9: flyperety folded before Flop (didn't bet)


*********** # 73 **************
PokerStars Hand #169698115967:  Hold'em No Limit ($0.01/$0.02 USD) - 20=
17/04/29 11:51:26 CUST [2017/04/28 21:51:26 ET]
Table 'Wilkens' 9-max Seat #7 is the button
Seat 1: LAILAH M ($2 in chips)=20
Seat 3: goofnewf616 ($4.05 in chips)=20
Seat 5: SMUTJAN72 ($1.79 in chips)=20
Seat 6: flyperety ($2.16 in chips)=20
Seat 7: the_wickstar ($1.69 in chips)=20
Seat 8: AldSantalo ($1.95 in chips)=20
Seat 9: jginebra55 ($1.60 in chips)=20
AldSantalo: posts small blind $0.01
jginebra55: posts big blind $0.02
1Asthma1: sits out=20
*** HOLE CARDS ***
Dealt to the_wickstar [5d 8h]
LAILAH M: folds=20
goofnewf616 said, "need card match"
goofnewf616: calls $0.02
SMUTJAN72: folds=20
flyperety has timed out
flyperety: folds=20
the_wickstar: calls $0.02
AldSantalo: folds=20
jginebra55: checks=20
*** FLOP *** [4h 6c 3s]
jginebra55: checks=20
goofnewf616: bets $0.02
the_wickstar: calls $0.02
goofnewf616 said, "100 percent match who gives a f u c k  hey"
jginebra55: calls $0.02
*** TURN *** [4h 6c 3s] [9s]
jginebra55: checks=20
goofnewf616: bets $0.02
the_wickstar: calls $0.02
jginebra55: calls $0.02
*** RIVER *** [4h 6c 3s 9s] [3c]
jginebra55: checks=20
goofnewf616: bets $0.04
the_wickstar: folds=20
jginebra55: folds=20
Uncalled bet ($0.04) returned to goofnewf616
goofnewf616 collected $0.18 from pot
goofnewf616: doesn't show hand=20
*** SUMMARY ***
Total pot $0.19 | Rake $0.01=20
Board [4h 6c 3s 9s 3c]
Seat 1: LAILAH M folded before Flop (didn't bet)
Seat 3: goofnewf616 collected ($0.18)
Seat 5: SMUTJAN72 folded before Flop (didn't bet)
Seat 6: flyperety folded before Flop (didn't bet)
Seat 7: the_wickstar (button) folded on the River
Seat 8: AldSantalo (small blind) folded before Flop
Seat 9: jginebra55 (big blind) folded on the River


*********** # 74 **************
PokerStars Hand #169698100365:  Hold'em No Limit ($0.01/$0.02 USD) - 20=
17/04/29 11:50:51 CUST [2017/04/28 21:50:51 ET]
Table 'Wilkens' 9-max Seat #6 is the button
Seat 1: LAILAH M ($2 in chips)=20
Seat 3: goofnewf616 ($4.02 in chips)=20
Seat 5: SMUTJAN72 ($1.79 in chips)=20
Seat 6: flyperety ($2.16 in chips)=20
Seat 7: the_wickstar ($1.70 in chips)=20
Seat 8: AldSantalo ($1.97 in chips)=20
Seat 9: jginebra55 ($1.60 in chips)=20
the_wickstar: posts small blind $0.01
AldSantalo: posts big blind $0.02
1Asthma1: sits out=20
*** HOLE CARDS ***
Dealt to the_wickstar [Jc 3d]
jginebra55: folds=20
LAILAH M: folds=20
goofnewf616: raises $4 to $4.02 and is all-in
SMUTJAN72: folds=20
flyperety: folds=20
the_wickstar: folds=20
AldSantalo: folds=20
Uncalled bet ($4) returned to goofnewf616
goofnewf616 collected $0.05 from pot
goofnewf616: doesn't show hand=20
*** SUMMARY ***
Total pot $0.05 | Rake $0=20
Seat 1: LAILAH M folded before Flop (didn't bet)
Seat 3: goofnewf616 collected ($0.05)
Seat 5: SMUTJAN72 folded before Flop (didn't bet)
Seat 6: flyperety (button) folded before Flop (didn't bet)
Seat 7: the_wickstar (small blind) folded before Flop
Seat 8: AldSantalo (big blind) folded before Flop
Seat 9: jginebra55 folded before Flop (didn't bet)


*********** # 75 **************
PokerStars Hand #169698097138:  Hold'em No Limit ($0.01/$0.02 USD) - 20=
17/04/29 11:50:43 CUST [2017/04/28 21:50:43 ET]
Table 'Antilia' 9-max Seat #2 is the button
Seat 1: Veraz147 ($2.14 in chips)=20
Seat 2: the_wickstar ($1.93 in chips)=20
Seat 3: diment76 ($1.64 in chips)=20
Seat 4: agapee92 ($2.36 in chips)=20
Seat 5: ErdgofrGG ($2.42 in chips)=20
Seat 6: themarfs ($2.16 in chips)=20
Seat 7: vini374 ($1.37 in chips)=20
Seat 9: flyperety ($2.38 in chips)=20
diment76: posts small blind $0.01
agapee92: posts big blind $0.02
*** HOLE CARDS ***
Dealt to the_wickstar [Js As]
ErdgofrGG: folds=20
themarfs: raises $0.04 to $0.06
vini374: folds=20
flyperety: raises $0.18 to $0.24
Veraz147: folds=20
the_wickstar: calls $0.24
shirleypo503 is disconnected=20
diment76: folds=20
agapee92: folds=20
themarfs: folds=20
*** FLOP *** [9c 9s 6c]
flyperety: bets $0.37
the_wickstar: folds=20
Uncalled bet ($0.37) returned to flyperety
flyperety collected $0.55 from pot
flyperety: doesn't show hand=20
*** SUMMARY ***
Total pot $0.57 | Rake $0.02=20
Board [9c 9s 6c]
Seat 1: Veraz147 folded before Flop (didn't bet)
Seat 2: the_wickstar (button) folded on the Flop
Seat 3: diment76 (small blind) folded before Flop
Seat 4: agapee92 (big blind) folded before Flop
Seat 5: ErdgofrGG folded before Flop (didn't bet)
Seat 6: themarfs folded before Flop
Seat 7: vini374 folded before Flop (didn't bet)
Seat 9: flyperety collected ($0.55)


*********** # 76 **************
PokerStars Hand #169698069402:  Hold'em No Limit ($0.01/$0.02 USD) - 20=
17/04/29 11:49:36 CUST [2017/04/28 21:49:36 ET]
Table 'Wilkens' 9-max Seat #5 is the button
Seat 1: LAILAH M ($2 in chips)=20
Seat 3: goofnewf616 ($3.96 in chips)=20
Seat 5: SMUTJAN72 ($1.81 in chips)=20
Seat 6: flyperety ($2.18 in chips)=20
Seat 7: the_wickstar ($1.72 in chips)=20
Seat 8: AldSantalo ($1.97 in chips)=20
Seat 9: jginebra55 ($1.60 in chips)=20
flyperety: posts small blind $0.01
the_wickstar: posts big blind $0.02
1Asthma1: sits out=20
*** HOLE CARDS ***
Dealt to the_wickstar [8c 7s]
AldSantalo: folds=20
jginebra55: folds=20
LAILAH M: folds=20
goofnewf616: calls $0.02
SMUTJAN72: calls $0.02
flyperety: calls $0.01
goofnewf616 said, "a7"
the_wickstar: checks=20
*** FLOP *** [5c 9d 9s]
flyperety: checks=20
the_wickstar: checks=20
goofnewf616: checks=20
SMUTJAN72: checks=20
*** TURN *** [5c 9d 9s] [2c]
flyperety: checks=20
the_wickstar: checks=20
goofnewf616: checks=20
SMUTJAN72: checks=20
*** RIVER *** [5c 9d 9s 2c] [5h]
flyperety: checks=20
the_wickstar: checks=20
goofnewf616: checks=20
SMUTJAN72: checks=20
*** SHOW DOWN ***
flyperety: shows [8d 2d] (two pair, Nines and Fives)
the_wickstar: shows [8c 7s] (two pair, Nines and Fives)
goofnewf616: shows [Ac 7d] (two pair, Nines and Fives - Ace kicker)
SMUTJAN72: mucks hand=20
goofnewf616 collected $0.08 from pot
*** SUMMARY ***
Total pot $0.08 | Rake $0=20
Board [5c 9d 9s 2c 5h]
Seat 1: LAILAH M folded before Flop (didn't bet)
Seat 3: goofnewf616 showed [Ac 7d] and won ($0.08) with two pair, Nines=
 and Fives
Seat 5: SMUTJAN72 (button) mucked [Jh 4h]
Seat 6: flyperety (small blind) showed [8d 2d] and lost with two pair, =
Nines and Fives
Seat 7: the_wickstar (big blind) showed [8c 7s] and lost with two pair,=
 Nines and Fives
Seat 8: AldSantalo folded before Flop (didn't bet)
Seat 9: jginebra55 folded before Flop (didn't bet)


*********** # 77 **************
PokerStars Hand #169698055533:  Hold'em No Limit ($0.01/$0.02 USD) - 20=
17/04/29 11:49:02 CUST [2017/04/28 21:49:02 ET]
Table 'Antilia' 9-max Seat #1 is the button
Seat 1: Veraz147 ($2.14 in chips)=20
Seat 2: the_wickstar ($1.85 in chips)=20
Seat 3: diment76 ($1.66 in chips)=20
Seat 4: agapee92 ($2.36 in chips)=20
Seat 5: ErdgofrGG ($2.42 in chips)=20
Seat 6: themarfs ($2.16 in chips)=20
Seat 7: vini374 ($1.43 in chips)=20
Seat 9: flyperety ($2.38 in chips)=20
the_wickstar: posts small blind $0.01
diment76: posts big blind $0.02
*** HOLE CARDS ***
Dealt to the_wickstar [Jh Tc]
agapee92: folds=20
ErdgofrGG: folds=20
themarfs: folds=20
vini374: calls $0.02
flyperety: folds=20
Veraz147: folds=20
the_wickstar: calls $0.01
diment76: checks=20
*** FLOP *** [8h As Kd]
the_wickstar: checks=20
diment76: checks=20
vini374: bets $0.02
the_wickstar: calls $0.02
diment76: folds=20
*** TURN *** [8h As Kd] [3d]
the_wickstar: checks=20
vini374: bets $0.02
the_wickstar: calls $0.02
*** RIVER *** [8h As Kd 3d] [3s]
the_wickstar: bets $0.10
vini374: folds=20
Uncalled bet ($0.10) returned to the_wickstar
the_wickstar collected $0.14 from pot
*** SUMMARY ***
Total pot $0.14 | Rake $0=20
Board [8h As Kd 3d 3s]
Seat 1: Veraz147 (button) folded before Flop (didn't bet)
Seat 2: the_wickstar (small blind) collected ($0.14)
Seat 3: diment76 (big blind) folded on the Flop
Seat 4: agapee92 folded before Flop (didn't bet)
Seat 5: ErdgofrGG folded before Flop (didn't bet)
Seat 6: themarfs folded before Flop (didn't bet)
Seat 7: vini374 folded on the River
Seat 9: flyperety folded before Flop (didn't bet)


*********** # 78 **************
PokerStars Hand #169698049818:  Hold'em No Limit ($0.01/$0.02 USD) - 20=
17/04/29 11:48:49 CUST [2017/04/28 21:48:49 ET]
Table 'Wilkens' 9-max Seat #3 is the button
Seat 1: LAILAH M ($2 in chips)=20
Seat 3: goofnewf616 ($3.93 in chips)=20
Seat 5: SMUTJAN72 ($1.82 in chips)=20
Seat 6: flyperety ($2.20 in chips)=20
Seat 7: the_wickstar ($1.72 in chips)=20
Seat 8: AldSantalo ($1.97 in chips)=20
Seat 9: jginebra55 ($1.60 in chips)=20
SMUTJAN72: posts small blind $0.01
flyperety: posts big blind $0.02
*** HOLE CARDS ***
Dealt to the_wickstar [Ts 5h]
the_wickstar: folds=20
EYENOGOOD4U leaves the table
goofnewf616 said, "sorry"
1Asthma1 joins the table at seat #2=20
AldSantalo: folds=20
jginebra55: folds=20
LAILAH M: folds=20
goofnewf616: calls $0.02
SMUTJAN72: folds=20
flyperety: checks=20
*** FLOP *** [4d Jc 6d]
flyperety: checks=20
goofnewf616: checks=20
*** TURN *** [4d Jc 6d] [5d]
flyperety: checks=20
goofnewf616: checks=20
*** RIVER *** [4d Jc 6d 5d] [Ah]
flyperety: checks=20
goofnewf616: bets $0.04
flyperety: folds=20
Uncalled bet ($0.04) returned to goofnewf616
goofnewf616 collected $0.05 from pot
goofnewf616: doesn't show hand=20
*** SUMMARY ***
Total pot $0.05 | Rake $0=20
Board [4d Jc 6d 5d Ah]
Seat 1: LAILAH M folded before Flop (didn't bet)
Seat 3: goofnewf616 (button) collected ($0.05)
Seat 5: SMUTJAN72 (small blind) folded before Flop
Seat 6: flyperety (big blind) folded on the River
Seat 7: the_wickstar folded before Flop (didn't bet)
Seat 8: AldSantalo folded before Flop (didn't bet)
Seat 9: jginebra55 folded before Flop (didn't bet)


*********** # 79 **************
PokerStars Hand #169698033349:  Hold'em No Limit ($0.01/$0.02 USD) - 20=
17/04/29 11:48:09 CUST [2017/04/28 21:48:09 ET]
Table 'Antilia' 9-max Seat #9 is the button
Seat 1: Veraz147 ($2.15 in chips)=20
Seat 2: the_wickstar ($1.84 in chips)=20
Seat 3: diment76 ($1.66 in chips)=20
Seat 4: agapee92 ($2.36 in chips)=20
Seat 5: ErdgofrGG ($2.42 in chips)=20
Seat 6: themarfs ($2.16 in chips)=20
Seat 7: vini374 ($1.43 in chips)=20
Seat 8: shirleypo503 ($0.66 in chips)=20
Seat 9: flyperety ($2.38 in chips)=20
Veraz147: posts small blind $0.01
the_wickstar: posts big blind $0.02
*** HOLE CARDS ***
Dealt to the_wickstar [5c 5h]
diment76: folds=20
agapee92: folds=20
ErdgofrGG: folds=20
themarfs: folds=20
vini374: folds=20
shirleypo503 has timed out
shirleypo503: folds=20
flyperety: folds=20
Veraz147: folds=20
Uncalled bet ($0.01) returned to the_wickstar
the_wickstar collected $0.02 from pot
*** SUMMARY ***
Total pot $0.02 | Rake $0=20
Seat 1: Veraz147 (small blind) folded before Flop
Seat 2: the_wickstar (big blind) collected ($0.02)
Seat 3: diment76 folded before Flop (didn't bet)
Seat 4: agapee92 folded before Flop (didn't bet)
Seat 5: ErdgofrGG folded before Flop (didn't bet)
Seat 6: themarfs folded before Flop (didn't bet)
Seat 7: vini374 folded before Flop (didn't bet)
Seat 8: shirleypo503 folded before Flop (didn't bet)
Seat 9: flyperety (button) folded before Flop (didn't bet)


*********** # 80 **************
PokerStars Hand #169698028507:  Hold'em No Limit ($0.01/$0.02 USD) - 20=
17/04/29 11:47:57 CUST [2017/04/28 21:47:57 ET]
Table 'Wilkens' 9-max Seat #1 is the button
Seat 1: LAILAH M ($2 in chips)=20
Seat 2: EYENOGOOD4U ($1.97 in chips)=20
Seat 3: goofnewf616 ($2.10 in chips)=20
Seat 5: SMUTJAN72 ($1.82 in chips)=20
Seat 6: flyperety ($2.20 in chips)=20
Seat 7: the_wickstar ($1.72 in chips)=20
Seat 8: AldSantalo ($1.97 in chips)=20
Seat 9: jginebra55 ($1.60 in chips)=20
EYENOGOOD4U: posts small blind $0.01
goofnewf616: posts big blind $0.02
*** HOLE CARDS ***
Dealt to the_wickstar [Qs 7h]
SMUTJAN72: folds=20
flyperety: folds=20
goofnewf616 said, "a k"
the_wickstar: folds=20
AldSantalo: folds=20
jginebra55: folds=20
LAILAH M: folds=20
EYENOGOOD4U: raises $0.06 to $0.08
goofnewf616: raises $0.06 to $0.14
EYENOGOOD4U: raises $1.83 to $1.97 and is all-in
goofnewf616: calls $1.83
*** FLOP *** [2c 7s Js]
*** TURN *** [2c 7s Js] [9d]
*** RIVER *** [2c 7s Js 9d] [9h]
*** SHOW DOWN ***
EYENOGOOD4U: shows [Ad Qd] (a pair of Nines)
goofnewf616: shows [Ah 9s] (three of a kind, Nines)
goofnewf616 collected $3.80 from pot
*** SUMMARY ***
Total pot $3.94 | Rake $0.14=20
Board [2c 7s Js 9d 9h]
Seat 1: LAILAH M (button) folded before Flop (didn't bet)
Seat 2: EYENOGOOD4U (small blind) showed [Ad Qd] and lost with a pair o=
f Nines
Seat 3: goofnewf616 (big blind) showed [Ah 9s] and won ($3.80) with thr=
ee of a kind, Nines
Seat 5: SMUTJAN72 folded before Flop (didn't bet)
Seat 6: flyperety folded before Flop (didn't bet)
Seat 7: the_wickstar folded before Flop (didn't bet)
Seat 8: AldSantalo folded before Flop (didn't bet)
Seat 9: jginebra55 folded before Flop (didn't bet)


*********** # 81 **************
PokerStars Hand #169698010721:  Hold'em No Limit ($0.01/$0.02 USD) - 20=
17/04/29 11:47:13 CUST [2017/04/28 21:47:13 ET]
Table 'Antilia' 9-max Seat #8 is the button
Seat 1: Veraz147 ($2.12 in chips)=20
Seat 2: the_wickstar ($1.86 in chips)=20
Seat 3: diment76 ($1.66 in chips)=20
Seat 4: agapee92 ($2.36 in chips)=20
Seat 5: ErdgofrGG ($2.42 in chips)=20
Seat 6: themarfs ($2.16 in chips)=20
Seat 7: vini374 ($1.43 in chips)=20
Seat 8: shirleypo503 ($0.66 in chips)=20
Seat 9: flyperety ($2.39 in chips)=20
flyperety: posts small blind $0.01
Veraz147: posts big blind $0.02
*** HOLE CARDS ***
Dealt to the_wickstar [Js Kd]
the_wickstar: calls $0.02
diment76: folds=20
agapee92: folds=20
ErdgofrGG: folds=20
themarfs: folds=20
vini374: folds=20
shirleypo503: folds=20
flyperety: folds=20
Veraz147: checks=20
*** FLOP *** [6h 4h Ah]
Veraz147: checks=20
the_wickstar: checks=20
*** TURN *** [6h 4h Ah] [Th]
Veraz147: checks=20
the_wickstar: checks=20
*** RIVER *** [6h 4h Ah Th] [Ad]
Veraz147: checks=20
the_wickstar: checks=20
*** SHOW DOWN ***
Veraz147: shows [7h Tc] (a flush, Ace high)
the_wickstar: mucks hand=20
Veraz147 collected $0.05 from pot
*** SUMMARY ***
Total pot $0.05 | Rake $0=20
Board [6h 4h Ah Th Ad]
Seat 1: Veraz147 (big blind) showed [7h Tc] and won ($0.05) with a flus=
h, Ace high
Seat 2: the_wickstar mucked [Js Kd]
Seat 3: diment76 folded before Flop (didn't bet)
Seat 4: agapee92 folded before Flop (didn't bet)
Seat 5: ErdgofrGG folded before Flop (didn't bet)
Seat 6: themarfs folded before Flop (didn't bet)
Seat 7: vini374 folded before Flop (didn't bet)
Seat 8: shirleypo503 (button) folded before Flop (didn't bet)
Seat 9: flyperety (small blind) folded before Flop


*********** # 82 **************
PokerStars Hand #169698005210:  Hold'em No Limit ($0.01/$0.02 USD) - 20=
17/04/29 11:47:00 CUST [2017/04/28 21:47:00 ET]
Table 'Wilkens' 9-max Seat #9 is the button
Seat 1: LAILAH M ($2.01 in chips)=20
Seat 2: EYENOGOOD4U ($1.99 in chips)=20
Seat 3: goofnewf616 ($2.07 in chips)=20
Seat 5: SMUTJAN72 ($1.82 in chips)=20
Seat 6: flyperety ($2.20 in chips)=20
Seat 7: the_wickstar ($1.72 in chips)=20
Seat 8: AldSantalo ($1.97 in chips)=20
Seat 9: jginebra55 ($1.60 in chips)=20
LAILAH M: posts small blind $0.01
EYENOGOOD4U: posts big blind $0.02
*** HOLE CARDS ***
Dealt to the_wickstar [6s 8h]
goofnewf616: calls $0.02
SMUTJAN72: folds=20
flyperety: folds=20
the_wickstar: folds=20
AldSantalo: folds=20
goofnewf616 said, "q 2"
jginebra55: folds=20
LAILAH M: folds=20
EYENOGOOD4U: checks=20
*** FLOP *** [Ac Th 7d]
EYENOGOOD4U: checks=20
goofnewf616: checks=20
*** TURN *** [Ac Th 7d] [Td]
EYENOGOOD4U: checks=20
goofnewf616: checks=20
*** RIVER *** [Ac Th 7d Td] [Qd]
EYENOGOOD4U: checks=20
goofnewf616: bets $0.02
EYENOGOOD4U: folds=20
Uncalled bet ($0.02) returned to goofnewf616
goofnewf616 collected $0.05 from pot
goofnewf616: doesn't show hand=20
*** SUMMARY ***
Total pot $0.05 | Rake $0=20
Board [Ac Th 7d Td Qd]
Seat 1: LAILAH M (small blind) folded before Flop
Seat 2: EYENOGOOD4U (big blind) folded on the River
Seat 3: goofnewf616 collected ($0.05)
Seat 5: SMUTJAN72 folded before Flop (didn't bet)
Seat 6: flyperety folded before Flop (didn't bet)
Seat 7: the_wickstar folded before Flop (didn't bet)
Seat 8: AldSantalo folded before Flop (didn't bet)
Seat 9: jginebra55 (button) folded before Flop (didn't bet)


*********** # 83 **************
PokerStars Hand #169697998908:  Hold'em No Limit ($0.01/$0.02 USD) - 20=
17/04/29 11:46:45 CUST [2017/04/28 21:46:45 ET]
Table 'Antilia' 9-max Seat #7 is the button
Seat 1: Veraz147 ($2.12 in chips)=20
Seat 2: the_wickstar ($1.86 in chips)=20
Seat 3: diment76 ($1.66 in chips)=20
Seat 4: agapee92 ($2.36 in chips)=20
Seat 5: ErdgofrGG ($2.42 in chips)=20
Seat 6: themarfs ($2.16 in chips)=20
Seat 7: vini374 ($1.43 in chips)=20
Seat 8: shirleypo503 ($0.67 in chips)=20
Seat 9: flyperety ($2.38 in chips)=20
shirleypo503: posts small blind $0.01
flyperety: posts big blind $0.02
*** HOLE CARDS ***
Dealt to the_wickstar [Qd 9s]
Veraz147: folds=20
the_wickstar: folds=20
diment76: folds=20
agapee92: folds=20
ErdgofrGG: folds=20
themarfs: folds=20
vini374: folds=20
shirleypo503: folds=20
Uncalled bet ($0.01) returned to flyperety
flyperety collected $0.02 from pot
flyperety: doesn't show hand=20
*** SUMMARY ***
Total pot $0.02 | Rake $0=20
Seat 1: Veraz147 folded before Flop (didn't bet)
Seat 2: the_wickstar folded before Flop (didn't bet)
Seat 3: diment76 folded before Flop (didn't bet)
Seat 4: agapee92 folded before Flop (didn't bet)
Seat 5: ErdgofrGG folded before Flop (didn't bet)
Seat 6: themarfs folded before Flop (didn't bet)
Seat 7: vini374 (button) folded before Flop (didn't bet)
Seat 8: shirleypo503 (small blind) folded before Flop
Seat 9: flyperety (big blind) collected ($0.02)


*********** # 84 **************
PokerStars Hand #169697989471:  Hold'em No Limit ($0.01/$0.02 USD) - 20=
17/04/29 11:46:22 CUST [2017/04/28 21:46:22 ET]
Table 'Antilia' 9-max Seat #6 is the button
Seat 1: Veraz147 ($2.12 in chips)=20
Seat 2: the_wickstar ($1.86 in chips)=20
Seat 3: diment76 ($1.66 in chips)=20
Seat 4: agapee92 ($2.36 in chips)=20
Seat 5: ErdgofrGG ($2.42 in chips)=20
Seat 6: themarfs ($2.16 in chips)=20
Seat 7: vini374 ($1.44 in chips)=20
Seat 8: shirleypo503 ($0.66 in chips)=20
Seat 9: flyperety ($2.38 in chips)=20
vini374: posts small blind $0.01
shirleypo503: posts big blind $0.02
*** HOLE CARDS ***
Dealt to the_wickstar [8c Ac]
flyperety: folds=20
Veraz147: folds=20
the_wickstar: folds=20
diment76: folds=20
agapee92: folds=20
ErdgofrGG: folds=20
themarfs: folds=20
vini374: folds=20
Uncalled bet ($0.01) returned to shirleypo503
shirleypo503 collected $0.02 from pot
*** SUMMARY ***
Total pot $0.02 | Rake $0=20
Seat 1: Veraz147 folded before Flop (didn't bet)
Seat 2: the_wickstar folded before Flop (didn't bet)
Seat 3: diment76 folded before Flop (didn't bet)
Seat 4: agapee92 folded before Flop (didn't bet)
Seat 5: ErdgofrGG folded before Flop (didn't bet)
Seat 6: themarfs (button) folded before Flop (didn't bet)
Seat 7: vini374 (small blind) folded before Flop
Seat 8: shirleypo503 (big blind) collected ($0.02)
Seat 9: flyperety folded before Flop (didn't bet)


*********** # 85 **************
PokerStars Hand #169697966584:  Hold'em No Limit ($0.01/$0.02 USD) - 20=
17/04/29 11:45:27 CUST [2017/04/28 21:45:27 ET]
Table 'Wilkens' 9-max Seat #8 is the button
Seat 1: LAILAH M ($2.03 in chips)=20
Seat 2: EYENOGOOD4U ($2.09 in chips)=20
Seat 3: goofnewf616 ($2.11 in chips)=20
Seat 5: SMUTJAN72 ($1.82 in chips)=20
Seat 6: flyperety ($2 in chips)=20
Seat 7: the_wickstar ($1.76 in chips)=20
Seat 8: AldSantalo ($1.97 in chips)=20
Seat 9: jginebra55 ($1.61 in chips)=20
jginebra55: posts small blind $0.01
LAILAH M: posts big blind $0.02
*** HOLE CARDS ***
Dealt to the_wickstar [Ac Td]
EYENOGOOD4U: calls $0.02
goofnewf616: calls $0.02
SMUTJAN72: folds=20
flyperety: raises $0.02 to $0.04
the_wickstar: calls $0.04
AldSantalo: folds=20
jginebra55: folds=20
LAILAH M: folds=20
goofnewf616 said, "needed card match ty"
EYENOGOOD4U: calls $0.02
goofnewf616: calls $0.02
*** FLOP *** [6h 8h 4c]
EYENOGOOD4U: checks=20
goofnewf616: checks=20
flyperety: checks=20
the_wickstar: checks=20
*** TURN *** [6h 8h 4c] [9s]
EYENOGOOD4U: checks=20
goofnewf616: checks=20
flyperety: checks=20
the_wickstar: checks=20
*** RIVER *** [6h 8h 4c 9s] [4s]
EYENOGOOD4U: bets $0.06
goofnewf616: folds=20
flyperety: calls $0.06
the_wickstar: folds=20
*** SHOW DOWN ***
EYENOGOOD4U: shows [Qd 9d] (two pair, Nines and Fours)
flyperety: shows [4h 5h] (three of a kind, Fours)
flyperety collected $0.30 from pot
*** SUMMARY ***
Total pot $0.31 | Rake $0.01=20
Board [6h 8h 4c 9s 4s]
Seat 1: LAILAH M (big blind) folded before Flop
Seat 2: EYENOGOOD4U showed [Qd 9d] and lost with two pair, Nines and Fo=
urs
Seat 3: goofnewf616 folded on the River
Seat 5: SMUTJAN72 folded before Flop (didn't bet)
Seat 6: flyperety showed [4h 5h] and won ($0.30) with three of a kind, =
Fours
Seat 7: the_wickstar folded on the River
Seat 8: AldSantalo (button) folded before Flop (didn't bet)
Seat 9: jginebra55 (small blind) folded before Flop


*********** # 86 **************
PokerStars Hand #169697965385:  Hold'em No Limit ($0.01/$0.02 USD) - 20=
17/04/29 11:45:25 CUST [2017/04/28 21:45:25 ET]
Table 'Antilia' 9-max Seat #5 is the button
Seat 1: Veraz147 ($2.12 in chips)=20
Seat 2: the_wickstar ($1.78 in chips)=20
Seat 3: diment76 ($1.66 in chips)=20
Seat 4: agapee92 ($2.36 in chips)=20
Seat 5: ErdgofrGG ($2.42 in chips)=20
Seat 6: themarfs ($2.17 in chips)=20
Seat 7: vini374 ($1.46 in chips)=20
Seat 8: shirleypo503 ($0.72 in chips)=20
Seat 9: flyperety ($2.38 in chips)=20
themarfs: posts small blind $0.01
vini374: posts big blind $0.02
*** HOLE CARDS ***
Dealt to the_wickstar [Qh Td]
shirleypo503: calls $0.02
flyperety: folds=20
Veraz147: folds=20
the_wickstar: raises $0.04 to $0.06
diment76: folds=20
agapee92: folds=20
ErdgofrGG: folds=20
themarfs: folds=20
vini374: folds=20
shirleypo503: calls $0.04
*** FLOP *** [6d Ks Jd]
shirleypo503: checks=20
the_wickstar: checks=20
*** TURN *** [6d Ks Jd] [Kd]
shirleypo503: checks=20
the_wickstar: bets $0.10
shirleypo503: folds=20
Uncalled bet ($0.10) returned to the_wickstar
the_wickstar collected $0.14 from pot
*** SUMMARY ***
Total pot $0.15 | Rake $0.01=20
Board [6d Ks Jd Kd]
Seat 1: Veraz147 folded before Flop (didn't bet)
Seat 2: the_wickstar collected ($0.14)
Seat 3: diment76 folded before Flop (didn't bet)
Seat 4: agapee92 folded before Flop (didn't bet)
Seat 5: ErdgofrGG (button) folded before Flop (didn't bet)
Seat 6: themarfs (small blind) folded before Flop
Seat 7: vini374 (big blind) folded before Flop
Seat 8: shirleypo503 folded on the Turn
Seat 9: flyperety folded before Flop (didn't bet)


*********** # 87 **************
PokerStars Hand #169697951088:  Hold'em No Limit ($0.01/$0.02 USD) - 20=
17/04/29 11:44:50 CUST [2017/04/28 21:44:50 ET]
Table 'Wilkens' 9-max Seat #7 is the button
Seat 1: LAILAH M ($2.03 in chips)=20
Seat 2: EYENOGOOD4U ($2.11 in chips)=20
Seat 3: goofnewf616 ($2.06 in chips)=20
Seat 5: SMUTJAN72 ($1.82 in chips)=20
Seat 6: flyperety ($2 in chips)=20
Seat 7: the_wickstar ($1.76 in chips)=20
Seat 8: AldSantalo ($1.98 in chips)=20
Seat 9: jginebra55 ($1.63 in chips)=20
AldSantalo: posts small blind $0.01
jginebra55: posts big blind $0.02
*** HOLE CARDS ***
Dealt to the_wickstar [8c 4s]
LAILAH M: folds=20
EYENOGOOD4U: calls $0.02
goofnewf616: raises $0.10 to $0.12
SMUTJAN72: folds=20
flyperety: folds=20
the_wickstar: folds=20
AldSantalo: folds=20
jginebra55: folds=20
EYENOGOOD4U: folds=20
Uncalled bet ($0.10) returned to goofnewf616
goofnewf616 collected $0.07 from pot
goofnewf616: doesn't show hand=20
*** SUMMARY ***
Total pot $0.07 | Rake $0=20
Seat 1: LAILAH M folded before Flop (didn't bet)
Seat 2: EYENOGOOD4U folded before Flop
Seat 3: goofnewf616 collected ($0.07)
Seat 5: SMUTJAN72 folded before Flop (didn't bet)
Seat 6: flyperety folded before Flop (didn't bet)
Seat 7: the_wickstar (button) folded before Flop (didn't bet)
Seat 8: AldSantalo (small blind) folded before Flop
Seat 9: jginebra55 (big blind) folded before Flop


*********** # 88 **************
PokerStars Hand #169697937931:  Hold'em No Limit ($0.01/$0.02 USD) - 20=
17/04/29 11:44:19 CUST [2017/04/28 21:44:19 ET]
Table 'Antilia' 9-max Seat #4 is the button
Seat 1: Veraz147 ($2.12 in chips)=20
Seat 2: the_wickstar ($1.75 in chips)=20
Seat 3: diment76 ($1.66 in chips)=20
Seat 4: agapee92 ($2.36 in chips)=20
Seat 5: ErdgofrGG ($2.43 in chips)=20
Seat 6: themarfs ($2.19 in chips)=20
Seat 7: vini374 ($1.46 in chips)=20
Seat 9: flyperety ($2.38 in chips)=20
ErdgofrGG: posts small blind $0.01
themarfs: posts big blind $0.02
*** HOLE CARDS ***
Dealt to the_wickstar [As 4d]
vini374 has timed out
vini374: folds=20
flyperety: folds=20
Veraz147: folds=20
the_wickstar: calls $0.02
diment76: folds=20
agapee92: folds=20
ErdgofrGG: folds=20
themarfs: checks=20
*** FLOP *** [6s 5h Js]
themarfs: checks=20
the_wickstar: bets $0.03
themarfs: folds=20
Uncalled bet ($0.03) returned to the_wickstar
the_wickstar collected $0.05 from pot
*** SUMMARY ***
Total pot $0.05 | Rake $0=20
Board [6s 5h Js]
Seat 1: Veraz147 folded before Flop (didn't bet)
Seat 2: the_wickstar collected ($0.05)
Seat 3: diment76 folded before Flop (didn't bet)
Seat 4: agapee92 (button) folded before Flop (didn't bet)
Seat 5: ErdgofrGG (small blind) folded before Flop
Seat 6: themarfs (big blind) folded on the Flop
Seat 7: vini374 folded before Flop (didn't bet)
Seat 9: flyperety folded before Flop (didn't bet)


*********** # 89 **************
PokerStars Hand #169697902180:  Hold'em No Limit ($0.01/$0.02 USD) - 20=
17/04/29 11:42:55 CUST [2017/04/28 21:42:55 ET]
Table 'Wilkens' 9-max Seat #6 is the button
Seat 1: LAILAH M ($2.03 in chips)=20
Seat 2: EYENOGOOD4U ($1.70 in chips)=20
Seat 3: goofnewf616 ($2.08 in chips)=20
Seat 5: SMUTJAN72 ($1.94 in chips)=20
Seat 6: flyperety ($2 in chips)=20
Seat 7: the_wickstar ($2.04 in chips)=20
Seat 8: AldSantalo ($2 in chips)=20
Seat 9: jginebra55 ($1.63 in chips)=20
the_wickstar: posts small blind $0.01
AldSantalo: posts big blind $0.02
*** HOLE CARDS ***
Dealt to the_wickstar [8d 5c]
the_wickstar said, ":)"
jginebra55: folds=20
LAILAH M: folds=20
EYENOGOOD4U: calls $0.02
goofnewf616: calls $0.02
SMUTJAN72: calls $0.02
flyperety: folds=20
the_wickstar: calls $0.01
AldSantalo: checks=20
*** FLOP *** [8c 8s Js]
the_wickstar: bets $0.04
AldSantalo: folds=20
EYENOGOOD4U: calls $0.04
goofnewf616: folds=20
SMUTJAN72: calls $0.04
*** TURN *** [8c 8s Js] [4s]
the_wickstar: checks=20
EYENOGOOD4U: bets $0.06
SMUTJAN72: calls $0.06
the_wickstar: raises $0.06 to $0.12
EYENOGOOD4U: calls $0.06
SMUTJAN72: folds=20
*** RIVER *** [8c 8s Js 4s] [6d]
the_wickstar: checks=20
EYENOGOOD4U: bets $0.10
the_wickstar: calls $0.10
*** SHOW DOWN ***
EYENOGOOD4U: shows [4c 4h] (a full house, Fours full of Eights)
goofnewf616 said, "<:)"
the_wickstar: mucks hand=20
EYENOGOOD4U collected $0.69 from pot
*** SUMMARY ***
Total pot $0.72 | Rake $0.03=20
Board [8c 8s Js 4s 6d]
Seat 1: LAILAH M folded before Flop (didn't bet)
Seat 2: EYENOGOOD4U showed [4c 4h] and won ($0.69) with a full house, F=
ours full of Eights
Seat 3: goofnewf616 folded on the Flop
Seat 5: SMUTJAN72 folded on the Turn
Seat 6: flyperety (button) folded before Flop (didn't bet)
Seat 7: the_wickstar (small blind) mucked [8d 5c]
Seat 8: AldSantalo (big blind) folded on the Flop
Seat 9: jginebra55 folded before Flop (didn't bet)


*********** # 90 **************
PokerStars Hand #169697900865:  Hold'em No Limit ($0.01/$0.02 USD) - 20=
17/04/29 11:42:52 CUST [2017/04/28 21:42:52 ET]
Table 'Antilia' 9-max Seat #3 is the button
Seat 1: Veraz147 ($2.12 in chips)=20
Seat 2: the_wickstar ($1.75 in chips)=20
Seat 3: diment76 ($1.85 in chips)=20
Seat 4: agapee92 ($2.37 in chips)=20
Seat 5: ErdgofrGG ($2.24 in chips)=20
Seat 6: themarfs ($2.19 in chips)=20
Seat 7: vini374 ($1.46 in chips)=20
Seat 8: shirleypo503 ($0.72 in chips)=20
Seat 9: flyperety ($2.38 in chips)=20
agapee92: posts small blind $0.01
ErdgofrGG: posts big blind $0.02
*** HOLE CARDS ***
Dealt to the_wickstar [3h 6d]
themarfs: folds=20
vini374: folds=20
shirleypo503 has timed out
shirleypo503: folds=20
flyperety: folds=20
Veraz147: folds=20
the_wickstar: folds=20
diment76: raises $0.04 to $0.06
agapee92: folds=20
ErdgofrGG: calls $0.04
*** FLOP *** [Qd Ad Js]
ErdgofrGG: bets $0.13
diment76: calls $0.13
*** TURN *** [Qd Ad Js] [7s]
ErdgofrGG: bets $0.38
diment76: folds=20
Uncalled bet ($0.38) returned to ErdgofrGG
ErdgofrGG collected $0.38 from pot
ErdgofrGG: doesn't show hand=20
*** SUMMARY ***
Total pot $0.39 | Rake $0.01=20
Board [Qd Ad Js 7s]
Seat 1: Veraz147 folded before Flop (didn't bet)
Seat 2: the_wickstar folded before Flop (didn't bet)
Seat 3: diment76 (button) folded on the Turn
Seat 4: agapee92 (small blind) folded before Flop
Seat 5: ErdgofrGG (big blind) collected ($0.38)
Seat 6: themarfs folded before Flop (didn't bet)
Seat 7: vini374 folded before Flop (didn't bet)
Seat 8: shirleypo503 folded before Flop (didn't bet)
Seat 9: flyperety folded before Flop (didn't bet)


*********** # 91 **************
PokerStars Hand #169697879937:  Hold'em No Limit ($0.01/$0.02 USD) - 20=
17/04/29 11:42:01 CUST [2017/04/28 21:42:01 ET]
Table 'Wilkens' 9-max Seat #5 is the button
Seat 1: LAILAH M ($2.03 in chips)=20
Seat 2: EYENOGOOD4U ($1.70 in chips)=20
Seat 3: goofnewf616 ($2.02 in chips)=20
Seat 5: SMUTJAN72 ($1.94 in chips)=20
Seat 6: flyperety ($2 in chips)=20
Seat 7: the_wickstar ($2.08 in chips)=20
Seat 9: jginebra55 ($1.63 in chips)=20
flyperety: posts small blind $0.01
the_wickstar: posts big blind $0.02
AldSantalo: sits out=20
*** HOLE CARDS ***
Dealt to the_wickstar [9h 4s]
jginebra55: folds=20
LAILAH M: folds=20
EYENOGOOD4U: folds=20
goofnewf616: calls $0.02
SMUTJAN72: folds=20
flyperety: calls $0.01
the_wickstar: checks=20
*** FLOP *** [Ac 7d 8s]
flyperety: checks=20
the_wickstar: checks=20
goofnewf616: checks=20
*** TURN *** [Ac 7d 8s] [Ts]
flyperety: checks=20
the_wickstar: checks=20
goofnewf616: checks=20
*** RIVER *** [Ac 7d 8s Ts] [Ah]
flyperety: checks=20
the_wickstar: checks=20
goofnewf616: bets $0.02
flyperety: folds=20
the_wickstar: calls $0.02
goofnewf616 said, "22"
*** SHOW DOWN ***
goofnewf616: shows [2h 2d] (two pair, Aces and Deuces)
the_wickstar: mucks hand=20
goofnewf616 collected $0.10 from pot
*** SUMMARY ***
Total pot $0.10 | Rake $0=20
Board [Ac 7d 8s Ts Ah]
Seat 1: LAILAH M folded before Flop (didn't bet)
Seat 2: EYENOGOOD4U folded before Flop (didn't bet)
Seat 3: goofnewf616 showed [2h 2d] and won ($0.10) with two pair, Aces =
and Deuces
Seat 5: SMUTJAN72 (button) folded before Flop (didn't bet)
Seat 6: flyperety (small blind) folded on the River
Seat 7: the_wickstar (big blind) mucked [9h 4s]
Seat 9: jginebra55 folded before Flop (didn't bet)


*********** # 92 **************
PokerStars Hand #169697869215:  Hold'em No Limit ($0.01/$0.02 USD) - 20=
17/04/29 11:41:36 CUST [2017/04/28 21:41:36 ET]
Table 'Antilia' 9-max Seat #2 is the button
Seat 1: Veraz147 ($2.02 in chips)=20
Seat 2: the_wickstar ($1.75 in chips)=20
Seat 3: diment76 ($1.86 in chips)=20
Seat 4: agapee92 ($2.39 in chips)=20
Seat 5: ErdgofrGG ($2.24 in chips)=20
Seat 6: themarfs ($2.19 in chips)=20
Seat 7: vini374 ($1.46 in chips)=20
Seat 8: shirleypo503 ($0.80 in chips)=20
Seat 9: flyperety ($2.38 in chips)=20
diment76: posts small blind $0.01
agapee92: posts big blind $0.02
shirleypo503: posts big blind $0.02
*** HOLE CARDS ***
Dealt to the_wickstar [Qh 3s]
ErdgofrGG: folds=20
themarfs: folds=20
vini374 has timed out
vini374: folds=20
shirleypo503: checks=20
flyperety: folds=20
Veraz147: raises $0.06 to $0.08
the_wickstar: folds=20
diment76: folds=20
agapee92: folds=20
shirleypo503: calls $0.06
*** FLOP *** [6d 5s Th]
shirleypo503: checks=20
Veraz147: bets $0.12
shirleypo503: folds=20
Uncalled bet ($0.12) returned to Veraz147
Veraz147 collected $0.18 from pot
Veraz147: doesn't show hand=20
*** SUMMARY ***
Total pot $0.19 | Rake $0.01=20
Board [6d 5s Th]
Seat 1: Veraz147 collected ($0.18)
Seat 2: the_wickstar (button) folded before Flop (didn't bet)
Seat 3: diment76 (small blind) folded before Flop
Seat 4: agapee92 (big blind) folded before Flop
Seat 5: ErdgofrGG folded before Flop (didn't bet)
Seat 6: themarfs folded before Flop (didn't bet)
Seat 7: vini374 folded before Flop (didn't bet)
Seat 8: shirleypo503 folded on the Flop
Seat 9: flyperety folded before Flop (didn't bet)


*********** # 93 **************
PokerStars Hand #169697858286:  Hold'em No Limit ($0.01/$0.02 USD) - 20=
17/04/29 11:41:11 CUST [2017/04/28 21:41:11 ET]
Table 'Wilkens' 9-max Seat #3 is the button
Seat 1: LAILAH M ($2.03 in chips)=20
Seat 2: EYENOGOOD4U ($1.76 in chips)=20
Seat 3: goofnewf616 ($2.08 in chips)=20
Seat 5: SMUTJAN72 ($1.95 in chips)=20
Seat 6: flyperety ($2 in chips)=20
Seat 7: the_wickstar ($1.94 in chips)=20
Seat 9: jginebra55 ($1.63 in chips)=20
SMUTJAN72: posts small blind $0.01
flyperety: posts big blind $0.02
AldSantalo: sits out=20
*** HOLE CARDS ***
Dealt to the_wickstar [4d 4s]
the_wickstar: calls $0.02
jginebra55: folds=20
LAILAH M: folds=20
EYENOGOOD4U: raises $0.04 to $0.06
goofnewf616: calls $0.06
SMUTJAN72: folds=20
flyperety: folds=20
the_wickstar: calls $0.04
*** FLOP *** [3c 7c 4c]
goofnewf616 said, "a k"
the_wickstar: bets $0.10
EYENOGOOD4U: folds=20
goofnewf616: folds=20
Uncalled bet ($0.10) returned to the_wickstar
the_wickstar collected $0.20 from pot
*** SUMMARY ***
Total pot $0.21 | Rake $0.01=20
Board [3c 7c 4c]
Seat 1: LAILAH M folded before Flop (didn't bet)
Seat 2: EYENOGOOD4U folded on the Flop
Seat 3: goofnewf616 (button) folded on the Flop
Seat 5: SMUTJAN72 (small blind) folded before Flop
Seat 6: flyperety (big blind) folded before Flop
Seat 7: the_wickstar collected ($0.20)
Seat 9: jginebra55 folded before Flop (didn't bet)


*********** # 94 **************
PokerStars Hand #169697844273:  Hold'em No Limit ($0.01/$0.02 USD) - 20=
17/04/29 11:40:38 CUST [2017/04/28 21:40:38 ET]
Table 'Antilia' 9-max Seat #1 is the button
Seat 1: Veraz147 ($2.02 in chips)=20
Seat 2: the_wickstar ($1.76 in chips)=20
Seat 3: diment76 ($1.95 in chips)=20
Seat 4: agapee92 ($2.39 in chips)=20
Seat 5: ErdgofrGG ($2.24 in chips)=20
Seat 6: themarfs ($2.19 in chips)=20
Seat 7: vini374 ($1.46 in chips)=20
Seat 9: flyperety ($2.29 in chips)=20
the_wickstar: posts small blind $0.01
diment76: posts big blind $0.02
shirleypo503: sits out=20
*** HOLE CARDS ***
Dealt to the_wickstar [5c Ah]
agapee92: folds=20
ErdgofrGG: folds=20
themarfs: folds=20
vini374: folds=20
flyperety: raises $0.02 to $0.04
Veraz147: folds=20
the_wickstar: folds=20
diment76: calls $0.02
*** FLOP *** [8h Ks 2d]
diment76: checks=20
flyperety: bets $0.05
diment76: calls $0.05
*** TURN *** [8h Ks 2d] [Ac]
diment76: checks=20
flyperety: bets $0.09
diment76: folds=20
Uncalled bet ($0.09) returned to flyperety
flyperety collected $0.18 from pot
flyperety: doesn't show hand=20
*** SUMMARY ***
Total pot $0.19 | Rake $0.01=20
Board [8h Ks 2d Ac]
Seat 1: Veraz147 (button) folded before Flop (didn't bet)
Seat 2: the_wickstar (small blind) folded before Flop
Seat 3: diment76 (big blind) folded on the Turn
Seat 4: agapee92 folded before Flop (didn't bet)
Seat 5: ErdgofrGG folded before Flop (didn't bet)
Seat 6: themarfs folded before Flop (didn't bet)
Seat 7: vini374 folded before Flop (didn't bet)
Seat 9: flyperety collected ($0.18)


*********** # 95 **************
PokerStars Hand #169697835482:  Hold'em No Limit ($0.01/$0.02 USD) - 20=
17/04/29 11:40:17 CUST [2017/04/28 21:40:17 ET]
Table 'Wilkens' 9-max Seat #2 is the button
Seat 1: LAILAH M ($2.03 in chips)=20
Seat 2: EYENOGOOD4U ($1.76 in chips)=20
Seat 3: goofnewf616 ($2.12 in chips)=20
Seat 5: SMUTJAN72 ($1.91 in chips)=20
Seat 6: tetro54 ($2.29 in chips)=20
Seat 7: the_wickstar ($1.94 in chips)=20
Seat 9: jginebra55 ($1.63 in chips)=20
goofnewf616: posts small blind $0.01
SMUTJAN72: posts big blind $0.02
AldSantalo: sits out=20
*** HOLE CARDS ***
Dealt to the_wickstar [Ac 6d]
tetro54: folds=20
tetro54 leaves the table
the_wickstar: folds=20
hard nutss joins the table at seat #6=20
hard nutss leaves the table
jginebra55: folds=20
LAILAH M: folds=20
EYENOGOOD4U: folds=20
goofnewf616: calls $0.01
SMUTJAN72: checks=20
*** FLOP *** [Js 6s 3c]
goofnewf616: checks=20
SMUTJAN72: checks=20
*** TURN *** [Js 6s 3c] [3d]
goofnewf616: checks=20
SMUTJAN72: bets $0.02
goofnewf616: calls $0.02
*** RIVER *** [Js 6s 3c 3d] [9d]
flyperety joins the table at seat #6=20
goofnewf616: checks=20
SMUTJAN72: checks=20
*** SHOW DOWN ***
goofnewf616: shows [4s 7d] (a pair of Threes)
SMUTJAN72: shows [Qh Ts] (a pair of Threes - Queen kicker)
SMUTJAN72 collected $0.08 from pot
*** SUMMARY ***
Total pot $0.08 | Rake $0=20
Board [Js 6s 3c 3d 9d]
Seat 1: LAILAH M folded before Flop (didn't bet)
Seat 2: EYENOGOOD4U (button) folded before Flop (didn't bet)
Seat 3: goofnewf616 (small blind) showed [4s 7d] and lost with a pair o=
f Threes
Seat 5: SMUTJAN72 (big blind) showed [Qh Ts] and won ($0.08) with a pai=
r of Threes
Seat 6: tetro54 folded before Flop (didn't bet)
Seat 7: the_wickstar folded before Flop (didn't bet)
Seat 9: jginebra55 folded before Flop (didn't bet)


*********** # 96 **************
PokerStars Hand #169697834965:  Hold'em No Limit ($0.01/$0.02 USD) - 20=
17/04/29 11:40:16 CUST [2017/04/28 21:40:16 ET]
Table 'Antilia' 9-max Seat #9 is the button
Seat 1: Veraz147 ($2 in chips)=20
Seat 2: the_wickstar ($1.78 in chips)=20
Seat 3: diment76 ($1.95 in chips)=20
Seat 4: agapee92 ($2.39 in chips)=20
Seat 5: ErdgofrGG ($2.24 in chips)=20
Seat 6: themarfs ($2.19 in chips)=20
Seat 7: vini374 ($1.46 in chips)=20
Seat 9: flyperety ($2.29 in chips)=20
Veraz147: posts small blind $0.01
the_wickstar: posts big blind $0.02
shirleypo503: sits out=20
*** HOLE CARDS ***
Dealt to the_wickstar [Ad 5d]
diment76: folds=20
agapee92: folds=20
ErdgofrGG: folds=20
themarfs: folds=20
vini374: folds=20
flyperety: folds=20
Veraz147: raises $0.03 to $0.05
the_wickstar: folds=20
Uncalled bet ($0.03) returned to Veraz147
Veraz147 collected $0.04 from pot
Veraz147: doesn't show hand=20
*** SUMMARY ***
Total pot $0.04 | Rake $0=20
Seat 1: Veraz147 (small blind) collected ($0.04)
Seat 2: the_wickstar (big blind) folded before Flop
Seat 3: diment76 folded before Flop (didn't bet)
Seat 4: agapee92 folded before Flop (didn't bet)
Seat 5: ErdgofrGG folded before Flop (didn't bet)
Seat 6: themarfs folded before Flop (didn't bet)
Seat 7: vini374 folded before Flop (didn't bet)
Seat 9: flyperety (button) folded before Flop (didn't bet)


*********** # 97 **************
PokerStars Hand #169697821829:  Hold'em No Limit ($0.01/$0.02 USD) - 20=
17/04/29 11:39:45 CUST [2017/04/28 21:39:45 ET]
Table 'Antilia' 9-max Seat #7 is the button
Seat 1: Veraz147 ($2 in chips)=20
Seat 2: the_wickstar ($1.78 in chips)=20
Seat 3: diment76 ($1.95 in chips)=20
Seat 4: agapee92 ($2.36 in chips)=20
Seat 5: ErdgofrGG ($2.24 in chips)=20
Seat 6: themarfs ($2.19 in chips)=20
Seat 7: vini374 ($1.46 in chips)=20
Seat 9: flyperety ($2.30 in chips)=20
shirleypo503 will be allowed to play after the button
flyperety: posts small blind $0.01
Veraz147: posts big blind $0.02
*** HOLE CARDS ***
Dealt to the_wickstar [Jc 5d]
the_wickstar: folds=20
diment76: folds=20
agapee92: raises $0.04 to $0.06
ErdgofrGG: folds=20
themarfs: folds=20
vini374: folds=20
flyperety: folds=20
Veraz147: folds=20
Uncalled bet ($0.04) returned to agapee92
agapee92 collected $0.05 from pot
agapee92: doesn't show hand=20
*** SUMMARY ***
Total pot $0.05 | Rake $0=20
Seat 1: Veraz147 (big blind) folded before Flop
Seat 2: the_wickstar folded before Flop (didn't bet)
Seat 3: diment76 folded before Flop (didn't bet)
Seat 4: agapee92 collected ($0.05)
Seat 5: ErdgofrGG folded before Flop (didn't bet)
Seat 6: themarfs folded before Flop (didn't bet)
Seat 7: vini374 (button) folded before Flop (didn't bet)
Seat 9: flyperety (small blind) folded before Flop


*********** # 98 **************
PokerStars Hand #169697805083:  Hold'em No Limit ($0.01/$0.02 USD) - 20=
17/04/29 11:39:06 CUST [2017/04/28 21:39:06 ET]
Table 'Antilia' 9-max Seat #6 is the button
Seat 1: Veraz147 ($2 in chips)=20
Seat 2: the_wickstar ($1.78 in chips)=20
Seat 3: diment76 ($1.95 in chips)=20
Seat 4: agapee92 ($2.36 in chips)=20
Seat 5: ErdgofrGG ($2.24 in chips)=20
Seat 6: themarfs ($2.19 in chips)=20
Seat 7: vini374 ($1.47 in chips)=20
Seat 9: flyperety ($2.29 in chips)=20
vini374: posts small blind $0.01
flyperety: posts big blind $0.02
*** HOLE CARDS ***
Dealt to the_wickstar [7c Ks]
Veraz147: folds=20
shirleypo503 joins the table at seat #8=20
the_wickstar: folds=20
diment76: folds=20
agapee92: folds=20
ErdgofrGG: folds=20
themarfs: folds=20
vini374: folds=20
Uncalled bet ($0.01) returned to flyperety
flyperety collected $0.02 from pot
flyperety: doesn't show hand=20
*** SUMMARY ***
Total pot $0.02 | Rake $0=20
Seat 1: Veraz147 folded before Flop (didn't bet)
Seat 2: the_wickstar folded before Flop (didn't bet)
Seat 3: diment76 folded before Flop (didn't bet)
Seat 4: agapee92 folded before Flop (didn't bet)
Seat 5: ErdgofrGG folded before Flop (didn't bet)
Seat 6: themarfs (button) folded before Flop (didn't bet)
Seat 7: vini374 (small blind) folded before Flop
Seat 9: flyperety (big blind) collected ($0.02)


*********** # 99 **************
PokerStars Hand #169697799882:  Hold'em No Limit ($0.01/$0.02 USD) - 20=
17/04/29 11:38:53 CUST [2017/04/28 21:38:53 ET]
Table 'Wilkens' 9-max Seat #1 is the button
Seat 1: LAILAH M ($2.03 in chips)=20
Seat 2: EYENOGOOD4U ($1.80 in chips)=20
Seat 3: goofnewf616 ($2.08 in chips)=20
Seat 5: SMUTJAN72 ($1.91 in chips)=20
Seat 6: tetro54 ($2.29 in chips)=20
Seat 7: the_wickstar ($1.94 in chips)=20
Seat 9: jginebra55 ($1.63 in chips)=20
EYENOGOOD4U: posts small blind $0.01
goofnewf616: posts big blind $0.02
AldSantalo: sits out=20
*** HOLE CARDS ***
Dealt to the_wickstar [Tc 7h]
goofnewf616 said, "haha"
SMUTJAN72: folds=20
tetro54: folds=20
the_wickstar: folds=20
jginebra55: folds=20
LAILAH M: folds=20
EYENOGOOD4U: raises $0.02 to $0.04
goofnewf616: calls $0.02
*** FLOP *** [6c 7c Th]
EYENOGOOD4U: checks=20
goofnewf616: checks=20
*** TURN *** [6c 7c Th] [2h]
EYENOGOOD4U: checks=20
goofnewf616 said, "need 8 for straight"
goofnewf616: checks=20
*** RIVER *** [6c 7c Th 2h] [5s]
EYENOGOOD4U: checks=20
goofnewf616: checks=20
*** SHOW DOWN ***
EYENOGOOD4U: shows [Js Kd] (high card King)
goofnewf616: shows [9d 5h] (a pair of Fives)
goofnewf616 collected $0.08 from pot
*** SUMMARY ***
Total pot $0.08 | Rake $0=20
Board [6c 7c Th 2h 5s]
Seat 1: LAILAH M (button) folded before Flop (didn't bet)
Seat 2: EYENOGOOD4U (small blind) showed [Js Kd] and lost with high car=
d King
Seat 3: goofnewf616 (big blind) showed [9d 5h] and won ($0.08) with a p=
air of Fives
Seat 5: SMUTJAN72 folded before Flop (didn't bet)
Seat 6: tetro54 folded before Flop (didn't bet)
Seat 7: the_wickstar folded before Flop (didn't bet)
Seat 9: jginebra55 folded before Flop (didn't bet)


*********** # 100 **************
PokerStars Hand #169697777841:  Hold'em No Limit ($0.01/$0.02 USD) - 20=
17/04/29 11:38:02 CUST [2017/04/28 21:38:02 ET]
Table 'Antilia' 9-max Seat #5 is the button
Seat 1: Veraz147 ($2 in chips)=20
Seat 2: the_wickstar ($1.78 in chips)=20
Seat 3: diment76 ($1.97 in chips)=20
Seat 4: agapee92 ($2.36 in chips)=20
Seat 5: ErdgofrGG ($2.24 in chips)=20
Seat 6: themarfs ($2.20 in chips)=20
Seat 7: vini374 ($1.44 in chips)=20
Seat 8: Fezinhu11 ($0.85 in chips)=20
Seat 9: flyperety ($2.29 in chips)=20
themarfs: posts small blind $0.01
vini374: posts big blind $0.02
*** HOLE CARDS ***
Dealt to the_wickstar [5s Th]
Fezinhu11: folds=20
flyperety: folds=20
Veraz147: folds=20
the_wickstar: folds=20
diment76: calls $0.02
agapee92: folds=20
ErdgofrGG: folds=20
themarfs: folds=20
vini374: checks=20
*** FLOP *** [Tc 3d Qh]
vini374: checks=20
diment76: checks=20
*** TURN *** [Tc 3d Qh] [4c]
vini374: checks=20
diment76: checks=20
*** RIVER *** [Tc 3d Qh 4c] [Ks]
Fezinhu11 leaves the table
vini374: checks=20
diment76: checks=20
*** SHOW DOWN ***
vini374: shows [7c 3s] (a pair of Threes)
diment76: mucks hand=20
vini374 collected $0.05 from pot
*** SUMMARY ***
Total pot $0.05 | Rake $0=20
Board [Tc 3d Qh 4c Ks]
Seat 1: Veraz147 folded before Flop (didn't bet)
Seat 2: the_wickstar folded before Flop (didn't bet)
Seat 3: diment76 mucked [6c Ac]
Seat 4: agapee92 folded before Flop (didn't bet)
Seat 5: ErdgofrGG (button) folded before Flop (didn't bet)
Seat 6: themarfs (small blind) folded before Flop
Seat 7: vini374 (big blind) showed [7c 3s] and won ($0.05) with a pair =
of Threes
Seat 8: Fezinhu11 folded before Flop (didn't bet)
Seat 9: flyperety folded before Flop (didn't bet)


*********** # 101 **************
PokerStars Hand #169697767132:  Hold'em No Limit ($0.01/$0.02 USD) - 20=
17/04/29 11:37:37 CUST [2017/04/28 21:37:37 ET]
Table 'Wilkens' 9-max Seat #9 is the button
Seat 1: LAILAH M ($2.04 in chips)=20
Seat 2: EYENOGOOD4U ($1.82 in chips)=20
Seat 3: goofnewf616 ($2.44 in chips)=20
Seat 5: SMUTJAN72 ($1.55 in chips)=20
Seat 6: tetro54 ($2.29 in chips)=20
Seat 7: the_wickstar ($1.94 in chips)=20
Seat 9: jginebra55 ($1.63 in chips)=20
LAILAH M: posts small blind $0.01
EYENOGOOD4U: posts big blind $0.02
AldSantalo: sits out=20
*** HOLE CARDS ***
Dealt to the_wickstar [4c Js]
goofnewf616 said, "told you"
goofnewf616: calls $0.02
SMUTJAN72: raises $0.06 to $0.08
jginebra55 said, "..."
tetro54: folds=20
the_wickstar: folds=20
jginebra55: folds=20
LAILAH M: folds=20
EYENOGOOD4U: folds=20
goofnewf616: calls $0.06
*** FLOP *** [4h 6d 7h]
goofnewf616: checks=20
SMUTJAN72: bets $0.08
goofnewf616: calls $0.08
*** TURN *** [4h 6d 7h] [4s]
goofnewf616: checks=20
SMUTJAN72: bets $0.20
goofnewf616: calls $0.20
*** RIVER *** [4h 6d 7h 4s] [As]
goofnewf616 said, "flushfull house"
goofnewf616: checks=20
SMUTJAN72: checks=20
*** SHOW DOWN ***
goofnewf616: shows [2h 3h] (a pair of Fours)
SMUTJAN72: shows [Qs Qc] (two pair, Queens and Fours)
SMUTJAN72 collected $0.72 from pot
*** SUMMARY ***
Total pot $0.75 | Rake $0.03=20
Board [4h 6d 7h 4s As]
Seat 1: LAILAH M (small blind) folded before Flop
Seat 2: EYENOGOOD4U (big blind) folded before Flop
Seat 3: goofnewf616 showed [2h 3h] and lost with a pair of Fours
Seat 5: SMUTJAN72 showed [Qs Qc] and won ($0.72) with two pair, Queens =
and Fours
Seat 6: tetro54 folded before Flop (didn't bet)
Seat 7: the_wickstar folded before Flop (didn't bet)
Seat 9: jginebra55 (button) folded before Flop (didn't bet)


*********** # 102 **************
PokerStars Hand #169697737831:  Hold'em No Limit ($0.01/$0.02 USD) - 20=
17/04/29 11:36:28 CUST [2017/04/28 21:36:28 ET]
Table 'Wilkens' 9-max Seat #7 is the button
Seat 1: LAILAH M ($2.06 in chips)=20
Seat 2: EYENOGOOD4U ($1.82 in chips)=20
Seat 3: goofnewf616 ($2.20 in chips)=20
Seat 5: SMUTJAN72 ($1.55 in chips)=20
Seat 6: tetro54 ($2.29 in chips)=20
Seat 7: the_wickstar ($1.94 in chips)=20
Seat 9: jginebra55 ($1.87 in chips)=20
AldSantalo will be allowed to play after the button
jginebra55: posts small blind $0.01
LAILAH M: posts big blind $0.02
*** HOLE CARDS ***
Dealt to the_wickstar [Tc 7d]
EYENOGOOD4U: folds=20
goofnewf616: calls $0.02
SMUTJAN72: folds=20
tetro54: folds=20
goofnewf616 said, "2 k"
the_wickstar: folds=20
jginebra55: raises $0.04 to $0.06
LAILAH M: folds=20
goofnewf616 said, "tell you what i have"
goofnewf616: calls $0.04
*** FLOP *** [Ac 6s Kc]
goofnewf616 said, "wow"
jginebra55: bets $0.08
goofnewf616 said, "you have a"
goofnewf616: calls $0.08
*** TURN *** [Ac 6s Kc] [5s]
goofnewf616 said, "all in"
jginebra55: checks=20
goofnewf616: checks=20
*** RIVER *** [Ac 6s Kc 5s] [9d]
jginebra55: bets $0.10
goofnewf616: calls $0.10
*** SHOW DOWN ***
jginebra55: shows [Jd Jh] (a pair of Jacks)
goofnewf616: shows [2c Kd] (a pair of Kings)
goofnewf616 collected $0.48 from pot
*** SUMMARY ***
Total pot $0.50 | Rake $0.02=20
Board [Ac 6s Kc 5s 9d]
Seat 1: LAILAH M (big blind) folded before Flop
Seat 2: EYENOGOOD4U folded before Flop (didn't bet)
Seat 3: goofnewf616 showed [2c Kd] and won ($0.48) with a pair of Kings
Seat 5: SMUTJAN72 folded before Flop (didn't bet)
Seat 6: tetro54 folded before Flop (didn't bet)
Seat 7: the_wickstar (button) folded before Flop (didn't bet)
Seat 9: jginebra55 (small blind) showed [Jd Jh] and lost with a pair of=
 Jacks


*********** # 103 **************
PokerStars Hand #169697735036:  Hold'em No Limit ($0.01/$0.02 USD) - 20=
17/04/29 11:36:22 CUST [2017/04/28 21:36:22 ET]
Table 'Antilia' 9-max Seat #4 is the button
Seat 1: Veraz147 ($2 in chips)=20
Seat 2: the_wickstar ($1.78 in chips)=20
Seat 3: diment76 ($1.97 in chips)=20
Seat 4: agapee92 ($2 in chips)=20
Seat 5: ErdgofrGG ($2.32 in chips)=20
Seat 6: themarfs ($2.22 in chips)=20
Seat 7: vini374 ($1.46 in chips)=20
Seat 8: Fezinhu11 ($0.85 in chips)=20
Seat 9: flyperety ($2.29 in chips)=20
ErdgofrGG: posts small blind $0.01
themarfs: posts big blind $0.02
*** HOLE CARDS ***
Dealt to the_wickstar [4s 3d]
vini374: calls $0.02
Fezinhu11: folds=20
flyperety: folds=20
Veraz147: raises $0.06 to $0.08
the_wickstar: folds=20
diment76: folds=20
agapee92: calls $0.08
ErdgofrGG: calls $0.07
themarfs: folds=20
vini374: folds=20
*** FLOP *** [5h 7s Jc]
ErdgofrGG: checks=20
Veraz147: checks=20
agapee92: checks=20
*** TURN *** [5h 7s Jc] [4h]
ErdgofrGG: checks=20
Veraz147: bets $0.18
agapee92: calls $0.18
ErdgofrGG: folds=20
*** RIVER *** [5h 7s Jc 4h] [8s]
Veraz147: checks=20
agapee92: bets $0.31
Veraz147: folds=20
Uncalled bet ($0.31) returned to agapee92
agapee92 collected $0.62 from pot
agapee92: doesn't show hand=20
*** SUMMARY ***
Total pot $0.64 | Rake $0.02=20
Board [5h 7s Jc 4h 8s]
Seat 1: Veraz147 folded on the River
Seat 2: the_wickstar folded before Flop (didn't bet)
Seat 3: diment76 folded before Flop (didn't bet)
Seat 4: agapee92 (button) collected ($0.62)
Seat 5: ErdgofrGG (small blind) folded on the Turn
Seat 6: themarfs (big blind) folded before Flop
Seat 7: vini374 folded before Flop
Seat 8: Fezinhu11 folded before Flop (didn't bet)
Seat 9: flyperety folded before Flop (didn't bet)


*********** # 104 **************
PokerStars Hand #169697716393:  Hold'em No Limit ($0.01/$0.02 USD) - 20=
17/04/29 11:35:38 CUST [2017/04/28 21:35:38 ET]
Table 'Antilia' 9-max Seat #3 is the button
Seat 1: Veraz147 ($2 in chips)=20
Seat 2: the_wickstar ($1.80 in chips)=20
Seat 3: diment76 ($1.97 in chips)=20
Seat 4: agapee92 ($2 in chips)=20
Seat 5: ErdgofrGG ($2.26 in chips)=20
Seat 6: themarfs ($2.22 in chips)=20
Seat 7: vini374 ($1.48 in chips)=20
Seat 8: Fezinhu11 ($0.85 in chips)=20
Seat 9: flyperety ($2.29 in chips)=20
agapee92: posts small blind $0.01
ErdgofrGG: posts big blind $0.02
*** HOLE CARDS ***
Dealt to the_wickstar [Ks 6c]
themarfs: folds=20
vini374: calls $0.02
Fezinhu11: folds=20
flyperety: folds=20
Veraz147: folds=20
the_wickstar: calls $0.02
diment76: folds=20
agapee92: calls $0.01
ErdgofrGG: raises $2.24 to $2.26 and is all-in
vini374: folds=20
the_wickstar: folds=20
agapee92: folds=20
Uncalled bet ($2.24) returned to ErdgofrGG
ErdgofrGG collected $0.08 from pot
ErdgofrGG: doesn't show hand=20
*** SUMMARY ***
Total pot $0.08 | Rake $0=20
Seat 1: Veraz147 folded before Flop (didn't bet)
Seat 2: the_wickstar folded before Flop
Seat 3: diment76 (button) folded before Flop (didn't bet)
Seat 4: agapee92 (small blind) folded before Flop
Seat 5: ErdgofrGG (big blind) collected ($0.08)
Seat 6: themarfs folded before Flop (didn't bet)
Seat 7: vini374 folded before Flop
Seat 8: Fezinhu11 folded before Flop (didn't bet)
Seat 9: flyperety folded before Flop (didn't bet)


*********** # 105 **************
PokerStars Hand #169697711546:  Hold'em No Limit ($0.01/$0.02 USD) - 20=
17/04/29 11:35:27 CUST [2017/04/28 21:35:27 ET]
Table 'Wilkens' 9-max Seat #6 is the button
Seat 1: LAILAH M ($2.06 in chips)=20
Seat 2: EYENOGOOD4U ($1.88 in chips)=20
Seat 3: goofnewf616 ($2.22 in chips)=20
Seat 5: SMUTJAN72 ($1.55 in chips)=20
Seat 6: tetro54 ($2.29 in chips)=20
Seat 7: the_wickstar ($1.85 in chips)=20
Seat 9: jginebra55 ($1.89 in chips)=20
the_wickstar: posts small blind $0.01
jginebra55: posts big blind $0.02
*** HOLE CARDS ***
Dealt to the_wickstar [4h Kd]
AldSantalo joins the table at seat #8=20
LAILAH M: folds=20
EYENOGOOD4U: calls $0.02
goofnewf616: calls $0.02
SMUTJAN72: folds=20
tetro54: folds=20
the_wickstar: calls $0.01
goofnewf616 said, "i have 10 4"
jginebra55: checks=20
*** FLOP *** [9c 7s Ks]
the_wickstar: bets $0.04
jginebra55: folds=20
EYENOGOOD4U: calls $0.04
goofnewf616: folds=20
*** TURN *** [9c 7s Ks] [2c]
the_wickstar: checks=20
EYENOGOOD4U: checks=20
*** RIVER *** [9c 7s Ks 2c] [2s]
the_wickstar: checks=20
EYENOGOOD4U: checks=20
*** SHOW DOWN ***
the_wickstar: shows [4h Kd] (two pair, Kings and Deuces)
EYENOGOOD4U: mucks hand=20
the_wickstar collected $0.15 from pot
*** SUMMARY ***
Total pot $0.16 | Rake $0.01=20
Board [9c 7s Ks 2c 2s]
Seat 1: LAILAH M folded before Flop (didn't bet)
Seat 2: EYENOGOOD4U mucked [Th Jc]
Seat 3: goofnewf616 folded on the Flop
Seat 5: SMUTJAN72 folded before Flop (didn't bet)
Seat 6: tetro54 (button) folded before Flop (didn't bet)
Seat 7: the_wickstar (small blind) showed [4h Kd] and won ($0.15) with =
two pair, Kings and Deuces
Seat 9: jginebra55 (big blind) folded on the Flop


*********** # 106 **************
PokerStars Hand #169697676598:  Hold'em No Limit ($0.01/$0.02 USD) - 20=
17/04/29 11:34:05 CUST [2017/04/28 21:34:05 ET]
Table 'Antilia' 9-max Seat #2 is the button
Seat 1: Veraz147 ($2 in chips)=20
Seat 2: the_wickstar ($2.06 in chips)=20
Seat 3: diment76 ($1.98 in chips)=20
Seat 4: agapee92 ($2 in chips)=20
Seat 5: ErdgofrGG ($2.26 in chips)=20
Seat 6: themarfs ($2.22 in chips)=20
Seat 7: vini374 ($1.48 in chips)=20
Seat 8: Fezinhu11 ($0.85 in chips)=20
Seat 9: flyperety ($2.02 in chips)=20
diment76: posts small blind $0.01
agapee92: posts big blind $0.02
*** HOLE CARDS ***
Dealt to the_wickstar [Ac Kh]
ErdgofrGG: folds=20
themarfs: folds=20
vini374: folds=20
Fezinhu11: folds=20
flyperety: raises $0.02 to $0.04
Veraz147: folds=20
the_wickstar: raises $0.04 to $0.08
diment76: folds=20
agapee92: folds=20
flyperety: calls $0.04
*** FLOP *** [6c Qc 4d]
flyperety: checks=20
the_wickstar: bets $0.18
flyperety: calls $0.18
*** TURN *** [6c Qc 4d] [8s]
flyperety: checks=20
the_wickstar: checks=20
*** RIVER *** [6c Qc 4d 8s] [Th]
flyperety: checks=20
the_wickstar: checks=20
*** SHOW DOWN ***
flyperety: shows [Jh Jd] (a pair of Jacks)
the_wickstar: mucks hand=20
flyperety collected $0.53 from pot
*** SUMMARY ***
Total pot $0.55 | Rake $0.02=20
Board [6c Qc 4d 8s Th]
Seat 1: Veraz147 folded before Flop (didn't bet)
Seat 2: the_wickstar (button) mucked [Ac Kh]
Seat 3: diment76 (small blind) folded before Flop
Seat 4: agapee92 (big blind) folded before Flop
Seat 5: ErdgofrGG folded before Flop (didn't bet)
Seat 6: themarfs folded before Flop (didn't bet)
Seat 7: vini374 folded before Flop (didn't bet)
Seat 8: Fezinhu11 folded before Flop (didn't bet)
Seat 9: flyperety showed [Jh Jd] and won ($0.53) with a pair of Jacks


*********** # 107 **************
PokerStars Hand #169697667493:  Hold'em No Limit ($0.01/$0.02 USD) - 20=
17/04/29 11:33:44 CUST [2017/04/28 21:33:44 ET]
Table 'Wilkens' 9-max Seat #5 is the button
Seat 1: LAILAH M ($2.06 in chips)=20
Seat 2: EYENOGOOD4U ($1.92 in chips)=20
Seat 3: goofnewf616 ($2.12 in chips)=20
Seat 5: SMUTJAN72 ($1.57 in chips)=20
Seat 6: tetro54 ($2.31 in chips)=20
Seat 7: the_wickstar ($1.87 in chips)=20
Seat 9: jginebra55 ($1.89 in chips)=20
tetro54: posts small blind $0.01
the_wickstar: posts big blind $0.02
*** HOLE CARDS ***
Dealt to the_wickstar [7s 2s]
jginebra55: folds=20
LAILAH M: folds=20
EYENOGOOD4U: calls $0.02
goofnewf616: calls $0.02
SMUTJAN72: calls $0.02
LAILAH M said, "who?"
tetro54: calls $0.01
the_wickstar: checks=20
*** FLOP *** [Qd Qc 4h]
tetro54: checks=20
the_wickstar: checks=20
EYENOGOOD4U: checks=20
goofnewf616: checks=20
SMUTJAN72: checks=20
*** TURN *** [Qd Qc 4h] [3s]
goofnewf616 said, "tetro only play if have good cards"
tetro54: checks=20
the_wickstar: checks=20
EYENOGOOD4U: checks=20
goofnewf616: checks=20
SMUTJAN72: checks=20
*** RIVER *** [Qd Qc 4h 3s] [6d]
tetro54: checks=20
the_wickstar: checks=20
EYENOGOOD4U: checks=20
goofnewf616: bets $0.02
SMUTJAN72: folds=20
tetro54: folds=20
goofnewf616 said, "no bluff"
the_wickstar: folds=20
FISH2236 leaves the table
EYENOGOOD4U: calls $0.02
*** SHOW DOWN ***
goofnewf616: shows [6h Kc] (two pair, Queens and Sixes)
EYENOGOOD4U: mucks hand=20
goofnewf616 collected $0.14 from pot
*** SUMMARY ***
Total pot $0.14 | Rake $0=20
Board [Qd Qc 4h 3s 6d]
Seat 1: LAILAH M folded before Flop (didn't bet)
Seat 2: EYENOGOOD4U mucked [Ah 5h]
Seat 3: goofnewf616 showed [6h Kc] and won ($0.14) with two pair, Queen=
s and Sixes
Seat 5: SMUTJAN72 (button) folded on the River
Seat 6: tetro54 (small blind) folded on the River
Seat 7: the_wickstar (big blind) folded on the River
Seat 9: jginebra55 folded before Flop (didn't bet)


*********** # 108 **************
PokerStars Hand #169697638587:  Hold'em No Limit ($0.01/$0.02 USD) - 20=
17/04/29 11:32:48 CUST [2017/04/28 21:32:48 ET]
Table 'Antilia' 9-max Seat #1 is the button
Seat 1: Veraz147 ($2 in chips)=20
Seat 2: the_wickstar ($2.08 in chips)=20
Seat 3: diment76 ($2 in chips)=20
Seat 4: agapee92 ($2 in chips)=20
Seat 5: ErdgofrGG ($2.26 in chips)=20
Seat 6: themarfs ($2.22 in chips)=20
Seat 7: vini374 ($1.44 in chips)=20
Seat 8: Fezinhu11 ($0.85 in chips)=20
Seat 9: flyperety ($2.02 in chips)=20
the_wickstar: posts small blind $0.01
diment76: posts big blind $0.02
vini374: posts small & big blinds $0.03
*** HOLE CARDS ***
Dealt to the_wickstar [7s Ac]
agapee92: folds=20
ErdgofrGG: folds=20
themarfs: folds=20
vini374: checks=20
Fezinhu11: folds=20
flyperety: folds=20
Veraz147: folds=20
the_wickstar: calls $0.01
diment76: checks=20
*** FLOP *** [2c Ks Qc]
the_wickstar: checks=20
diment76: checks=20
vini374: bets $0.07
the_wickstar: folds=20
diment76: folds=20
Uncalled bet ($0.07) returned to vini374
vini374 collected $0.07 from pot
*** SUMMARY ***
Total pot $0.07 | Rake $0=20
Board [2c Ks Qc]
Seat 1: Veraz147 (button) folded before Flop (didn't bet)
Seat 2: the_wickstar (small blind) folded on the Flop
Seat 3: diment76 (big blind) folded on the Flop
Seat 4: agapee92 folded before Flop (didn't bet)
Seat 5: ErdgofrGG folded before Flop (didn't bet)
Seat 6: themarfs folded before Flop (didn't bet)
Seat 7: vini374 collected ($0.07)
Seat 8: Fezinhu11 folded before Flop (didn't bet)
Seat 9: flyperety folded before Flop (didn't bet)


*********** # 109 **************
PokerStars Hand #169697614321:  Hold'em No Limit ($0.01/$0.02 USD) - 20=
17/04/29 11:31:52 CUST [2017/04/28 21:31:52 ET]
Table 'Wilkens' 9-max Seat #3 is the button
Seat 1: LAILAH M ($2.06 in chips)=20
Seat 2: EYENOGOOD4U ($1.92 in chips)=20
Seat 3: goofnewf616 ($2.14 in chips)=20
Seat 5: SMUTJAN72 ($1.58 in chips)=20
Seat 6: tetro54 ($2.28 in chips)=20
Seat 7: the_wickstar ($1.87 in chips)=20
Seat 9: jginebra55 ($1.89 in chips)=20
SMUTJAN72: posts small blind $0.01
tetro54: posts big blind $0.02
*** HOLE CARDS ***
Dealt to the_wickstar [4s 9s]
the_wickstar: folds=20
jginebra55: folds=20
LAILAH M: folds=20
EYENOGOOD4U: folds=20
goofnewf616: calls $0.02
SMUTJAN72: folds=20
tetro54: checks=20
*** FLOP *** [8s Th 4c]
tetro54: checks=20
goofnewf616: checks=20
*** TURN *** [8s Th 4c] [4h]
tetro54: checks=20
goofnewf616: checks=20
*** RIVER *** [8s Th 4c 4h] [Ad]
goofnewf616 said, "just letting you guys know i bluff alot but not all =
the time"
tetro54: bets $1.06
goofnewf616: folds=20
Uncalled bet ($1.06) returned to tetro54
tetro54 collected $0.05 from pot
goofnewf616 said, "bluff 70 percent"
*** SUMMARY ***
Total pot $0.05 | Rake $0=20
Board [8s Th 4c 4h Ad]
Seat 1: LAILAH M folded before Flop (didn't bet)
Seat 2: EYENOGOOD4U folded before Flop (didn't bet)
Seat 3: goofnewf616 (button) folded on the River
Seat 5: SMUTJAN72 (small blind) folded before Flop
Seat 6: tetro54 (big blind) collected ($0.05)
Seat 7: the_wickstar folded before Flop (didn't bet)
Seat 9: jginebra55 folded before Flop (didn't bet)


*********** # 110 **************
PokerStars Hand #169697602978:  Hold'em No Limit ($0.01/$0.02 USD) - 20=
17/04/29 11:31:26 CUST [2017/04/28 21:31:26 ET]
Table 'Antilia' 9-max Seat #9 is the button
Seat 1: Veraz147 ($2 in chips)=20
Seat 2: the_wickstar ($2.14 in chips)=20
Seat 4: agapee92 ($2 in chips)=20
Seat 5: ErdgofrGG ($2.26 in chips)=20
Seat 6: themarfs ($2.22 in chips)=20
Seat 8: Fezinhu11 ($0.77 in chips)=20
Seat 9: flyperety ($2.02 in chips)=20
Veraz147: posts small blind $0.01
the_wickstar: posts big blind $0.02
diment76: sits out=20
*** HOLE CARDS ***
Dealt to the_wickstar [Ac 4d]
agapee92: folds=20
ErdgofrGG: folds=20
themarfs: folds=20
Fezinhu11: calls $0.02
flyperety: folds=20
Veraz147: calls $0.01
the_wickstar: checks=20
*** FLOP *** [Td Kd 9s]
Veraz147: checks=20
the_wickstar: checks=20
Fezinhu11: checks=20
*** TURN *** [Td Kd 9s] [Kc]
Veraz147: checks=20
the_wickstar: bets $0.04
Fezinhu11: calls $0.04
Veraz147: folds=20
*** RIVER *** [Td Kd 9s Kc] [8c]
the_wickstar: checks=20
Fezinhu11: bets $0.22
the_wickstar: folds=20
Uncalled bet ($0.22) returned to Fezinhu11
Fezinhu11 collected $0.14 from pot
Fezinhu11: doesn't show hand=20
*** SUMMARY ***
Total pot $0.14 | Rake $0=20
Board [Td Kd 9s Kc 8c]
Seat 1: Veraz147 (small blind) folded on the Turn
Seat 2: the_wickstar (big blind) folded on the River
Seat 4: agapee92 folded before Flop (didn't bet)
Seat 5: ErdgofrGG folded before Flop (didn't bet)
Seat 6: themarfs folded before Flop (didn't bet)
Seat 8: Fezinhu11 collected ($0.14)
Seat 9: flyperety (button) folded before Flop (didn't bet)


*********** # 111 **************
PokerStars Hand #169697598715:  Hold'em No Limit ($0.01/$0.02 USD) - 20=
17/04/29 11:31:16 CUST [2017/04/28 21:31:16 ET]
Table 'Wilkens' 9-max Seat #2 is the button
Seat 1: LAILAH M ($2.06 in chips)=20
Seat 2: EYENOGOOD4U ($1.92 in chips)=20
Seat 3: goofnewf616 ($2.06 in chips)=20
Seat 5: SMUTJAN72 ($1.60 in chips)=20
Seat 6: tetro54 ($2.34 in chips)=20
Seat 7: the_wickstar ($1.87 in chips)=20
Seat 9: jginebra55 ($1.89 in chips)=20
goofnewf616: posts small blind $0.01
SMUTJAN72: posts big blind $0.02
*** HOLE CARDS ***
Dealt to the_wickstar [2d Ac]
tetro54: raises $0.04 to $0.06
the_wickstar: folds=20
jginebra55: folds=20
LAILAH M: folds=20
EYENOGOOD4U: folds=20
goofnewf616: calls $0.05
SMUTJAN72: folds=20
*** FLOP *** [3h Ks Ah]
goofnewf616: checks=20
tetro54: checks=20
*** TURN *** [3h Ks Ah] [Qh]
goofnewf616: bets $0.06
tetro54: folds=20
Uncalled bet ($0.06) returned to goofnewf616
goofnewf616 collected $0.14 from pot
goofnewf616: doesn't show hand=20
*** SUMMARY ***
Total pot $0.14 | Rake $0=20
Board [3h Ks Ah Qh]
Seat 1: LAILAH M folded before Flop (didn't bet)
Seat 2: EYENOGOOD4U (button) folded before Flop (didn't bet)
Seat 3: goofnewf616 (small blind) collected ($0.14)
Seat 5: SMUTJAN72 (big blind) folded before Flop
Seat 6: tetro54 folded on the Turn
Seat 7: the_wickstar folded before Flop (didn't bet)
Seat 9: jginebra55 folded before Flop (didn't bet)


*********** # 112 **************
PokerStars Hand #169697591060:  Hold'em No Limit ($0.01/$0.02 USD) - 20=
17/04/29 11:30:59 CUST [2017/04/28 21:30:59 ET]
Table 'Antilia' 9-max Seat #8 is the button
Seat 1: Veraz147 ($2 in chips)=20
Seat 2: the_wickstar ($2.14 in chips)=20
Seat 4: agapee92 ($2 in chips)=20
Seat 5: ErdgofrGG ($2.26 in chips)=20
Seat 6: themarfs ($2.22 in chips)=20
Seat 8: Fezinhu11 ($0.77 in chips)=20
Seat 9: flyperety ($2 in chips)=20
flyperety: posts small blind $0.01
Veraz147: posts big blind $0.02
diment76: sits out=20
*** HOLE CARDS ***
Dealt to the_wickstar [9d Jc]
the_wickstar: folds=20
agapee92: folds=20
ErdgofrGG: folds=20
themarfs: folds=20
Fezinhu11: folds=20
flyperety: raises $0.02 to $0.04
Veraz147: folds=20
Uncalled bet ($0.02) returned to flyperety
flyperety collected $0.04 from pot
flyperety: doesn't show hand=20
*** SUMMARY ***
Total pot $0.04 | Rake $0=20
Seat 1: Veraz147 (big blind) folded before Flop
Seat 2: the_wickstar folded before Flop (didn't bet)
Seat 4: agapee92 folded before Flop (didn't bet)
Seat 5: ErdgofrGG folded before Flop (didn't bet)
Seat 6: themarfs folded before Flop (didn't bet)
Seat 8: Fezinhu11 (button) folded before Flop (didn't bet)
Seat 9: flyperety (small blind) collected ($0.04)


*********** # 113 **************
PokerStars Hand #169697578788:  Hold'em No Limit ($0.01/$0.02 USD) - 20=
17/04/29 11:30:31 CUST [2017/04/28 21:30:31 ET]
Table 'Wilkens' 9-max Seat #1 is the button
Seat 1: LAILAH M ($2.06 in chips)=20
Seat 2: EYENOGOOD4U ($1.93 in chips)=20
Seat 3: goofnewf616 ($1.93 in chips)=20
Seat 6: tetro54 ($2.34 in chips)=20
Seat 7: the_wickstar ($1.87 in chips)=20
Seat 9: jginebra55 ($2.02 in chips)=20
EYENOGOOD4U: posts small blind $0.01
goofnewf616: posts big blind $0.02
SMUTJAN72: sits out=20
*** HOLE CARDS ***
Dealt to the_wickstar [3d Ks]
tetro54: folds=20
the_wickstar: folds=20
jginebra55: raises $0.04 to $0.06
LAILAH M: folds=20
EYENOGOOD4U: folds=20
goofnewf616: calls $0.04
*** FLOP *** [Jd 2c 5h]
goofnewf616: checks=20
jginebra55: bets $0.07
goofnewf616: calls $0.07
*** TURN *** [Jd 2c 5h] [6d]
goofnewf616: checks=20
jginebra55: checks=20
*** RIVER *** [Jd 2c 5h 6d] [Qd]
goofnewf616: bets $0.24
jginebra55: folds=20
Uncalled bet ($0.24) returned to goofnewf616
goofnewf616 collected $0.26 from pot
goofnewf616: doesn't show hand=20
*** SUMMARY ***
Total pot $0.27 | Rake $0.01=20
Board [Jd 2c 5h 6d Qd]
Seat 1: LAILAH M (button) folded before Flop (didn't bet)
Seat 2: EYENOGOOD4U (small blind) folded before Flop
Seat 3: goofnewf616 (big blind) collected ($0.26)
Seat 6: tetro54 folded before Flop (didn't bet)
Seat 7: the_wickstar folded before Flop (didn't bet)
Seat 9: jginebra55 folded on the River


*********** # 114 **************
PokerStars Hand #169697576870:  Hold'em No Limit ($0.01/$0.02 USD) - 20=
17/04/29 11:30:26 CUST [2017/04/28 21:30:26 ET]
Table 'Antilia' 9-max Seat #6 is the button
Seat 1: Veraz147 ($2 in chips)=20
Seat 2: the_wickstar ($2.14 in chips)=20
Seat 4: agapee92 ($2 in chips)=20
Seat 5: ErdgofrGG ($2.26 in chips)=20
Seat 6: themarfs ($2.19 in chips)=20
Seat 8: Fezinhu11 ($0.78 in chips)=20
Seat 9: flyperety ($2 in chips)=20
Fezinhu11: posts small blind $0.01
flyperety: posts big blind $0.02
diment76: sits out=20
*** HOLE CARDS ***
Dealt to the_wickstar [Qd 7c]
Veraz147: folds=20
the_wickstar: folds=20
agapee92: folds=20
ErdgofrGG: folds=20
themarfs: raises $0.04 to $0.06
Fezinhu11: folds=20
flyperety: folds=20
Uncalled bet ($0.04) returned to themarfs
themarfs collected $0.05 from pot
themarfs: doesn't show hand=20
*** SUMMARY ***
Total pot $0.05 | Rake $0=20
Seat 1: Veraz147 folded before Flop (didn't bet)
Seat 2: the_wickstar folded before Flop (didn't bet)
Seat 4: agapee92 folded before Flop (didn't bet)
Seat 5: ErdgofrGG folded before Flop (didn't bet)
Seat 6: themarfs (button) collected ($0.05)
Seat 8: Fezinhu11 (small blind) folded before Flop
Seat 9: flyperety (big blind) folded before Flop


*********** # 115 **************
PokerStars Hand #169697567083:  Hold'em No Limit ($0.01/$0.02 USD) - 20=
17/04/29 11:30:03 CUST [2017/04/28 21:30:03 ET]
Table 'Wilkens' 9-max Seat #9 is the button
Seat 1: LAILAH M ($2.07 in chips)=20
Seat 2: EYENOGOOD4U ($1.95 in chips)=20
Seat 3: goofnewf616 ($1.90 in chips)=20
Seat 6: tetro54 ($2.34 in chips)=20
Seat 7: the_wickstar ($1.87 in chips)=20
Seat 9: jginebra55 ($2.02 in chips)=20
LAILAH M: posts small blind $0.01
EYENOGOOD4U: posts big blind $0.02
SMUTJAN72: sits out=20
*** HOLE CARDS ***
Dealt to the_wickstar [6h 9c]
goofnewf616: raises $0.08 to $0.10
tetro54: folds=20
the_wickstar: folds=20
jginebra55: folds=20
LAILAH M: folds=20
EYENOGOOD4U: folds=20
Uncalled bet ($0.08) returned to goofnewf616
goofnewf616 collected $0.05 from pot
goofnewf616: doesn't show hand=20
*** SUMMARY ***
Total pot $0.05 | Rake $0=20
Seat 1: LAILAH M (small blind) folded before Flop
Seat 2: EYENOGOOD4U (big blind) folded before Flop
Seat 3: goofnewf616 collected ($0.05)
Seat 6: tetro54 folded before Flop (didn't bet)
Seat 7: the_wickstar folded before Flop (didn't bet)
Seat 9: jginebra55 (button) folded before Flop (didn't bet)


*********** # 116 **************
PokerStars Hand #169697557283:  Hold'em No Limit ($0.01/$0.02 USD) - 20=
17/04/29 11:29:41 CUST [2017/04/28 21:29:41 ET]
Table 'Antilia' 9-max Seat #5 is the button
Seat 1: Veraz147 ($2 in chips)=20
Seat 2: the_wickstar ($2.14 in chips)=20
Seat 4: agapee92 ($2 in chips)=20
Seat 5: ErdgofrGG ($2.11 in chips)=20
Seat 6: themarfs ($2.20 in chips)=20
Seat 8: Fezinhu11 ($0.80 in chips)=20
Seat 9: flyperety ($2 in chips)=20
themarfs: posts small blind $0.01
Fezinhu11: posts big blind $0.02
diment76: sits out=20
*** HOLE CARDS ***
Dealt to the_wickstar [As 3s]
flyperety: folds=20
Veraz147: raises $0.04 to $0.06
the_wickstar: folds=20
agapee92: calls $0.06
ErdgofrGG: raises $0.26 to $0.32
themarfs: folds=20
Fezinhu11: folds=20
Veraz147: folds=20
agapee92: folds=20
Uncalled bet ($0.26) returned to ErdgofrGG
ErdgofrGG collected $0.21 from pot
ErdgofrGG: doesn't show hand=20
*** SUMMARY ***
Total pot $0.21 | Rake $0=20
Seat 1: Veraz147 folded before Flop
Seat 2: the_wickstar folded before Flop (didn't bet)
Seat 4: agapee92 folded before Flop
Seat 5: ErdgofrGG (button) collected ($0.21)
Seat 6: themarfs (small blind) folded before Flop
Seat 8: Fezinhu11 (big blind) folded before Flop
Seat 9: flyperety folded before Flop (didn't bet)


*********** # 117 **************
PokerStars Hand #169697548237:  Hold'em No Limit ($0.01/$0.02 USD) - 20=
17/04/29 11:29:20 CUST [2017/04/28 21:29:20 ET]
Table 'Antilia' 9-max Seat #4 is the button
Seat 1: Veraz147 ($2 in chips)=20
Seat 2: the_wickstar ($2.14 in chips)=20
Seat 4: agapee92 ($2 in chips)=20
Seat 5: ErdgofrGG ($2.12 in chips)=20
Seat 6: themarfs ($2.19 in chips)=20
Seat 9: flyperety ($2 in chips)=20
ErdgofrGG: posts small blind $0.01
themarfs: posts big blind $0.02
Fezinhu11: sits out=20
*** HOLE CARDS ***
Dealt to the_wickstar [6h 7h]
flyperety: folds=20
Veraz147: folds=20
diment76 joins the table at seat #3=20
the_wickstar: folds=20
agapee92: folds=20
ErdgofrGG: folds=20
Uncalled bet ($0.01) returned to themarfs
themarfs collected $0.02 from pot
themarfs: doesn't show hand=20
*** SUMMARY ***
Total pot $0.02 | Rake $0=20
Seat 1: Veraz147 folded before Flop (didn't bet)
Seat 2: the_wickstar folded before Flop (didn't bet)
Seat 4: agapee92 (button) folded before Flop (didn't bet)
Seat 5: ErdgofrGG (small blind) folded before Flop
Seat 6: themarfs (big blind) collected ($0.02)
Seat 9: flyperety folded before Flop (didn't bet)


*********** # 118 **************
PokerStars Hand #169697537524:  Hold'em No Limit ($0.01/$0.02 USD) - 20=
17/04/29 11:28:56 CUST [2017/04/28 21:28:56 ET]
Table 'Antilia' 9-max Seat #3 is the button
Seat 1: Veraz147 ($2 in chips)=20
Seat 2: the_wickstar ($2.14 in chips)=20
Seat 3: boden1211 ($1.15 in chips)=20
Seat 4: agapee92 ($2 in chips)=20
Seat 5: ErdgofrGG ($2.11 in chips)=20
Seat 6: themarfs ($2.19 in chips)=20
Seat 9: flyperety ($2 in chips)=20
agapee92: posts small blind $0.01
ErdgofrGG: posts big blind $0.02
Fezinhu11: sits out=20
*** HOLE CARDS ***
Dealt to the_wickstar [3c 8h]
themarfs: folds=20
flyperety: folds=20
Veraz147: folds=20
the_wickstar: folds=20
boden1211: folds=20
boden1211 leaves the table
agapee92: folds=20
Uncalled bet ($0.01) returned to ErdgofrGG
ErdgofrGG collected $0.02 from pot
ErdgofrGG: doesn't show hand=20
*** SUMMARY ***
Total pot $0.02 | Rake $0=20
Seat 1: Veraz147 folded before Flop (didn't bet)
Seat 2: the_wickstar folded before Flop (didn't bet)
Seat 3: boden1211 (button) folded before Flop (didn't bet)
Seat 4: agapee92 (small blind) folded before Flop
Seat 5: ErdgofrGG (big blind) collected ($0.02)
Seat 6: themarfs folded before Flop (didn't bet)
Seat 9: flyperety folded before Flop (didn't bet)


*********** # 119 **************
PokerStars Hand #169697533182:  Hold'em No Limit ($0.01/$0.02 USD) - 20=
17/04/29 11:28:46 CUST [2017/04/28 21:28:46 ET]
Table 'Wilkens' 9-max Seat #7 is the button
Seat 1: LAILAH M ($2.09 in chips)=20
Seat 2: EYENOGOOD4U ($1.78 in chips)=20
Seat 3: goofnewf616 ($1.97 in chips)=20
Seat 6: tetro54 ($2.34 in chips)=20
Seat 7: the_wickstar ($1.94 in chips)=20
Seat 9: jginebra55 ($2.04 in chips)=20
jginebra55: posts small blind $0.01
LAILAH M: posts big blind $0.02
SMUTJAN72: sits out=20
*** HOLE CARDS ***
Dealt to the_wickstar [2s Ah]
EYENOGOOD4U: calls $0.02
goofnewf616: calls $0.02
tetro54: folds=20
the_wickstar: calls $0.02
jginebra55: calls $0.01
LAILAH M: checks=20
*** FLOP *** [Kd Ks 3h]
jginebra55: checks=20
LAILAH M: checks=20
EYENOGOOD4U: checks=20
goofnewf616: checks=20
the_wickstar: bets $0.05
jginebra55: folds=20
LAILAH M: folds=20
EYENOGOOD4U: calls $0.05
goofnewf616: calls $0.05
*** TURN *** [Kd Ks 3h] [Qh]
EYENOGOOD4U: checks=20
goofnewf616: checks=20
the_wickstar: checks=20
*** RIVER *** [Kd Ks 3h Qh] [8d]
EYENOGOOD4U: bets $0.24
goofnewf616: folds=20
the_wickstar: folds=20
Uncalled bet ($0.24) returned to EYENOGOOD4U
EYENOGOOD4U collected $0.24 from pot
*** SUMMARY ***
Total pot $0.25 | Rake $0.01=20
Board [Kd Ks 3h Qh 8d]
Seat 1: LAILAH M (big blind) folded on the Flop
Seat 2: EYENOGOOD4U collected ($0.24)
Seat 3: goofnewf616 folded on the River
Seat 6: tetro54 folded before Flop (didn't bet)
Seat 7: the_wickstar (button) folded on the River
Seat 9: jginebra55 (small blind) folded on the Flop


*********** # 120 **************
PokerStars Hand #169697506831:  Hold'em No Limit ($0.01/$0.02 USD) - 20=
17/04/29 11:27:46 CUST [2017/04/28 21:27:46 ET]
Table 'Wilkens' 9-max Seat #6 is the button
Seat 1: LAILAH M ($2.11 in chips)=20
Seat 2: EYENOGOOD4U ($1.90 in chips)=20
Seat 3: goofnewf616 ($1.81 in chips)=20
Seat 6: tetro54 ($2.34 in chips)=20
Seat 7: the_wickstar ($1.95 in chips)=20
Seat 9: jginebra55 ($2.06 in chips)=20
the_wickstar: posts small blind $0.01
jginebra55: posts big blind $0.02
SMUTJAN72: sits out=20
*** HOLE CARDS ***
Dealt to the_wickstar [6c Kh]
LAILAH M: calls $0.02
EYENOGOOD4U: calls $0.02
goofnewf616: raises $0.10 to $0.12
goofnewf616 said, "all in"
tetro54: folds=20
the_wickstar: folds=20
jginebra55: folds=20
LAILAH M: folds=20
EYENOGOOD4U: calls $0.10
*** FLOP *** [Qs 4c Ks]
EYENOGOOD4U: checks=20
goofnewf616: checks=20
*** TURN *** [Qs 4c Ks] [Kc]
EYENOGOOD4U: checks=20
goofnewf616: checks=20
*** RIVER *** [Qs 4c Ks Kc] [3c]
EYENOGOOD4U: checks=20
goofnewf616: checks=20
*** SHOW DOWN ***
EYENOGOOD4U: shows [4h Ah] (two pair, Kings and Fours)
goofnewf616: shows [Qd Ac] (two pair, Kings and Queens)
goofnewf616 collected $0.28 from pot
*** SUMMARY ***
Total pot $0.29 | Rake $0.01=20
Board [Qs 4c Ks Kc 3c]
Seat 1: LAILAH M folded before Flop
Seat 2: EYENOGOOD4U showed [4h Ah] and lost with two pair, Kings and Fo=
urs
Seat 3: goofnewf616 showed [Qd Ac] and won ($0.28) with two pair, Kings=
 and Queens
Seat 6: tetro54 (button) folded before Flop (didn't bet)
Seat 7: the_wickstar (small blind) folded before Flop
Seat 9: jginebra55 (big blind) folded before Flop


*********** # 121 **************
PokerStars Hand #169697499812:  Hold'em No Limit ($0.01/$0.02 USD) - 20=
17/04/29 11:27:30 CUST [2017/04/28 21:27:30 ET]
Table 'Antilia' 9-max Seat #2 is the button
Seat 1: Veraz147 ($2 in chips)=20
Seat 2: the_wickstar ($2.20 in chips)=20
Seat 3: boden1211 ($1.07 in chips)=20
Seat 4: agapee92 ($2 in chips)=20
Seat 5: ErdgofrGG ($2.11 in chips)=20
Seat 6: themarfs ($2.19 in chips)=20
Seat 7: vini374 ($1.44 in chips)=20
Seat 9: flyperety ($2 in chips)=20
boden1211: posts small blind $0.01
agapee92: posts big blind $0.02
Fezinhu11: sits out=20
*** HOLE CARDS ***
Dealt to the_wickstar [Jd Ts]
ErdgofrGG: folds=20
themarfs: folds=20
vini374 has timed out
vini374: folds=20
flyperety: folds=20
Veraz147: folds=20
the_wickstar: calls $0.02
boden1211: calls $0.01
agapee92: checks=20
*** FLOP *** [8h Kc 5h]
boden1211: checks=20
agapee92: checks=20
the_wickstar: bets $0.04
boden1211: raises $0.06 to $0.10
agapee92: folds=20
the_wickstar: folds=20
Uncalled bet ($0.06) returned to boden1211
boden1211 collected $0.14 from pot
boden1211: doesn't show hand=20
*** SUMMARY ***
Total pot $0.14 | Rake $0=20
Board [8h Kc 5h]
Seat 1: Veraz147 folded before Flop (didn't bet)
Seat 2: the_wickstar (button) folded on the Flop
Seat 3: boden1211 (small blind) collected ($0.14)
Seat 4: agapee92 (big blind) folded on the Flop
Seat 5: ErdgofrGG folded before Flop (didn't bet)
Seat 6: themarfs folded before Flop (didn't bet)
Seat 7: vini374 folded before Flop (didn't bet)
Seat 9: flyperety folded before Flop (didn't bet)


*********** # 122 **************
PokerStars Hand #169697479588:  Hold'em No Limit ($0.01/$0.02 USD) - 20=
17/04/29 11:26:44 CUST [2017/04/28 21:26:44 ET]
Table 'Wilkens' 9-max Seat #3 is the button
Seat 1: LAILAH M ($2.11 in chips)=20
Seat 2: EYENOGOOD4U ($1.90 in chips)=20
Seat 3: goofnewf616 ($1.86 in chips)=20
Seat 6: tetro54 ($2.35 in chips)=20
Seat 7: the_wickstar ($1.89 in chips)=20
Seat 9: jginebra55 ($2.06 in chips)=20
SMUTJAN72 will be allowed to play after the button
tetro54: posts small blind $0.01
the_wickstar: posts big blind $0.02
*** HOLE CARDS ***
Dealt to the_wickstar [Qs 2h]
jginebra55: folds=20
LAILAH M: folds=20
EYENOGOOD4U: folds=20
goofnewf616: calls $0.02
goofnewf616 said, "just f up"
tetro54: folds=20
the_wickstar: checks=20
*** FLOP *** [5s Th 8c]
the_wickstar: checks=20
goofnewf616: checks=20
*** TURN *** [5s Th 8c] [7h]
the_wickstar: checks=20
goofnewf616 said, "folded k im drunk"
goofnewf616: checks=20
*** RIVER *** [5s Th 8c 7h] [Qc]
the_wickstar: bets $0.03
goofnewf616: calls $0.03
*** SHOW DOWN ***
the_wickstar: shows [Qs 2h] (a pair of Queens)
goofnewf616: mucks hand=20
the_wickstar collected $0.11 from pot
*** SUMMARY ***
Total pot $0.11 | Rake $0=20
Board [5s Th 8c 7h Qc]
Seat 1: LAILAH M folded before Flop (didn't bet)
Seat 2: EYENOGOOD4U folded before Flop (didn't bet)
Seat 3: goofnewf616 (button) mucked [5h Jc]
Seat 6: tetro54 (small blind) folded before Flop
Seat 7: the_wickstar (big blind) showed [Qs 2h] and won ($0.11) with a =
pair of Queens
Seat 9: jginebra55 folded before Flop (didn't bet)


*********** # 123 **************
PokerStars Hand #169697462465:  Hold'em No Limit ($0.01/$0.02 USD) - 20=
17/04/29 11:26:06 CUST [2017/04/28 21:26:06 ET]
Table 'Antilia' 9-max Seat #1 is the button
Seat 1: Veraz147 ($2 in chips)=20
Seat 2: the_wickstar ($2.21 in chips)=20
Seat 3: boden1211 ($0.55 in chips)=20
Seat 4: agapee92 ($2 in chips)=20
Seat 5: ErdgofrGG ($2.11 in chips)=20
Seat 6: themarfs ($2.19 in chips)=20
Seat 7: vini374 ($1.44 in chips)=20
Seat 9: flyperety ($2.07 in chips)=20
the_wickstar: posts small blind $0.01
boden1211: posts big blind $0.02
Fezinhu11: sits out=20
*** HOLE CARDS ***
Dealt to the_wickstar [4c Kc]
agapee92: folds=20
ErdgofrGG: folds=20
themarfs: folds=20
vini374: folds=20
flyperety: raises $0.02 to $0.04
Veraz147: folds=20
the_wickstar: folds=20
boden1211: calls $0.02
*** FLOP *** [Qd Kh Ac]
boden1211: bets $0.08
flyperety: calls $0.08
*** TURN *** [Qd Kh Ac] [2d]
boden1211: bets $0.24
flyperety: calls $0.24
*** RIVER *** [Qd Kh Ac 2d] [4s]
boden1211: bets $0.19 and is all-in
flyperety: calls $0.19
*** SHOW DOWN ***
boden1211: shows [Qh Ks] (two pair, Kings and Queens)
flyperety: shows [Tc As] (a pair of Aces)
boden1211 collected $1.07 from pot
*** SUMMARY ***
Total pot $1.11 | Rake $0.04=20
Board [Qd Kh Ac 2d 4s]
Seat 1: Veraz147 (button) folded before Flop (didn't bet)
Seat 2: the_wickstar (small blind) folded before Flop
Seat 3: boden1211 (big blind) showed [Qh Ks] and won ($1.07) with two p=
air, Kings and Queens
Seat 4: agapee92 folded before Flop (didn't bet)
Seat 5: ErdgofrGG folded before Flop (didn't bet)
Seat 6: themarfs folded before Flop (didn't bet)
Seat 7: vini374 folded before Flop (didn't bet)
Seat 9: flyperety showed [Tc As] and lost with a pair of Aces


*********** # 124 **************
PokerStars Hand #169697452832:  Hold'em No Limit ($0.01/$0.02 USD) - 20=
17/04/29 11:25:44 CUST [2017/04/28 21:25:44 ET]
Table 'Wilkens' 9-max Seat #2 is the button
Seat 1: LAILAH M ($2.11 in chips)=20
Seat 2: EYENOGOOD4U ($1.90 in chips)=20
Seat 3: goofnewf616 ($1.88 in chips)=20
Seat 6: tetro54 ($2.37 in chips)=20
Seat 7: the_wickstar ($1.85 in chips)=20
Seat 9: jginebra55 ($2.06 in chips)=20
goofnewf616: posts small blind $0.01
Cookee96: is sitting out=20
tetro54: posts big blind $0.02
*** HOLE CARDS ***
Dealt to the_wickstar [8c 8s]
the_wickstar: calls $0.02
jginebra55: folds=20
Cookee96 leaves the table
LAILAH M: folds=20
EYENOGOOD4U: folds=20
goofnewf616: calls $0.01
SMUTJAN72 joins the table at seat #5=20
goofnewf616 said, "all in"
tetro54: checks=20
*** FLOP *** [3s Kd Kc]
goofnewf616: checks=20
tetro54: checks=20
the_wickstar: bets $0.03
goofnewf616: folds=20
tetro54: folds=20
Uncalled bet ($0.03) returned to the_wickstar
the_wickstar collected $0.06 from pot
*** SUMMARY ***
Total pot $0.06 | Rake $0=20
Board [3s Kd Kc]
Seat 1: LAILAH M folded before Flop (didn't bet)
Seat 2: EYENOGOOD4U (button) folded before Flop (didn't bet)
Seat 3: goofnewf616 (small blind) folded on the Flop
Seat 6: tetro54 (big blind) folded on the Flop
Seat 7: the_wickstar collected ($0.06)
Seat 9: jginebra55 folded before Flop (didn't bet)


*********** # 125 **************
PokerStars Hand #169697428318:  Hold'em No Limit ($0.01/$0.02 USD) - 20=
17/04/29 11:24:49 CUST [2017/04/28 21:24:49 ET]
Table 'Wilkens' 9-max Seat #1 is the button
Seat 1: LAILAH M ($2 in chips)=20
Seat 2: EYENOGOOD4U ($1.94 in chips)=20
Seat 3: goofnewf616 ($1.92 in chips)=20
Seat 5: Cookee96 ($2.46 in chips)=20
Seat 6: tetro54 ($2.37 in chips)=20
Seat 7: the_wickstar ($1.89 in chips)=20
Seat 9: jginebra55 ($2.06 in chips)=20
EYENOGOOD4U: posts small blind $0.01
goofnewf616: posts big blind $0.02
*** HOLE CARDS ***
Dealt to the_wickstar [Jc Td]
Cookee96: folds=20
tetro54: folds=20
the_wickstar: raises $0.02 to $0.04
jginebra55: folds=20
LAILAH M: calls $0.04
EYENOGOOD4U: calls $0.03
goofnewf616: calls $0.02
*** FLOP *** [3h Ts Ac]
EYENOGOOD4U: checks=20
goofnewf616: checks=20
the_wickstar: checks=20
LAILAH M: bets $0.15
EYENOGOOD4U: folds=20
goofnewf616: folds=20
the_wickstar: folds=20
Uncalled bet ($0.15) returned to LAILAH M
LAILAH M collected $0.15 from pot
LAILAH M: doesn't show hand=20
*** SUMMARY ***
Total pot $0.16 | Rake $0.01=20
Board [3h Ts Ac]
Seat 1: LAILAH M (button) collected ($0.15)
Seat 2: EYENOGOOD4U (small blind) folded on the Flop
Seat 3: goofnewf616 (big blind) folded on the Flop
Seat 5: Cookee96 folded before Flop (didn't bet)
Seat 6: tetro54 folded before Flop (didn't bet)
Seat 7: the_wickstar folded on the Flop
Seat 9: jginebra55 folded before Flop (didn't bet)


*********** # 126 **************
PokerStars Hand #169697417300:  Hold'em No Limit ($0.01/$0.02 USD) - 20=
17/04/29 11:24:25 CUST [2017/04/28 21:24:25 ET]
Table 'Antilia' 9-max Seat #9 is the button
Seat 1: Veraz147 ($2.08 in chips)=20
Seat 2: the_wickstar ($2.23 in chips)=20
Seat 3: boden1211 ($0.57 in chips)=20
Seat 4: agapee92 ($2 in chips)=20
Seat 5: ErdgofrGG ($2.11 in chips)=20
Seat 6: themarfs ($2 in chips)=20
Seat 7: vini374 ($1.44 in chips)=20
Seat 9: flyperety ($2.15 in chips)=20
Veraz147: posts small blind $0.01
the_wickstar: posts big blind $0.02
Fezinhu11: sits out=20
*** HOLE CARDS ***
Dealt to the_wickstar [4s Ad]
boden1211: calls $0.02
agapee92: folds=20
ErdgofrGG: folds=20
themarfs: raises $0.06 to $0.08
vini374: folds=20
flyperety: calls $0.08
Veraz147: calls $0.07
the_wickstar: folds=20
boden1211: folds=20
*** FLOP *** [5s 6s Qs]
Veraz147: checks=20
themarfs: checks=20
flyperety: checks=20
*** TURN *** [5s 6s Qs] [Ts]
Veraz147: checks=20
themarfs: checks=20
flyperety: checks=20
*** RIVER *** [5s 6s Qs Ts] [5h]
Veraz147: checks=20
themarfs: checks=20
flyperety: checks=20
*** SHOW DOWN ***
Veraz147: shows [9h 9c] (two pair, Nines and Fives)
themarfs: shows [Tc Jc] (two pair, Tens and Fives)
flyperety: mucks hand=20
themarfs collected $0.27 from pot
*** SUMMARY ***
Total pot $0.28 | Rake $0.01=20
Board [5s 6s Qs Ts 5h]
Seat 1: Veraz147 (small blind) showed [9h 9c] and lost with two pair, N=
ines and Fives
Seat 2: the_wickstar (big blind) folded before Flop
Seat 3: boden1211 folded before Flop
Seat 4: agapee92 folded before Flop (didn't bet)
Seat 5: ErdgofrGG folded before Flop (didn't bet)
Seat 6: themarfs showed [Tc Jc] and won ($0.27) with two pair, Tens and=
 Fives
Seat 7: vini374 folded before Flop (didn't bet)
Seat 9: flyperety (button) mucked [6d 7d]


*********** # 127 **************
PokerStars Hand #169697401143:  Hold'em No Limit ($0.01/$0.02 USD) - 20=
17/04/29 11:23:49 CUST [2017/04/28 21:23:49 ET]
Table 'Antilia' 9-max Seat #7 is the button
Seat 1: Veraz147 ($2.07 in chips)=20
Seat 2: the_wickstar ($2.23 in chips)=20
Seat 3: boden1211 ($0.57 in chips)=20
Seat 4: agapee92 ($2 in chips)=20
Seat 5: ErdgofrGG ($2.11 in chips)=20
Seat 6: themarfs ($2 in chips)=20
Seat 7: vini374 ($1.44 in chips)=20
Seat 9: flyperety ($2.16 in chips)=20
Fezinhu11 will be allowed to play after the button
flyperety: posts small blind $0.01
Veraz147: posts big blind $0.02
*** HOLE CARDS ***
Dealt to the_wickstar [9h Js]
the_wickstar: folds=20
boden1211: folds=20
agapee92: folds=20
ErdgofrGG: folds=20
themarfs: folds=20
vini374: folds=20
flyperety: folds=20
Uncalled bet ($0.01) returned to Veraz147
Veraz147 collected $0.02 from pot
Veraz147: doesn't show hand=20
*** SUMMARY ***
Total pot $0.02 | Rake $0=20
Seat 1: Veraz147 (big blind) collected ($0.02)
Seat 2: the_wickstar folded before Flop (didn't bet)
Seat 3: boden1211 folded before Flop (didn't bet)
Seat 4: agapee92 folded before Flop (didn't bet)
Seat 5: ErdgofrGG folded before Flop (didn't bet)
Seat 6: themarfs folded before Flop (didn't bet)
Seat 7: vini374 (button) folded before Flop (didn't bet)
Seat 9: flyperety (small blind) folded before Flop


*********** # 128 **************
PokerStars Hand #169697396887:  Hold'em No Limit ($0.01/$0.02 USD) - 20=
17/04/29 11:23:40 CUST [2017/04/28 21:23:40 ET]
Table 'Wilkens' 9-max Seat #9 is the button
Seat 1: LAILAH M ($2.01 in chips)=20
Seat 2: EYENOGOOD4U ($1.98 in chips)=20
Seat 3: goofnewf616 ($1.96 in chips)=20
Seat 4: ynwmbiwf ($0.86 in chips)=20
Seat 5: Cookee96 ($2.46 in chips)=20
Seat 6: tetro54 ($2.37 in chips)=20
Seat 7: the_wickstar ($1.80 in chips)=20
Seat 9: jginebra55 ($2.06 in chips)=20
LAILAH M: posts small blind $0.01
EYENOGOOD4U: posts big blind $0.02
*** HOLE CARDS ***
Dealt to the_wickstar [Td Qc]
goofnewf616: raises $0.02 to $0.04
ynwmbiwf has timed out
ynwmbiwf: folds=20
Cookee96: folds=20
tetro54: folds=20
the_wickstar: calls $0.04
jginebra55: folds=20
LAILAH M: folds=20
EYENOGOOD4U: calls $0.02
*** FLOP *** [2s 7s 4s]
EYENOGOOD4U: checks=20
goofnewf616: checks=20
the_wickstar: bets $0.10
EYENOGOOD4U: folds=20
goofnewf616: folds=20
Uncalled bet ($0.10) returned to the_wickstar
the_wickstar collected $0.13 from pot
*** SUMMARY ***
Total pot $0.13 | Rake $0=20
Board [2s 7s 4s]
Seat 1: LAILAH M (small blind) folded before Flop
Seat 2: EYENOGOOD4U (big blind) folded on the Flop
Seat 3: goofnewf616 folded on the Flop
Seat 4: ynwmbiwf folded before Flop (didn't bet)
Seat 5: Cookee96 folded before Flop (didn't bet)
Seat 6: tetro54 folded before Flop (didn't bet)
Seat 7: the_wickstar collected ($0.13)
Seat 9: jginebra55 (button) folded before Flop (didn't bet)


*********** # 129 **************
PokerStars Hand #169697372193:  Hold'em No Limit ($0.01/$0.02 USD) - 20=
17/04/29 11:22:46 CUST [2017/04/28 21:22:46 ET]
Table 'Antilia' 9-max Seat #6 is the button
Seat 1: Veraz147 ($2.07 in chips)=20
Seat 2: the_wickstar ($2.23 in chips)=20
Seat 3: boden1211 ($0.57 in chips)=20
Seat 4: agapee92 ($2 in chips)=20
Seat 5: ErdgofrGG ($2.11 in chips)=20
Seat 6: themarfs ($2.05 in chips)=20
Seat 7: vini374 ($1.45 in chips)=20
Seat 9: flyperety ($2 in chips)=20
vini374: posts small blind $0.01
tomashovka55: is sitting out=20
flyperety: posts big blind $0.02
*** HOLE CARDS ***
Dealt to the_wickstar [Js 8s]
tomashovka55 leaves the table
Veraz147: folds=20
the_wickstar: folds=20
boden1211: folds=20
agapee92: folds=20
ErdgofrGG: folds=20
themarfs: raises $0.04 to $0.06
vini374: folds=20
flyperety: calls $0.04
*** FLOP *** [2h 8c 3d]
flyperety: checks=20
Fezinhu11 joins the table at seat #8=20
themarfs: checks=20
*** TURN *** [2h 8c 3d] [Kh]
flyperety: checks=20
themarfs: bets $0.10
flyperety: raises $0.33 to $0.43
themarfs: folds=20
Uncalled bet ($0.33) returned to flyperety
flyperety collected $0.32 from pot
flyperety: doesn't show hand=20
*** SUMMARY ***
Total pot $0.33 | Rake $0.01=20
Board [2h 8c 3d Kh]
Seat 1: Veraz147 folded before Flop (didn't bet)
Seat 2: the_wickstar folded before Flop (didn't bet)
Seat 3: boden1211 folded before Flop (didn't bet)
Seat 4: agapee92 folded before Flop (didn't bet)
Seat 5: ErdgofrGG folded before Flop (didn't bet)
Seat 6: themarfs (button) folded on the Turn
Seat 7: vini374 (small blind) folded before Flop
Seat 9: flyperety (big blind) collected ($0.32)


*********** # 130 **************
PokerStars Hand #169697362227:  Hold'em No Limit ($0.01/$0.02 USD) - 20=
17/04/29 11:22:24 CUST [2017/04/28 21:22:24 ET]
Table 'Wilkens' 9-max Seat #7 is the button
Seat 1: LAILAH M ($1.96 in chips)=20
Seat 2: EYENOGOOD4U ($1.98 in chips)=20
Seat 3: goofnewf616 ($1.98 in chips)=20
Seat 4: ynwmbiwf ($0.86 in chips)=20
Seat 5: Cookee96 ($2.46 in chips)=20
Seat 6: tetro54 ($2.37 in chips)=20
Seat 7: the_wickstar ($1.82 in chips)=20
Seat 9: jginebra55 ($2.07 in chips)=20
jginebra55: posts small blind $0.01
LAILAH M: posts big blind $0.02
*** HOLE CARDS ***
Dealt to the_wickstar [9d As]
EYENOGOOD4U: folds=20
goofnewf616: calls $0.02
ynwmbiwf has timed out
ynwmbiwf: folds=20
Cookee96: folds=20
tetro54: folds=20
the_wickstar: calls $0.02
jginebra55: folds=20
LAILAH M: checks=20
*** FLOP *** [Kd 5c Qc]
LAILAH M: bets $0.04
goofnewf616: folds=20
the_wickstar: folds=20
Uncalled bet ($0.04) returned to LAILAH M
LAILAH M collected $0.07 from pot
LAILAH M: doesn't show hand=20
*** SUMMARY ***
Total pot $0.07 | Rake $0=20
Board [Kd 5c Qc]
Seat 1: LAILAH M (big blind) collected ($0.07)
Seat 2: EYENOGOOD4U folded before Flop (didn't bet)
Seat 3: goofnewf616 folded on the Flop
Seat 4: ynwmbiwf folded before Flop (didn't bet)
Seat 5: Cookee96 folded before Flop (didn't bet)
Seat 6: tetro54 folded before Flop (didn't bet)
Seat 7: the_wickstar (button) folded on the Flop
Seat 9: jginebra55 (small blind) folded before Flop


*********** # 131 **************
PokerStars Hand #169697350095:  Hold'em No Limit ($0.01/$0.02 USD) - 20=
17/04/29 11:21:57 CUST [2017/04/28 21:21:57 ET]
Table 'Antilia' 9-max Seat #5 is the button
Seat 1: Veraz147 ($2.07 in chips)=20
Seat 2: the_wickstar ($2.23 in chips)=20
Seat 3: boden1211 ($0.65 in chips)=20
Seat 4: agapee92 ($2 in chips)=20
Seat 5: ErdgofrGG ($2.11 in chips)=20
Seat 6: themarfs ($2.06 in chips)=20
Seat 7: vini374 ($1.37 in chips)=20
Seat 8: tomashovka55 ($2.97 in chips)=20
Seat 9: flyperety ($2 in chips)=20
themarfs: posts small blind $0.01
vini374: posts big blind $0.02
*** HOLE CARDS ***
Dealt to the_wickstar [2h 7d]
tomashovka55: folds=20
flyperety: folds=20
Veraz147: folds=20
the_wickstar: folds=20
boden1211: calls $0.02
agapee92: folds=20
ErdgofrGG: folds=20
themarfs: folds=20
vini374: raises $0.06 to $0.08
boden1211: calls $0.06
*** FLOP *** [5c 8s Ad]
vini374: bets $0.16
boden1211: folds=20
Uncalled bet ($0.16) returned to vini374
vini374 collected $0.16 from pot
*** SUMMARY ***
Total pot $0.17 | Rake $0.01=20
Board [5c 8s Ad]
Seat 1: Veraz147 folded before Flop (didn't bet)
Seat 2: the_wickstar folded before Flop (didn't bet)
Seat 3: boden1211 folded on the Flop
Seat 4: agapee92 folded before Flop (didn't bet)
Seat 5: ErdgofrGG (button) folded before Flop (didn't bet)
Seat 6: themarfs (small blind) folded before Flop
Seat 7: vini374 (big blind) collected ($0.16)
Seat 8: tomashovka55 folded before Flop (didn't bet)
Seat 9: flyperety folded before Flop (didn't bet)


*********** # 132 **************
PokerStars Hand #169697343245:  Hold'em No Limit ($0.01/$0.02 USD) - 20=
17/04/29 11:21:41 CUST [2017/04/28 21:21:41 ET]
Table 'Wilkens' 9-max Seat #6 is the button
Seat 1: LAILAH M ($1.96 in chips)=20
Seat 2: EYENOGOOD4U ($1.98 in chips)=20
Seat 3: goofnewf616 ($1.95 in chips)=20
Seat 4: ynwmbiwf ($0.86 in chips)=20
Seat 5: Cookee96 ($2.46 in chips)=20
Seat 6: tetro54 ($2.37 in chips)=20
Seat 7: the_wickstar ($1.83 in chips)=20
Seat 9: jginebra55 ($2.09 in chips)=20
the_wickstar: posts small blind $0.01
jginebra55: posts big blind $0.02
*** HOLE CARDS ***
Dealt to the_wickstar [2c Qh]
LAILAH M: folds=20
EYENOGOOD4U: folds=20
goofnewf616: raises $0.08 to $0.10
ynwmbiwf: folds=20
Cookee96: folds=20
tetro54: folds=20
the_wickstar: folds=20
jginebra55: folds=20
Uncalled bet ($0.08) returned to goofnewf616
goofnewf616 collected $0.05 from pot
goofnewf616: doesn't show hand=20
*** SUMMARY ***
Total pot $0.05 | Rake $0=20
Seat 1: LAILAH M folded before Flop (didn't bet)
Seat 2: EYENOGOOD4U folded before Flop (didn't bet)
Seat 3: goofnewf616 collected ($0.05)
Seat 4: ynwmbiwf folded before Flop (didn't bet)
Seat 5: Cookee96 folded before Flop (didn't bet)
Seat 6: tetro54 (button) folded before Flop (didn't bet)
Seat 7: the_wickstar (small blind) folded before Flop
Seat 9: jginebra55 (big blind) folded before Flop


*********** # 133 **************
PokerStars Hand #169697324963:  Hold'em No Limit ($0.01/$0.02 USD) - 20=
17/04/29 11:21:01 CUST [2017/04/28 21:21:01 ET]
Table 'Antilia' 9-max Seat #4 is the button
Seat 1: Veraz147 ($2.07 in chips)=20
Seat 2: the_wickstar ($2.23 in chips)=20
Seat 3: boden1211 ($0.65 in chips)=20
Seat 4: agapee92 ($2 in chips)=20
Seat 5: ErdgofrGG ($2 in chips)=20
Seat 6: themarfs ($2.08 in chips)=20
Seat 7: vini374 ($1.47 in chips)=20
Seat 8: tomashovka55 ($2.97 in chips)=20
Seat 9: flyperety ($2 in chips)=20
ErdgofrGG: posts small blind $0.01
themarfs: posts big blind $0.02
*** HOLE CARDS ***
Dealt to the_wickstar [3d 6c]
vini374: calls $0.02
tomashovka55: folds=20
flyperety: folds=20
Veraz147: folds=20
the_wickstar: folds=20
boden1211: folds=20
agapee92: folds=20
ErdgofrGG: raises $0.08 to $0.10
themarfs: folds=20
vini374: calls $0.08
*** FLOP *** [5c As 4c]
ErdgofrGG: bets $0.21
vini374: folds=20
Uncalled bet ($0.21) returned to ErdgofrGG
ErdgofrGG collected $0.21 from pot
ErdgofrGG: doesn't show hand=20
*** SUMMARY ***
Total pot $0.22 | Rake $0.01=20
Board [5c As 4c]
Seat 1: Veraz147 folded before Flop (didn't bet)
Seat 2: the_wickstar folded before Flop (didn't bet)
Seat 3: boden1211 folded before Flop (didn't bet)
Seat 4: agapee92 (button) folded before Flop (didn't bet)
Seat 5: ErdgofrGG (small blind) collected ($0.21)
Seat 6: themarfs (big blind) folded before Flop
Seat 7: vini374 folded on the Flop
Seat 8: tomashovka55 folded before Flop (didn't bet)
Seat 9: flyperety folded before Flop (didn't bet)


*********** # 134 **************
PokerStars Hand #169697304039:  Hold'em No Limit ($0.01/$0.02 USD) - 20=
17/04/29 11:20:15 CUST [2017/04/28 21:20:15 ET]
Table 'Wilkens' 9-max Seat #5 is the button
Seat 1: LAILAH M ($1.96 in chips)=20
Seat 2: EYENOGOOD4U ($2 in chips)=20
Seat 3: goofnewf616 ($2.02 in chips)=20
Seat 4: ynwmbiwf ($0.86 in chips)=20
Seat 5: Cookee96 ($2.46 in chips)=20
Seat 6: tetro54 ($2.39 in chips)=20
Seat 7: the_wickstar ($1.85 in chips)=20
Seat 9: jginebra55 ($1.97 in chips)=20
tetro54: posts small blind $0.01
the_wickstar: posts big blind $0.02
EYENOGOOD4U: posts big blind $0.02
*** HOLE CARDS ***
Dealt to the_wickstar [6s 4s]
jginebra55: calls $0.02
goofnewf616 said, "wow"
LAILAH M: folds=20
EYENOGOOD4U: checks=20
goofnewf616: calls $0.02
ynwmbiwf: folds=20
Cookee96: folds=20
tetro54: calls $0.01
the_wickstar: checks=20
*** FLOP *** [6h Jh 8h]
tetro54: checks=20
the_wickstar: checks=20
jginebra55: bets $0.05
EYENOGOOD4U: folds=20
goofnewf616: calls $0.05
tetro54: folds=20
FISH2236 said, ">:(nedonosok"
the_wickstar: folds=20
*** TURN *** [6h Jh 8h] [Kc]
jginebra55: bets $0.08
goofnewf616: folds=20
Uncalled bet ($0.08) returned to jginebra55
jginebra55 collected $0.19 from pot
*** SUMMARY ***
Total pot $0.20 | Rake $0.01=20
Board [6h Jh 8h Kc]
Seat 1: LAILAH M folded before Flop (didn't bet)
Seat 2: EYENOGOOD4U folded on the Flop
Seat 3: goofnewf616 folded on the Turn
Seat 4: ynwmbiwf folded before Flop (didn't bet)
Seat 5: Cookee96 (button) folded before Flop (didn't bet)
Seat 6: tetro54 (small blind) folded on the Flop
Seat 7: the_wickstar (big blind) folded on the Flop
Seat 9: jginebra55 collected ($0.19)


*********** # 135 **************
PokerStars Hand #169697290473:  Hold'em No Limit ($0.01/$0.02 USD) - 20=
17/04/29 11:19:45 CUST [2017/04/28 21:19:45 ET]
Table 'Antilia' 9-max Seat #3 is the button
Seat 1: Veraz147 ($2.07 in chips)=20
Seat 2: the_wickstar ($1.10 in chips)=20
Seat 3: boden1211 ($0.75 in chips)=20
Seat 4: agapee92 ($2 in chips)=20
Seat 5: ErdgofrGG ($2.14 in chips)=20
Seat 6: themarfs ($2.08 in chips)=20
Seat 7: vini374 ($1.47 in chips)=20
Seat 8: tomashovka55 ($2.97 in chips)=20
Seat 9: flyperety ($2 in chips)=20
agapee92: posts small blind $0.01
ErdgofrGG: posts big blind $0.02
*** HOLE CARDS ***
Dealt to the_wickstar [Qs Qh]
themarfs: folds=20
vini374: folds=20
tomashovka55: folds=20
flyperety: folds=20
Veraz147: folds=20
the_wickstar: raises $0.04 to $0.06
boden1211: raises $0.04 to $0.10
agapee92: folds=20
ErdgofrGG: raises $2.04 to $2.14 and is all-in
the_wickstar: calls $1.04 and is all-in
boden1211: folds=20
Uncalled bet ($1.04) returned to ErdgofrGG
*** FLOP *** [6h 3s 5s]
*** TURN *** [6h 3s 5s] [Kh]
*** RIVER *** [6h 3s 5s Kh] [Qc]
*** SHOW DOWN ***
ErdgofrGG: shows [Js Ac] (high card Ace)
the_wickstar: shows [Qs Qh] (three of a kind, Queens)
the_wickstar collected $2.23 from pot
*** SUMMARY ***
Total pot $2.31 | Rake $0.08=20
Board [6h 3s 5s Kh Qc]
Seat 1: Veraz147 folded before Flop (didn't bet)
Seat 2: the_wickstar showed [Qs Qh] and won ($2.23) with three of a kin=
d, Queens
Seat 3: boden1211 (button) folded before Flop
Seat 4: agapee92 (small blind) folded before Flop
Seat 5: ErdgofrGG (big blind) showed [Js Ac] and lost with high card Ace
Seat 6: themarfs folded before Flop (didn't bet)
Seat 7: vini374 folded before Flop (didn't bet)
Seat 8: tomashovka55 folded before Flop (didn't bet)
Seat 9: flyperety folded before Flop (didn't bet)


*********** # 136 **************
PokerStars Hand #169697277854:  Hold'em No Limit ($0.01/$0.02 USD) - 20=
17/04/29 11:19:17 CUST [2017/04/28 21:19:17 ET]
Table 'Wilkens' 9-max Seat #4 is the button
Seat 1: LAILAH M ($1.96 in chips)=20
Seat 3: goofnewf616 ($1.06 in chips)=20
Seat 4: ynwmbiwf ($0.86 in chips)=20
Seat 5: Cookee96 ($2.47 in chips)=20
Seat 6: tetro54 ($2.41 in chips)=20
Seat 7: the_wickstar ($1.85 in chips)=20
Seat 8: FISH2236 ($1 in chips)=20
Seat 9: jginebra55 ($1.97 in chips)=20
Cookee96: posts small blind $0.01
tetro54: posts big blind $0.02
*** HOLE CARDS ***
Dealt to the_wickstar [6h 7s]
Cookee96 said, "nh"
the_wickstar: folds=20
rafavicente leaves the table
FISH2236: raises $0.02 to $0.04
jginebra55: folds=20
LAILAH M: folds=20
goofnewf616: raises $0.02 to $0.06
ynwmbiwf: folds=20
EYENOGOOD4U joins the table at seat #2=20
Cookee96: folds=20
tetro54: folds=20
FISH2236: calls $0.02
*** FLOP *** [5h 6d 8c]
FISH2236: bets $0.07
goofnewf616: calls $0.07
*** TURN *** [5h 6d 8c] [Jd]
FISH2236: bets $0.14
goofnewf616: raises $0.79 to $0.93 and is all-in
FISH2236: calls $0.73 and is all-in
Uncalled bet ($0.06) returned to goofnewf616
*** RIVER *** [5h 6d 8c Jd] [2s]
*** SHOW DOWN ***
FISH2236: shows [Jc 9c] (a pair of Jacks)
goofnewf616: shows [7d 9d] (a straight, Five to Nine)
goofnewf616 collected $1.96 from pot
*** SUMMARY ***
Total pot $2.03 | Rake $0.07=20
Board [5h 6d 8c Jd 2s]
Seat 1: LAILAH M folded before Flop (didn't bet)
Seat 3: goofnewf616 showed [7d 9d] and won ($1.96) with a straight, Fiv=
e to Nine
Seat 4: ynwmbiwf (button) folded before Flop (didn't bet)
Seat 5: Cookee96 (small blind) folded before Flop
Seat 6: tetro54 (big blind) folded before Flop
Seat 7: the_wickstar folded before Flop (didn't bet)
Seat 8: FISH2236 showed [Jc 9c] and lost with a pair of Jacks
Seat 9: jginebra55 folded before Flop (didn't bet)


*********** # 137 **************
PokerStars Hand #169697265182:  Hold'em No Limit ($0.01/$0.02 USD) - 20=
17/04/29 11:18:49 CUST [2017/04/28 21:18:49 ET]
Table 'Antilia' 9-max Seat #2 is the button
Seat 1: Veraz147 ($2 in chips)=20
Seat 2: the_wickstar ($1.10 in chips)=20
Seat 3: boden1211 ($0.76 in chips)=20
Seat 4: agapee92 ($2 in chips)=20
Seat 5: ErdgofrGG ($2.14 in chips)=20
Seat 6: themarfs ($2.08 in chips)=20
Seat 7: vini374 ($1.47 in chips)=20
Seat 8: tomashovka55 ($2.97 in chips)=20
Seat 9: flyperety ($2.02 in chips)=20
boden1211: posts small blind $0.01
agapee92: posts big blind $0.02
*** HOLE CARDS ***
Dealt to the_wickstar [Jc 3h]
ErdgofrGG: folds=20
themarfs: folds=20
vini374: folds=20
tomashovka55: folds=20
flyperety: raises $0.02 to $0.04
Veraz147: raises $0.14 to $0.18
the_wickstar: folds=20
boden1211: folds=20
agapee92: folds=20
flyperety: folds=20
Uncalled bet ($0.14) returned to Veraz147
Veraz147 collected $0.11 from pot
Veraz147: doesn't show hand=20
*** SUMMARY ***
Total pot $0.11 | Rake $0=20
Seat 1: Veraz147 collected ($0.11)
Seat 2: the_wickstar (button) folded before Flop (didn't bet)
Seat 3: boden1211 (small blind) folded before Flop
Seat 4: agapee92 (big blind) folded before Flop
Seat 5: ErdgofrGG folded before Flop (didn't bet)
Seat 6: themarfs folded before Flop (didn't bet)
Seat 7: vini374 folded before Flop (didn't bet)
Seat 8: tomashovka55 folded before Flop (didn't bet)
Seat 9: flyperety folded before Flop


*********** # 138 **************
PokerStars Hand #169697260214:  Hold'em No Limit ($0.01/$0.02 USD) - 20=
17/04/29 11:18:38 CUST [2017/04/28 21:18:38 ET]
Table 'Wilkens' 9-max Seat #3 is the button
Seat 1: LAILAH M ($1.96 in chips)=20
Seat 3: goofnewf616 ($1.01 in chips)=20
Seat 4: ynwmbiwf ($0.87 in chips)=20
Seat 5: Cookee96 ($2.51 in chips)=20
Seat 6: tetro54 ($2.41 in chips)=20
Seat 7: the_wickstar ($1.85 in chips)=20
Seat 8: FISH2236 ($1 in chips)=20
Seat 9: jginebra55 ($1.97 in chips)=20
ynwmbiwf: posts small blind $0.01
Cookee96: posts big blind $0.02
*** HOLE CARDS ***
Dealt to the_wickstar [5h 7d]
tetro54: folds=20
the_wickstar: folds=20
FISH2236: folds=20
jginebra55: folds=20
LAILAH M: folds=20
goofnewf616: calls $0.02
ynwmbiwf: folds=20
Cookee96: checks=20
*** FLOP *** [5c 2c 2d]
Cookee96: checks=20
goofnewf616: checks=20
*** TURN *** [5c 2c 2d] [Ad]
Cookee96: checks=20
goofnewf616: checks=20
*** RIVER *** [5c 2c 2d Ad] [7s]
Cookee96: checks=20
goofnewf616: bets $0.02
Cookee96: calls $0.02
*** SHOW DOWN ***
goofnewf616: shows [4s 7c] (two pair, Sevens and Deuces)
Cookee96: mucks hand=20
goofnewf616 collected $0.09 from pot
*** SUMMARY ***
Total pot $0.09 | Rake $0=20
Board [5c 2c 2d Ad 7s]
Seat 1: LAILAH M folded before Flop (didn't bet)
Seat 3: goofnewf616 (button) showed [4s 7c] and won ($0.09) with two pa=
ir, Sevens and Deuces
Seat 4: ynwmbiwf (small blind) folded before Flop
Seat 5: Cookee96 (big blind) mucked [3d Kh]
Seat 6: tetro54 folded before Flop (didn't bet)
Seat 7: the_wickstar folded before Flop (didn't bet)
Seat 8: FISH2236 folded before Flop (didn't bet)
Seat 9: jginebra55 folded before Flop (didn't bet)


*********** # 139 **************
PokerStars Hand #169697239592:  Hold'em No Limit ($0.01/$0.02 USD) - 20=
17/04/29 11:17:53 CUST [2017/04/28 21:17:53 ET]
Table 'Antilia' 9-max Seat #1 is the button
Seat 1: Veraz147 ($2 in chips)=20
Seat 2: the_wickstar ($1.11 in chips)=20
Seat 3: boden1211 ($0.69 in chips)=20
Seat 4: agapee92 ($2 in chips)=20
Seat 5: ErdgofrGG ($2.14 in chips)=20
Seat 6: themarfs ($2.08 in chips)=20
Seat 7: vini374 ($1.53 in chips)=20
Seat 8: tomashovka55 ($2.97 in chips)=20
Seat 9: flyperety ($2.02 in chips)=20
the_wickstar: posts small blind $0.01
boden1211: posts big blind $0.02
*** HOLE CARDS ***
Dealt to the_wickstar [Qh 6h]
agapee92: folds=20
ErdgofrGG: folds=20
themarfs: folds=20
vini374: calls $0.02
tomashovka55: folds=20
flyperety: folds=20
Veraz147: folds=20
the_wickstar: folds=20
boden1211: checks=20
*** FLOP *** [8h 5c Td]
boden1211: bets $0.04
vini374: calls $0.04
*** TURN *** [8h 5c Td] [6d]
boden1211: bets $0.12
vini374: folds=20
Uncalled bet ($0.12) returned to boden1211
boden1211 collected $0.13 from pot
boden1211: doesn't show hand=20
*** SUMMARY ***
Total pot $0.13 | Rake $0=20
Board [8h 5c Td 6d]
Seat 1: Veraz147 (button) folded before Flop (didn't bet)
Seat 2: the_wickstar (small blind) folded before Flop
Seat 3: boden1211 (big blind) collected ($0.13)
Seat 4: agapee92 folded before Flop (didn't bet)
Seat 5: ErdgofrGG folded before Flop (didn't bet)
Seat 6: themarfs folded before Flop (didn't bet)
Seat 7: vini374 folded on the Turn
Seat 8: tomashovka55 folded before Flop (didn't bet)
Seat 9: flyperety folded before Flop (didn't bet)


*********** # 140 **************
PokerStars Hand #169697227240:  Hold'em No Limit ($0.01/$0.02 USD) - 20=
17/04/29 11:17:27 CUST [2017/04/28 21:17:27 ET]
Table 'Wilkens' 9-max Seat #1 is the button
Seat 1: LAILAH M ($1.96 in chips)=20
Seat 3: goofnewf616 ($1.96 in chips)=20
Seat 4: ynwmbiwf ($0.89 in chips)=20
Seat 5: Cookee96 ($2.51 in chips)=20
Seat 6: tetro54 ($2.41 in chips)=20
Seat 7: the_wickstar ($0.95 in chips)=20
Seat 8: FISH2236 ($1 in chips)=20
Seat 9: jginebra55 ($1.97 in chips)=20
goofnewf616: posts small blind $0.01
ynwmbiwf: posts big blind $0.02
*** HOLE CARDS ***
Dealt to the_wickstar [3d 3h]
Cookee96: folds=20
tetro54: folds=20
the_wickstar: calls $0.02
FISH2236: folds=20
jginebra55: folds=20
LAILAH M: folds=20
goofnewf616: raises $0.08 to $0.10
ynwmbiwf: folds=20
the_wickstar: calls $0.08
*** FLOP *** [9d Qc 4h]
goofnewf616: bets $0.10
the_wickstar: raises $0.11 to $0.21
goofnewf616: calls $0.11
*** TURN *** [9d Qc 4h] [2d]
goofnewf616: checks=20
the_wickstar: bets $0.50
goofnewf616: calls $0.50
*** RIVER *** [9d Qc 4h 2d] [Th]
goofnewf616: bets $0.14
the_wickstar: calls $0.14 and is all-in
*** SHOW DOWN ***
goofnewf616: shows [Ah 5h] (high card Ace)
the_wickstar: shows [3d 3h] (a pair of Threes)
the_wickstar collected $1.85 from pot
*** SUMMARY ***
Total pot $1.92 | Rake $0.07=20
Board [9d Qc 4h 2d Th]
Seat 1: LAILAH M (button) folded before Flop (didn't bet)
Seat 3: goofnewf616 (small blind) showed [Ah 5h] and lost with high car=
d Ace
Seat 4: ynwmbiwf (big blind) folded before Flop
Seat 5: Cookee96 folded before Flop (didn't bet)
Seat 6: tetro54 folded before Flop (didn't bet)
Seat 7: the_wickstar showed [3d 3h] and won ($1.85) with a pair of Thre=
es
Seat 8: FISH2236 folded before Flop (didn't bet)
Seat 9: jginebra55 folded before Flop (didn't bet)


*********** # 141 **************
PokerStars Hand #169697224520:  Hold'em No Limit ($0.01/$0.02 USD) - 20=
17/04/29 11:17:21 CUST [2017/04/28 21:17:21 ET]
Table 'Antilia' 9-max Seat #9 is the button
Seat 1: Veraz147 ($2.01 in chips)=20
Seat 2: the_wickstar ($1.10 in chips)=20
Seat 3: boden1211 ($0.69 in chips)=20
Seat 4: agapee92 ($2 in chips)=20
Seat 5: ErdgofrGG ($2.14 in chips)=20
Seat 6: themarfs ($2.08 in chips)=20
Seat 7: vini374 ($1.53 in chips)=20
Seat 8: tomashovka55 ($2.97 in chips)=20
Seat 9: flyperety ($2.02 in chips)=20
Veraz147: posts small blind $0.01
the_wickstar: posts big blind $0.02
*** HOLE CARDS ***
Dealt to the_wickstar [Js 2d]
boden1211: folds=20
agapee92: folds=20
ErdgofrGG: folds=20
themarfs: folds=20
vini374: folds=20
tomashovka55: folds=20
flyperety: folds=20
Veraz147: folds=20
Uncalled bet ($0.01) returned to the_wickstar
the_wickstar collected $0.02 from pot
*** SUMMARY ***
Total pot $0.02 | Rake $0=20
Seat 1: Veraz147 (small blind) folded before Flop
Seat 2: the_wickstar (big blind) collected ($0.02)
Seat 3: boden1211 folded before Flop (didn't bet)
Seat 4: agapee92 folded before Flop (didn't bet)
Seat 5: ErdgofrGG folded before Flop (didn't bet)
Seat 6: themarfs folded before Flop (didn't bet)
Seat 7: vini374 folded before Flop (didn't bet)
Seat 8: tomashovka55 folded before Flop (didn't bet)
Seat 9: flyperety (button) folded before Flop (didn't bet)


*********** # 142 **************
PokerStars Hand #169697193829:  Hold'em No Limit ($0.01/$0.02 USD) - 20=
17/04/29 11:16:14 CUST [2017/04/28 21:16:14 ET]
Table 'Wilkens' 9-max Seat #9 is the button
Seat 1: LAILAH M ($1.64 in chips)=20
Seat 3: goofnewf616 ($2.02 in chips)=20
Seat 4: ynwmbiwf ($0.89 in chips)=20
Seat 5: Cookee96 ($2.73 in chips)=20
Seat 6: tetro54 ($2.41 in chips)=20
Seat 7: the_wickstar ($0.95 in chips)=20
Seat 8: FISH2236 ($1.06 in chips)=20
Seat 9: jginebra55 ($1.97 in chips)=20
LAILAH M: posts small blind $0.01
goofnewf616: posts big blind $0.02
*** HOLE CARDS ***
Dealt to the_wickstar [Kc 7h]
ynwmbiwf: folds=20
Cookee96: raises $0.04 to $0.06
tetro54: folds=20
the_wickstar: folds=20
FISH2236: calls $0.06
jginebra55: folds=20
LAILAH M: calls $0.05
goofnewf616: calls $0.04
*** FLOP *** [Js Tc 6s]
LAILAH M: bets $0.02
goofnewf616: folds=20
Cookee96: raises $0.10 to $0.12
FISH2236: folds=20
LAILAH M: calls $0.10
*** TURN *** [Js Tc 6s] [4h]
LAILAH M: bets $0.02
Cookee96: calls $0.02
*** RIVER *** [Js Tc 6s 4h] [As]
LAILAH M: bets $0.02
Cookee96: calls $0.02
*** SHOW DOWN ***
LAILAH M: shows [Kd Qd] (a straight, Ten to Ace)
Cookee96: mucks hand=20
LAILAH M collected $0.54 from pot
*** SUMMARY ***
Total pot $0.56 | Rake $0.02=20
Board [Js Tc 6s 4h As]
Seat 1: LAILAH M (small blind) showed [Kd Qd] and won ($0.54) with a st=
raight, Ten to Ace
Seat 3: goofnewf616 (big blind) folded on the Flop
Seat 4: ynwmbiwf folded before Flop (didn't bet)
Seat 5: Cookee96 mucked [Jd Qh]
Seat 6: tetro54 folded before Flop (didn't bet)
Seat 7: the_wickstar folded before Flop (didn't bet)
Seat 8: FISH2236 folded on the Flop
Seat 9: jginebra55 (button) folded before Flop (didn't bet)


*********** # 143 **************
PokerStars Hand #169697143031:  Hold'em No Limit ($0.01/$0.02 USD) - 20=
17/04/29 11:14:24 CUST [2017/04/28 21:14:24 ET]
Table 'Wilkens' 9-max Seat #8 is the button
Seat 1: LAILAH M ($1.66 in chips)=20
Seat 3: goofnewf616 ($2.24 in chips)=20
Seat 4: ynwmbiwf ($0.89 in chips)=20
Seat 5: Cookee96 ($2.73 in chips)=20
Seat 6: tetro54 ($2.18 in chips)=20
Seat 7: the_wickstar ($0.95 in chips)=20
Seat 8: FISH2236 ($1.06 in chips)=20
Seat 9: jginebra55 ($1.98 in chips)=20
jginebra55: posts small blind $0.01
LAILAH M: posts big blind $0.02
*** HOLE CARDS ***
Dealt to the_wickstar [Qs 2h]
goofnewf616: raises $0.08 to $0.10
ynwmbiwf: folds=20
Cookee96: folds=20
tetro54: calls $0.10
the_wickstar: folds=20
FISH2236: folds=20
jginebra55: folds=20
LAILAH M: folds=20
*** FLOP *** [6s 8c Kc]
goofnewf616: checks=20
tetro54: checks=20
*** TURN *** [6s 8c Kc] [Ts]
goofnewf616: checks=20
tetro54: bets $0.12
goofnewf616: calls $0.12
*** RIVER *** [6s 8c Kc Ts] [7h]
goofnewf616 said, "3 10"
goofnewf616: checks=20
tetro54: checks=20
*** SHOW DOWN ***
goofnewf616: shows [Qd Th] (a pair of Tens)
tetro54: shows [Ad Kh] (a pair of Kings)
tetro54 collected $0.45 from pot
*** SUMMARY ***
Total pot $0.47 | Rake $0.02=20
Board [6s 8c Kc Ts 7h]
Seat 1: LAILAH M (big blind) folded before Flop
Seat 3: goofnewf616 showed [Qd Th] and lost with a pair of Tens
Seat 4: ynwmbiwf folded before Flop (didn't bet)
Seat 5: Cookee96 folded before Flop (didn't bet)
Seat 6: tetro54 showed [Ad Kh] and won ($0.45) with a pair of Kings
Seat 7: the_wickstar folded before Flop (didn't bet)
Seat 8: FISH2236 (button) folded before Flop (didn't bet)
Seat 9: jginebra55 (small blind) folded before Flop


*********** # 144 **************
PokerStars Hand #169697115158:  Hold'em No Limit ($0.01/$0.02 USD) - 20=
17/04/29 11:13:23 CUST [2017/04/28 21:13:23 ET]
Table 'Wilkens' 9-max Seat #7 is the button
Seat 1: LAILAH M ($1.66 in chips)=20
Seat 3: goofnewf616 ($2.28 in chips)=20
Seat 4: ynwmbiwf ($0.89 in chips)=20
Seat 5: Cookee96 ($2.56 in chips)=20
Seat 6: tetro54 ($2.18 in chips)=20
Seat 7: the_wickstar ($1.06 in chips)=20
Seat 8: FISH2236 ($1.07 in chips)=20
Seat 9: jginebra55 ($2 in chips)=20
FISH2236: posts small blind $0.01
jginebra55: posts big blind $0.02
*** HOLE CARDS ***
Dealt to the_wickstar [Qd 7h]
LAILAH M: folds=20
goofnewf616: raises $0.02 to $0.04
ynwmbiwf: folds=20
Cookee96: calls $0.04
tetro54: folds=20
the_wickstar: calls $0.04
FISH2236: folds=20
jginebra55: folds=20
*** FLOP *** [Jc 2d 7d]
goofnewf616: checks=20
Cookee96: checks=20
the_wickstar: bets $0.07
goofnewf616: folds=20
Cookee96: raises $0.13 to $0.20
the_wickstar: folds=20
Uncalled bet ($0.13) returned to Cookee96
Cookee96 collected $0.28 from pot
*** SUMMARY ***
Total pot $0.29 | Rake $0.01=20
Board [Jc 2d 7d]
Seat 1: LAILAH M folded before Flop (didn't bet)
Seat 3: goofnewf616 folded on the Flop
Seat 4: ynwmbiwf folded before Flop (didn't bet)
Seat 5: Cookee96 collected ($0.28)
Seat 6: tetro54 folded before Flop (didn't bet)
Seat 7: the_wickstar (button) folded on the Flop
Seat 8: FISH2236 (small blind) folded before Flop
Seat 9: jginebra55 (big blind) folded before Flop


*********** # 145 **************
PokerStars Hand #169697085722:  Hold'em No Limit ($0.01/$0.02 USD) - 20=
17/04/29 11:12:19 CUST [2017/04/28 21:12:19 ET]
Table 'Wilkens' 9-max Seat #6 is the button
Seat 1: LAILAH M ($1.66 in chips)=20
Seat 3: goofnewf616 ($2.07 in chips)=20
Seat 4: ynwmbiwf ($0.91 in chips)=20
Seat 5: Cookee96 ($2.56 in chips)=20
Seat 6: tetro54 ($2.18 in chips)=20
Seat 7: the_wickstar ($1.08 in chips)=20
Seat 8: FISH2236 ($1.25 in chips)=20
the_wickstar: posts small blind $0.01
FISH2236: posts big blind $0.02
jginebra55: sits out=20
*** HOLE CARDS ***
Dealt to the_wickstar [6d Td]
LAILAH M: folds=20
goofnewf616: calls $0.02
ynwmbiwf: calls $0.02
Cookee96: folds=20
tetro54: folds=20
the_wickstar: calls $0.01
FISH2236: checks=20
*** FLOP *** [As 9h Qd]
the_wickstar: checks=20
FISH2236: bets $0.06
goofnewf616: calls $0.06
ynwmbiwf: folds=20
the_wickstar: folds=20
*** TURN *** [As 9h Qd] [9d]
FISH2236: checks=20
goofnewf616: bets $0.02
FISH2236: calls $0.02
*** RIVER *** [As 9h Qd 9d] [Qs]
FISH2236: checks=20
goofnewf616: bets $0.08
FISH2236: calls $0.08
*** SHOW DOWN ***
goofnewf616: shows [3d Qc] (a full house, Queens full of Nines)
FISH2236: mucks hand=20
goofnewf616 collected $0.39 from pot
*** SUMMARY ***
Total pot $0.40 | Rake $0.01=20
Board [As 9h Qd 9d Qs]
Seat 1: LAILAH M folded before Flop (didn't bet)
Seat 3: goofnewf616 showed [3d Qc] and won ($0.39) with a full house, Q=
ueens full of Nines
Seat 4: ynwmbiwf folded on the Flop
Seat 5: Cookee96 folded before Flop (didn't bet)
Seat 6: tetro54 (button) folded before Flop (didn't bet)
Seat 7: the_wickstar (small blind) folded on the Flop
Seat 8: FISH2236 (big blind) mucked [Ad 5s]


*********** # 146 **************
PokerStars Hand #169697072807:  Hold'em No Limit ($0.01/$0.02 USD) - 20=
17/04/29 11:11:52 CUST [2017/04/28 21:11:52 ET]
Table 'Wilkens' 9-max Seat #5 is the button
Seat 1: LAILAH M ($1.73 in chips)=20
Seat 3: goofnewf616 ($1.97 in chips)=20
Seat 4: ynwmbiwf ($0.91 in chips)=20
Seat 5: Cookee96 ($2.56 in chips)=20
Seat 6: tetro54 ($2.19 in chips)=20
Seat 7: the_wickstar ($1.10 in chips)=20
Seat 8: FISH2236 ($1.25 in chips)=20
tetro54: posts small blind $0.01
the_wickstar: posts big blind $0.02
jginebra55: sits out=20
*** HOLE CARDS ***
Dealt to the_wickstar [Th Js]
FISH2236: folds=20
LAILAH M: raises $0.05 to $0.07
goofnewf616: raises $1.90 to $1.97 and is all-in
ynwmbiwf: folds=20
Cookee96: folds=20
tetro54: folds=20
the_wickstar: folds=20
LAILAH M: folds=20
Uncalled bet ($1.90) returned to goofnewf616
goofnewf616 collected $0.17 from pot
goofnewf616: doesn't show hand=20
*** SUMMARY ***
Total pot $0.17 | Rake $0=20
Seat 1: LAILAH M folded before Flop
Seat 3: goofnewf616 collected ($0.17)
Seat 4: ynwmbiwf folded before Flop (didn't bet)
Seat 5: Cookee96 (button) folded before Flop (didn't bet)
Seat 6: tetro54 (small blind) folded before Flop
Seat 7: the_wickstar (big blind) folded before Flop
Seat 8: FISH2236 folded before Flop (didn't bet)


*********** # 147 **************
PokerStars Hand #169677914983:  Hold'em No Limit ($0.01/$0.02 USD) - 20=
17/04/29 3:39:56 CUST [2017/04/28 13:39:56 ET]
Table 'Electra' 9-max Seat #3 is the button
Seat 3: julio.jacob1 ($2.04 in chips)=20
Seat 4: PerpetualNew ($2.09 in chips)=20
Seat 5: Gonzalogo ($2.23 in chips)=20
Seat 6: the_wickstar ($2.09 in chips)=20
Seat 7: daNeck88 ($2 in chips)=20
Seat 9: ronan33 ($2 in chips)=20
PerpetualNew: posts small blind $0.01
Gonzalogo: posts big blind $0.02
Noyouseeme: sits out=20
dmitryobow: sits out=20
*** HOLE CARDS ***
Dealt to the_wickstar [Ad 7s]
the_wickstar: folds=20
daNeck88: folds=20
ronan33: folds=20
the_wickstar leaves the table
julio.jacob1: raises $0.04 to $0.06
PerpetualNew: folds=20
Gonzalogo: folds=20
Uncalled bet ($0.04) returned to julio.jacob1
musainur5 joins the table at seat #6=20
julio.jacob1 collected $0.05 from pot
*** SUMMARY ***
Total pot $0.05 | Rake $0=20
Seat 3: julio.jacob1 (button) collected ($0.05)
Seat 4: PerpetualNew (small blind) folded before Flop
Seat 5: Gonzalogo (big blind) folded before Flop
Seat 6: the_wickstar folded before Flop (didn't bet)
Seat 7: daNeck88 folded before Flop (didn't bet)
Seat 9: ronan33 folded before Flop (didn't bet)


*********** # 148 **************
PokerStars Hand #169677899484:  Hold'em No Limit ($0.01/$0.02 USD) - 20=
17/04/29 3:39:35 CUST [2017/04/28 13:39:35 ET]
Table 'Electra' 9-max Seat #9 is the button
Seat 3: julio.jacob1 ($2.05 in chips)=20
Seat 4: PerpetualNew ($2.08 in chips)=20
Seat 5: Gonzalogo ($2.23 in chips)=20
Seat 6: the_wickstar ($2.09 in chips)=20
Seat 7: daNeck88 ($2 in chips)=20
Seat 9: ronan33 ($2 in chips)=20
Noyouseeme will be allowed to play after the button
julio.jacob1: posts small blind $0.01
PerpetualNew: posts big blind $0.02
*** HOLE CARDS ***
Dealt to the_wickstar [7c 4h]
Gonzalogo: folds=20
the_wickstar: folds=20
dmitryobow joins the table at seat #2=20
daNeck88: folds=20
ronan33: folds=20
julio.jacob1: folds=20
Uncalled bet ($0.01) returned to PerpetualNew
PerpetualNew collected $0.02 from pot
PerpetualNew: doesn't show hand=20
*** SUMMARY ***
Total pot $0.02 | Rake $0=20
Seat 3: julio.jacob1 (small blind) folded before Flop
Seat 4: PerpetualNew (big blind) collected ($0.02)
Seat 5: Gonzalogo folded before Flop (didn't bet)
Seat 6: the_wickstar folded before Flop (didn't bet)
Seat 7: daNeck88 folded before Flop (didn't bet)
Seat 9: ronan33 (button) folded before Flop (didn't bet)


*********** # 149 **************
PokerStars Hand #169677867725:  Hold'em No Limit ($0.01/$0.02 USD) - 20=
17/04/29 3:38:54 CUST [2017/04/28 13:38:54 ET]
Table 'Electra' 9-max Seat #7 is the button
Seat 1: IceMan 62289 ($1.57 in chips)=20
Seat 2: dadofaca ($2 in chips)=20
Seat 3: julio.jacob1 ($2.05 in chips)=20
Seat 4: PerpetualNew ($2.14 in chips)=20
Seat 5: Gonzalogo ($2.23 in chips)=20
Seat 6: the_wickstar ($2.01 in chips)=20
Seat 7: daNeck88 ($2 in chips)=20
Seat 9: ronan33 ($2 in chips)=20
ronan33: posts small blind $0.01
IceMan 62289: posts big blind $0.02
*** HOLE CARDS ***
Dealt to the_wickstar [Tc Td]
dadofaca: folds=20
julio.jacob1: folds=20
PerpetualNew: raises $0.04 to $0.06
Gonzalogo: folds=20
the_wickstar: calls $0.06
daNeck88: folds=20
ronan33: folds=20
IceMan 62289: folds=20
*** FLOP *** [3h Qs Kc]
IceMan 62289 leaves the table
dadofaca leaves the table
PerpetualNew: checks=20
the_wickstar: bets $0.10
PerpetualNew: folds=20
Uncalled bet ($0.10) returned to the_wickstar
the_wickstar collected $0.14 from pot
Noyouseeme joins the table at seat #1=20
*** SUMMARY ***
Total pot $0.15 | Rake $0.01=20
Board [3h Qs Kc]
Seat 1: IceMan 62289 (big blind) folded before Flop
Seat 2: dadofaca folded before Flop (didn't bet)
Seat 3: julio.jacob1 folded before Flop (didn't bet)
Seat 4: PerpetualNew folded on the Flop
Seat 5: Gonzalogo folded before Flop (didn't bet)
Seat 6: the_wickstar collected ($0.14)
Seat 7: daNeck88 (button) folded before Flop (didn't bet)
Seat 9: ronan33 (small blind) folded before Flop


*********** # 150 **************
PokerStars Hand #169677822377:  Hold'em No Limit ($0.01/$0.02 USD) - 20=
17/04/29 3:37:54 CUST [2017/04/28 13:37:54 ET]
Table 'Electra' 9-max Seat #6 is the button
Seat 1: IceMan 62289 ($1.67 in chips)=20
Seat 2: dadofaca ($2 in chips)=20
Seat 3: julio.jacob1 ($2.05 in chips)=20
Seat 4: PerpetualNew ($2.14 in chips)=20
Seat 5: Gonzalogo ($2.11 in chips)=20
Seat 6: the_wickstar ($2.01 in chips)=20
Seat 7: daNeck88 ($2 in chips)=20
Seat 8: schiebe444 ($2.67 in chips)=20
Seat 9: ronan33 ($2 in chips)=20
daNeck88: posts small blind $0.01
schiebe444: posts big blind $0.02
*** HOLE CARDS ***
Dealt to the_wickstar [4h 2d]
ronan33: folds=20
IceMan 62289: calls $0.02
dadofaca: folds=20
julio.jacob1: folds=20
PerpetualNew: folds=20
Gonzalogo: raises $0.08 to $0.10
the_wickstar: folds=20
daNeck88: folds=20
schiebe444: folds=20
IceMan 62289: calls $0.08
*** FLOP *** [2h Kc 4c]
IceMan 62289: checks=20
Gonzalogo: bets $0.12
IceMan 62289: folds=20
Uncalled bet ($0.12) returned to Gonzalogo
Gonzalogo collected $0.22 from pot
Gonzalogo: doesn't show hand=20
*** SUMMARY ***
Total pot $0.23 | Rake $0.01=20
Board [2h Kc 4c]
Seat 1: IceMan 62289 folded on the Flop
Seat 2: dadofaca folded before Flop (didn't bet)
Seat 3: julio.jacob1 folded before Flop (didn't bet)
Seat 4: PerpetualNew folded before Flop (didn't bet)
Seat 5: Gonzalogo collected ($0.22)
Seat 6: the_wickstar (button) folded before Flop (didn't bet)
Seat 7: daNeck88 (small blind) folded before Flop
Seat 8: schiebe444 (big blind) folded before Flop
Seat 9: ronan33 folded before Flop (didn't bet)


*********** # 151 **************
PokerStars Hand #169677798231:  Hold'em No Limit ($0.01/$0.02 USD) - 20=
17/04/29 3:37:22 CUST [2017/04/28 13:37:22 ET]
Table 'Electra' 9-max Seat #5 is the button
Seat 1: IceMan 62289 ($1.67 in chips)=20
Seat 2: dadofaca ($2 in chips)=20
Seat 3: julio.jacob1 ($2.05 in chips)=20
Seat 4: PerpetualNew ($2.11 in chips)=20
Seat 5: Gonzalogo ($2.11 in chips)=20
Seat 6: the_wickstar ($2.02 in chips)=20
Seat 7: daNeck88 ($2 in chips)=20
Seat 8: schiebe444 ($2.67 in chips)=20
Seat 9: ronan33 ($2 in chips)=20
the_wickstar: posts small blind $0.01
daNeck88: posts big blind $0.02
*** HOLE CARDS ***
Dealt to the_wickstar [5h Tc]
schiebe444: folds=20
ronan33: folds=20
IceMan 62289: folds=20
dadofaca: folds=20
julio.jacob1: folds=20
PerpetualNew: raises $0.04 to $0.06
Gonzalogo: folds=20
the_wickstar: folds=20
daNeck88: folds=20
Uncalled bet ($0.04) returned to PerpetualNew
PerpetualNew collected $0.05 from pot
PerpetualNew: doesn't show hand=20
*** SUMMARY ***
Total pot $0.05 | Rake $0=20
Seat 1: IceMan 62289 folded before Flop (didn't bet)
Seat 2: dadofaca folded before Flop (didn't bet)
Seat 3: julio.jacob1 folded before Flop (didn't bet)
Seat 4: PerpetualNew collected ($0.05)
Seat 5: Gonzalogo (button) folded before Flop (didn't bet)
Seat 6: the_wickstar (small blind) folded before Flop
Seat 7: daNeck88 (big blind) folded before Flop
Seat 8: schiebe444 folded before Flop (didn't bet)
Seat 9: ronan33 folded before Flop (didn't bet)


*********** # 152 **************
PokerStars Hand #169677759044:  Hold'em No Limit ($0.01/$0.02 USD) - 20=
17/04/29 3:36:30 CUST [2017/04/28 13:36:30 ET]
Table 'Scythia' 9-max Seat #9 is the button
Seat 1: PerpetualNew ($2 in chips)=20
Seat 2: Petasi ($2 in chips)=20
Seat 3: the_wickstar ($0.61 in chips)=20
Seat 4: Lazomaz ($3.77 in chips)=20
Seat 5: bootlessly ($0.66 in chips)=20
Seat 7: Joaovdn ($2.73 in chips)=20
Seat 8: krome20 ($2 in chips)=20
Seat 9: super =9Eelva ($2 in chips)=20
PerpetualNew: posts small blind $0.01
Petasi: posts big blind $0.02
*** HOLE CARDS ***
Dealt to the_wickstar [Tc 4d]
Gonzalogo joins the table at seat #6=20
the_wickstar: folds=20
Lazomaz: folds=20
bootlessly: folds=20
Joaovdn: folds=20
the_wickstar leaves the table
krome20: raises $0.04 to $0.06
super =9Eelva: folds=20
PerpetualNew: folds=20
Petasi: folds=20
Uncalled bet ($0.04) returned to krome20
krome20 collected $0.05 from pot
krome20: doesn't show hand=20
*** SUMMARY ***
Total pot $0.05 | Rake $0=20
Seat 1: PerpetualNew (small blind) folded before Flop
Seat 2: Petasi (big blind) folded before Flop
Seat 3: the_wickstar folded before Flop (didn't bet)
Seat 4: Lazomaz folded before Flop (didn't bet)
Seat 5: bootlessly folded before Flop (didn't bet)
Seat 7: Joaovdn folded before Flop (didn't bet)
Seat 8: krome20 collected ($0.05)
Seat 9: super =9Eelva (button) folded before Flop (didn't bet)


*********** # 153 **************
PokerStars Hand #169677758306:  Hold'em No Limit ($0.01/$0.02 USD) - 20=
17/04/29 3:36:29 CUST [2017/04/28 13:36:29 ET]
Table 'Electra' 9-max Seat #4 is the button
Seat 1: IceMan 62289 ($1.67 in chips)=20
Seat 2: dadofaca ($2 in chips)=20
Seat 3: julio.jacob1 ($2.05 in chips)=20
Seat 4: PerpetualNew ($2.11 in chips)=20
Seat 5: Gonzalogo ($2.12 in chips)=20
Seat 6: the_wickstar ($2.06 in chips)=20
Seat 7: daNeck88 ($2 in chips)=20
Seat 8: schiebe444 ($2.55 in chips)=20
Seat 9: ronan33 ($2 in chips)=20
Gonzalogo: posts small blind $0.01
the_wickstar: posts big blind $0.02
*** HOLE CARDS ***
Dealt to the_wickstar [2d Kc]
daNeck88: folds=20
schiebe444: raises $0.02 to $0.04
ronan33: calls $0.04
IceMan 62289: folds=20
dadofaca: calls $0.04
julio.jacob1: folds=20
PerpetualNew: folds=20
Gonzalogo: folds=20
the_wickstar: calls $0.02
*** FLOP *** [Ts Ac 9d]
the_wickstar: checks=20
schiebe444: bets $0.06
ronan33: folds=20
dadofaca: folds=20
the_wickstar: folds=20
Uncalled bet ($0.06) returned to schiebe444
schiebe444 collected $0.16 from pot
schiebe444: doesn't show hand=20
*** SUMMARY ***
Total pot $0.17 | Rake $0.01=20
Board [Ts Ac 9d]
Seat 1: IceMan 62289 folded before Flop (didn't bet)
Seat 2: dadofaca folded on the Flop
Seat 3: julio.jacob1 folded before Flop (didn't bet)
Seat 4: PerpetualNew (button) folded before Flop (didn't bet)
Seat 5: Gonzalogo (small blind) folded before Flop
Seat 6: the_wickstar (big blind) folded on the Flop
Seat 7: daNeck88 folded before Flop (didn't bet)
Seat 8: schiebe444 collected ($0.16)
Seat 9: ronan33 folded on the Flop


*********** # 154 **************
PokerStars Hand #169677733236:  Hold'em No Limit ($0.01/$0.02 USD) - 20=
17/04/29 3:35:55 CUST [2017/04/28 13:35:55 ET]
Table 'Electra' 9-max Seat #3 is the button
Seat 1: IceMan 62289 ($1.67 in chips)=20
Seat 2: dadofaca ($2 in chips)=20
Seat 3: julio.jacob1 ($2.11 in chips)=20
Seat 4: PerpetualNew ($2.03 in chips)=20
Seat 5: Gonzalogo ($2.14 in chips)=20
Seat 6: the_wickstar ($2.06 in chips)=20
Seat 7: daNeck88 ($2 in chips)=20
Seat 8: schiebe444 ($2.55 in chips)=20
Seat 9: ronan33 ($2 in chips)=20
PerpetualNew: posts small blind $0.01
Gonzalogo: posts big blind $0.02
*** HOLE CARDS ***
Dealt to the_wickstar [8h Jc]
the_wickstar: folds=20
daNeck88: folds=20
schiebe444: folds=20
ronan33: folds=20
IceMan 62289: folds=20
dadofaca: folds=20
julio.jacob1: raises $0.04 to $0.06
PerpetualNew: raises $0.12 to $0.18
Gonzalogo: folds=20
julio.jacob1: folds=20
Uncalled bet ($0.12) returned to PerpetualNew
PerpetualNew collected $0.14 from pot
PerpetualNew: doesn't show hand=20
*** SUMMARY ***
Total pot $0.14 | Rake $0=20
Seat 1: IceMan 62289 folded before Flop (didn't bet)
Seat 2: dadofaca folded before Flop (didn't bet)
Seat 3: julio.jacob1 (button) folded before Flop
Seat 4: PerpetualNew (small blind) collected ($0.14)
Seat 5: Gonzalogo (big blind) folded before Flop
Seat 6: the_wickstar folded before Flop (didn't bet)
Seat 7: daNeck88 folded before Flop (didn't bet)
Seat 8: schiebe444 folded before Flop (didn't bet)
Seat 9: ronan33 folded before Flop (didn't bet)


*********** # 155 **************
PokerStars Hand #169677705191:  Hold'em No Limit ($0.01/$0.02 USD) - 20=
17/04/29 3:35:18 CUST [2017/04/28 13:35:18 ET]
Table 'Scythia' 9-max Seat #8 is the button
Seat 1: PerpetualNew ($2 in chips)=20
Seat 3: the_wickstar ($0.63 in chips)=20
Seat 4: Lazomaz ($3.77 in chips)=20
Seat 5: bootlessly ($0.66 in chips)=20
Seat 6: CiaranMu ($2.13 in chips)=20
Seat 7: Joaovdn ($2.30 in chips)=20
Seat 8: krome20 ($2 in chips)=20
Seat 9: super =9Eelva ($2.06 in chips)=20
super =9Eelva: posts small blind $0.01
PerpetualNew: posts big blind $0.02
Petasi: sits out=20
*** HOLE CARDS ***
Dealt to the_wickstar [5d 5s]
the_wickstar: calls $0.02
Lazomaz: folds=20
bootlessly: folds=20
CiaranMu: folds=20
Joaovdn: calls $0.02
krome20: raises $0.08 to $0.10
super =9Eelva: calls $0.09
PerpetualNew: folds=20
the_wickstar: folds=20
Joaovdn: calls $0.08
*** FLOP *** [7d 5h Td]
super =9Eelva: checks=20
Joaovdn: checks=20
krome20: checks=20
*** TURN *** [7d 5h Td] [4d]
super =9Eelva: bets $0.22
Joaovdn: calls $0.22
krome20: folds=20
*** RIVER *** [7d 5h Td 4d] [As]
CiaranMu leaves the table
super =9Eelva: checks=20
Joaovdn: checks=20
*** SHOW DOWN ***
super =9Eelva: shows [6c 6d] (a pair of Sixes)
Joaovdn: shows [Th 9c] (a pair of Tens)
Joaovdn collected $0.75 from pot
*** SUMMARY ***
Total pot $0.78 | Rake $0.03=20
Board [7d 5h Td 4d As]
Seat 1: PerpetualNew (big blind) folded before Flop
Seat 3: the_wickstar folded before Flop
Seat 4: Lazomaz folded before Flop (didn't bet)
Seat 5: bootlessly folded before Flop (didn't bet)
Seat 6: CiaranMu folded before Flop (didn't bet)
Seat 7: Joaovdn showed [Th 9c] and won ($0.75) with a pair of Tens
Seat 8: krome20 (button) folded on the Turn
Seat 9: super =9Eelva (small blind) showed [6c 6d] and lost with a pair=
 of Sixes


*********** # 156 **************
PokerStars Hand #169677693443:  Hold'em No Limit ($0.01/$0.02 USD) - 20=
17/04/29 3:35:03 CUST [2017/04/28 13:35:03 ET]
Table 'Electra' 9-max Seat #2 is the button
Seat 1: IceMan 62289 ($1.67 in chips)=20
Seat 2: dadofaca ($2 in chips)=20
Seat 3: julio.jacob1 ($2.12 in chips)=20
Seat 4: PerpetualNew ($2 in chips)=20
Seat 5: Gonzalogo ($2.14 in chips)=20
Seat 6: the_wickstar ($2.08 in chips)=20
Seat 7: daNeck88 ($2 in chips)=20
Seat 8: schiebe444 ($2.55 in chips)=20
Seat 9: ronan33 ($2 in chips)=20
julio.jacob1: posts small blind $0.01
PerpetualNew: posts big blind $0.02
*** HOLE CARDS ***
Dealt to the_wickstar [Jh Tc]
Gonzalogo: folds=20
the_wickstar: calls $0.02
daNeck88: folds=20
schiebe444: folds=20
ronan33: folds=20
IceMan 62289: folds=20
dadofaca: folds=20
julio.jacob1: folds=20
PerpetualNew: checks=20
*** FLOP *** [5c Ad 3d]
PerpetualNew: bets $0.03
the_wickstar: folds=20
Uncalled bet ($0.03) returned to PerpetualNew
PerpetualNew collected $0.05 from pot
PerpetualNew: doesn't show hand=20
*** SUMMARY ***
Total pot $0.05 | Rake $0=20
Board [5c Ad 3d]
Seat 1: IceMan 62289 folded before Flop (didn't bet)
Seat 2: dadofaca (button) folded before Flop (didn't bet)
Seat 3: julio.jacob1 (small blind) folded before Flop
Seat 4: PerpetualNew (big blind) collected ($0.05)
Seat 5: Gonzalogo folded before Flop (didn't bet)
Seat 6: the_wickstar folded on the Flop
Seat 7: daNeck88 folded before Flop (didn't bet)
Seat 8: schiebe444 folded before Flop (didn't bet)
Seat 9: ronan33 folded before Flop (didn't bet)


*********** # 157 **************
PokerStars Hand #169677672017:  Hold'em No Limit ($0.01/$0.02 USD) - 20=
17/04/29 3:34:34 CUST [2017/04/28 13:34:34 ET]
Table 'Scythia' 9-max Seat #7 is the button
Seat 3: the_wickstar ($0.63 in chips)=20
Seat 4: Lazomaz ($3.77 in chips)=20
Seat 5: bootlessly ($0.66 in chips)=20
Seat 6: CiaranMu ($2.15 in chips)=20
Seat 7: Joaovdn ($2.32 in chips)=20
Seat 8: krome20 ($2.01 in chips)=20
Seat 9: super =9Eelva ($2 in chips)=20
krome20: posts small blind $0.01
super =9Eelva: posts big blind $0.02
PerpetualNew: sits out=20
Petasi: sits out=20
*** HOLE CARDS ***
Dealt to the_wickstar [Kh 4s]
the_wickstar: folds=20
Lazomaz: folds=20
bootlessly: folds=20
CiaranMu: calls $0.02
Joaovdn: calls $0.02
krome20: calls $0.01
super =9Eelva: checks=20
*** FLOP *** [6h 2d 5h]
krome20: checks=20
super =9Eelva: bets $0.06
CiaranMu: folds=20
Joaovdn: folds=20
krome20: folds=20
Uncalled bet ($0.06) returned to super =9Eelva
super =9Eelva collected $0.08 from pot
super =9Eelva: doesn't show hand=20
*** SUMMARY ***
Total pot $0.08 | Rake $0=20
Board [6h 2d 5h]
Seat 3: the_wickstar folded before Flop (didn't bet)
Seat 4: Lazomaz folded before Flop (didn't bet)
Seat 5: bootlessly folded before Flop (didn't bet)
Seat 6: CiaranMu folded on the Flop
Seat 7: Joaovdn (button) folded on the Flop
Seat 8: krome20 (small blind) folded on the Flop
Seat 9: super =9Eelva (big blind) collected ($0.08)


*********** # 158 **************
PokerStars Hand #169677658166:  Hold'em No Limit ($0.01/$0.02 USD) - 20=
17/04/29 3:34:16 CUST [2017/04/28 13:34:16 ET]
Table 'Scythia' 9-max Seat #6 is the button
Seat 3: the_wickstar ($0.63 in chips)=20
Seat 4: Lazomaz ($3.77 in chips)=20
Seat 5: bootlessly ($0.66 in chips)=20
Seat 6: CiaranMu ($2.15 in chips)=20
Seat 7: Joaovdn ($2.33 in chips)=20
Seat 8: krome20 ($2 in chips)=20
Joaovdn: posts small blind $0.01
krome20: posts big blind $0.02
super =9Eelva: sits out=20
PerpetualNew: sits out=20
Petasi: sits out=20
*** HOLE CARDS ***
Dealt to the_wickstar [7s 5h]
the_wickstar: folds=20
Lazomaz: folds=20
bootlessly: folds=20
CiaranMu: folds=20
Joaovdn: folds=20
Uncalled bet ($0.01) returned to krome20
krome20 collected $0.02 from pot
krome20: doesn't show hand=20
*** SUMMARY ***
Total pot $0.02 | Rake $0=20
Seat 3: the_wickstar folded before Flop (didn't bet)
Seat 4: Lazomaz folded before Flop (didn't bet)
Seat 5: bootlessly folded before Flop (didn't bet)
Seat 6: CiaranMu (button) folded before Flop (didn't bet)
Seat 7: Joaovdn (small blind) folded before Flop
Seat 8: krome20 (big blind) collected ($0.02)


*********** # 159 **************
PokerStars Hand #169677631732:  Hold'em No Limit ($0.01/$0.02 USD) - 20=
17/04/29 3:33:40 CUST [2017/04/28 13:33:40 ET]
Table 'Electra' 9-max Seat #1 is the button
Seat 1: IceMan 62289 ($1.54 in chips)=20
Seat 2: dadofaca ($2 in chips)=20
Seat 3: julio.jacob1 ($2.14 in chips)=20
Seat 5: Gonzalogo ($2.14 in chips)=20
Seat 6: the_wickstar ($2.08 in chips)=20
Seat 7: daNeck88 ($2 in chips)=20
Seat 8: schiebe444 ($2.55 in chips)=20
Seat 9: ronan33 ($2 in chips)=20
dadofaca: posts small blind $0.01
julio.jacob1: posts big blind $0.02
PerpetualNew: sits out=20
*** HOLE CARDS ***
Dealt to the_wickstar [4d 5c]
Gonzalogo: folds=20
the_wickstar: folds=20
daNeck88: folds=20
schiebe444: folds=20
ronan33: folds=20
IceMan 62289: raises $0.04 to $0.06
dadofaca: calls $0.05
julio.jacob1: folds=20
*** FLOP *** [As Kd 2d]
dadofaca: bets $0.06
IceMan 62289: calls $0.06
*** TURN *** [As Kd 2d] [Ks]
dadofaca: checks=20
IceMan 62289: checks=20
*** RIVER *** [As Kd 2d Ks] [4s]
dadofaca: checks=20
IceMan 62289: bets $0.18
dadofaca: folds=20
Uncalled bet ($0.18) returned to IceMan 62289
IceMan 62289 collected $0.25 from pot
IceMan 62289: doesn't show hand=20
*** SUMMARY ***
Total pot $0.26 | Rake $0.01=20
Board [As Kd 2d Ks 4s]
Seat 1: IceMan 62289 (button) collected ($0.25)
Seat 2: dadofaca (small blind) folded on the River
Seat 3: julio.jacob1 (big blind) folded before Flop
Seat 5: Gonzalogo folded before Flop (didn't bet)
Seat 6: the_wickstar folded before Flop (didn't bet)
Seat 7: daNeck88 folded before Flop (didn't bet)
Seat 8: schiebe444 folded before Flop (didn't bet)
Seat 9: ronan33 folded before Flop (didn't bet)


*********** # 160 **************
PokerStars Hand #169677618008:  Hold'em No Limit ($0.01/$0.02 USD) - 20=
17/04/29 3:33:22 CUST [2017/04/28 13:33:22 ET]
Table 'Scythia' 9-max Seat #5 is the button
Seat 3: the_wickstar ($0.58 in chips)=20
Seat 4: Lazomaz ($3.77 in chips)=20
Seat 5: bootlessly ($0.68 in chips)=20
Seat 6: CiaranMu ($2.16 in chips)=20
Seat 7: Joaovdn ($2.35 in chips)=20
CiaranMu: posts small blind $0.01
Joaovdn: posts big blind $0.02
krome20: sits out=20
PerpetualNew: sits out=20
*** HOLE CARDS ***
Dealt to the_wickstar [Qh 9h]
the_wickstar: calls $0.02
super =9Eelva joins the table at seat #9=20
Petasi joins the table at seat #2=20
Lazomaz: folds=20
bootlessly: calls $0.02
CiaranMu: folds=20
Joaovdn: checks=20
*** FLOP *** [6d 2c 2s]
Joaovdn: checks=20
the_wickstar: checks=20
bootlessly: checks=20
*** TURN *** [6d 2c 2s] [Ac]
Joaovdn: checks=20
the_wickstar: bets $0.04
bootlessly: folds=20
Joaovdn: folds=20
Uncalled bet ($0.04) returned to the_wickstar
the_wickstar collected $0.07 from pot
*** SUMMARY ***
Total pot $0.07 | Rake $0=20
Board [6d 2c 2s Ac]
Seat 3: the_wickstar collected ($0.07)
Seat 4: Lazomaz folded before Flop (didn't bet)
Seat 5: bootlessly (button) folded on the Turn
Seat 6: CiaranMu (small blind) folded before Flop
Seat 7: Joaovdn (big blind) folded on the Turn


*********** # 161 **************
PokerStars Hand #169677599008:  Hold'em No Limit ($0.01/$0.02 USD) - 20=
17/04/29 3:32:57 CUST [2017/04/28 13:32:57 ET]
Table 'Scythia' 9-max Seat #4 is the button
Seat 3: the_wickstar ($0.58 in chips)=20
Seat 4: Lazomaz ($3.77 in chips)=20
Seat 5: bootlessly ($0.69 in chips)=20
Seat 6: CiaranMu ($2.18 in chips)=20
Seat 7: Joaovdn ($2.32 in chips)=20
bootlessly: posts small blind $0.01
CiaranMu: posts big blind $0.02
krome20: sits out=20
PerpetualNew: sits out=20
*** HOLE CARDS ***
Dealt to the_wickstar [9h Qd]
Joaovdn: raises $0.04 to $0.06
the_wickstar: folds=20
Lazomaz: folds=20
bootlessly: folds=20
CiaranMu: folds=20
Uncalled bet ($0.04) returned to Joaovdn
Joaovdn collected $0.05 from pot
Joaovdn: doesn't show hand=20
*** SUMMARY ***
Total pot $0.05 | Rake $0=20
Seat 3: the_wickstar folded before Flop (didn't bet)
Seat 4: Lazomaz (button) folded before Flop (didn't bet)
Seat 5: bootlessly (small blind) folded before Flop
Seat 6: CiaranMu (big blind) folded before Flop
Seat 7: Joaovdn collected ($0.05)


*********** # 162 **************
PokerStars Hand #169677563363:  Hold'em No Limit ($0.01/$0.02 USD) - 20=
17/04/29 3:32:09 CUST [2017/04/28 13:32:09 ET]
Table 'Scythia' 9-max Seat #3 is the button
Seat 3: the_wickstar ($0.58 in chips)=20
Seat 4: Lazomaz ($3.78 in chips)=20
Seat 5: bootlessly ($1.11 in chips)=20
Seat 6: CiaranMu ($2.26 in chips)=20
Seat 7: Joaovdn ($1.84 in chips)=20
Lazomaz: posts small blind $0.01
bootlessly: posts big blind $0.02
krome20: sits out=20
PerpetualNew: sits out=20
*** HOLE CARDS ***
Dealt to the_wickstar [5c 7c]
CiaranMu: calls $0.02
Joaovdn: raises $0.06 to $0.08
the_wickstar: folds=20
Lazomaz: folds=20
bootlessly: calls $0.06
CiaranMu: calls $0.06
*** FLOP *** [Js 3s 9c]
bootlessly: checks=20
CiaranMu: checks=20
Joaovdn: bets $0.12
bootlessly: calls $0.12
CiaranMu: folds=20
*** TURN *** [Js 3s 9c] [2c]
bootlessly: checks=20
Joaovdn: bets $0.22
bootlessly: calls $0.22
*** RIVER *** [Js 3s 9c 2c] [9d]
bootlessly: checks=20
Joaovdn: bets $0.44
bootlessly: folds=20
Uncalled bet ($0.44) returned to Joaovdn
Joaovdn collected $0.90 from pot
Joaovdn: doesn't show hand=20
*** SUMMARY ***
Total pot $0.93 | Rake $0.03=20
Board [Js 3s 9c 2c 9d]
Seat 3: the_wickstar (button) folded before Flop (didn't bet)
Seat 4: Lazomaz (small blind) folded before Flop
Seat 5: bootlessly (big blind) folded on the River
Seat 6: CiaranMu folded on the Flop
Seat 7: Joaovdn collected ($0.90)


*********** # 163 **************
PokerStars Hand #169677554624:  Hold'em No Limit ($0.01/$0.02 USD) - 20=
17/04/29 3:31:57 CUST [2017/04/28 13:31:57 ET]
Table 'Electra' 9-max Seat #9 is the button
Seat 1: IceMan 62289 ($1.55 in chips)=20
Seat 2: dadofaca ($2 in chips)=20
Seat 3: julio.jacob1 ($2.14 in chips)=20
Seat 5: Gonzalogo ($2.14 in chips)=20
Seat 6: the_wickstar ($2.08 in chips)=20
Seat 7: daNeck88 ($2 in chips)=20
Seat 8: schiebe444 ($2 in chips)=20
Seat 9: ronan33 ($2.55 in chips)=20
IceMan 62289: posts small blind $0.01
dadofaca: posts big blind $0.02
PerpetualNew: sits out=20
schiebe444: posts big blind $0.02
*** HOLE CARDS ***
Dealt to the_wickstar [Qs 3d]
julio.jacob1: folds=20
Gonzalogo: folds=20
the_wickstar: folds=20
daNeck88: folds=20
schiebe444: checks=20
ronan33: calls $0.02
IceMan 62289: folds=20
dadofaca: checks=20
*** FLOP *** [6c 9d Ah]
dadofaca: checks=20
schiebe444: checks=20
ronan33: bets $0.04
dadofaca: folds=20
schiebe444: calls $0.04
*** TURN *** [6c 9d Ah] [7s]
schiebe444: bets $0.08
ronan33: calls $0.08
*** RIVER *** [6c 9d Ah 7s] [Jc]
schiebe444: bets $0.14
ronan33: raises $0.14 to $0.28
schiebe444: raises $0.14 to $0.42
ronan33: calls $0.14
*** SHOW DOWN ***
schiebe444: shows [8h Th] (a straight, Seven to Jack)
ronan33: mucks hand=20
schiebe444 collected $1.11 from pot
*** SUMMARY ***
Total pot $1.15 | Rake $0.04=20
Board [6c 9d Ah 7s Jc]
Seat 1: IceMan 62289 (small blind) folded before Flop
Seat 2: dadofaca (big blind) folded on the Flop
Seat 3: julio.jacob1 folded before Flop (didn't bet)
Seat 5: Gonzalogo folded before Flop (didn't bet)
Seat 6: the_wickstar folded before Flop (didn't bet)
Seat 7: daNeck88 folded before Flop (didn't bet)
Seat 8: schiebe444 showed [8h Th] and won ($1.11) with a straight, Seve=
n to Jack
Seat 9: ronan33 (button) mucked [9h Ad]


*********** # 164 **************
PokerStars Hand #169677529641:  Hold'em No Limit ($0.01/$0.02 USD) - 20=
17/04/29 3:31:24 CUST [2017/04/28 13:31:24 ET]
Table 'Scythia' 9-max Seat #7 is the button
Seat 3: the_wickstar ($0.41 in chips)=20
Seat 4: Lazomaz ($3.84 in chips)=20
Seat 5: bootlessly ($1.11 in chips)=20
Seat 6: CiaranMu ($2.32 in chips)=20
Seat 7: Joaovdn ($1.90 in chips)=20
PerpetualNew will be allowed to play after the button
the_wickstar: posts small blind $0.01
Lazomaz: posts big blind $0.02
*** HOLE CARDS ***
Dealt to the_wickstar [Js Qh]
bootlessly: folds=20
CiaranMu: raises $0.04 to $0.06
Joaovdn: calls $0.06
the_wickstar: calls $0.05
Lazomaz: calls $0.04
*** FLOP *** [Jh 6s 2h]
the_wickstar: bets $0.35 and is all-in
krome20 joins the table at seat #8=20
Lazomaz: folds=20
CiaranMu: folds=20
Joaovdn: folds=20
Uncalled bet ($0.35) returned to the_wickstar
the_wickstar collected $0.23 from pot
*** SUMMARY ***
Total pot $0.24 | Rake $0.01=20
Board [Jh 6s 2h]
Seat 3: the_wickstar (small blind) collected ($0.23)
Seat 4: Lazomaz (big blind) folded on the Flop
Seat 5: bootlessly folded before Flop (didn't bet)
Seat 6: CiaranMu folded on the Flop
Seat 7: Joaovdn (button) folded on the Flop


*********** # 165 **************
PokerStars Hand #169677500841:  Hold'em No Limit ($0.01/$0.02 USD) - 20=
17/04/29 3:30:46 CUST [2017/04/28 13:30:46 ET]
Table 'Scythia' 9-max Seat #6 is the button
Seat 3: the_wickstar ($0.43 in chips)=20
Seat 4: Lazomaz ($3.41 in chips)=20
Seat 5: bootlessly ($1.54 in chips)=20
Seat 6: CiaranMu ($2.32 in chips)=20
Seat 7: Joaovdn ($1.91 in chips)=20
Joaovdn: posts small blind $0.01
MAGNUSVAGNER: is sitting out=20
the_wickstar: posts big blind $0.02
bootlessly: posts big blind $0.02
*** HOLE CARDS ***
Dealt to the_wickstar [Qc 7h]
Lazomaz: raises $0.08 to $0.10
bootlessly: calls $0.08
CiaranMu: folds=20
Joaovdn: folds=20
the_wickstar: folds=20
*** FLOP *** [3h Qh 5d]
Lazomaz: bets $0.11
bootlessly: calls $0.11
*** TURN *** [3h Qh 5d] [8c]
Lazomaz: checks=20
bootlessly: bets $0.22
Lazomaz: calls $0.22
*** RIVER *** [3h Qh 5d 8c] [Jc]
Lazomaz: checks=20
bootlessly: checks=20
*** SHOW DOWN ***
Lazomaz: shows [9d 9h] (a pair of Nines)
bootlessly: mucks hand=20
MAGNUSVAGNER leaves the table
Lazomaz collected $0.86 from pot
*** SUMMARY ***
Total pot $0.89 | Rake $0.03=20
Board [3h Qh 5d 8c Jc]
Seat 3: the_wickstar (big blind) folded before Flop
Seat 4: Lazomaz showed [9d 9h] and won ($0.86) with a pair of Nines
Seat 5: bootlessly mucked [Ac Kh]
Seat 6: CiaranMu (button) folded before Flop (didn't bet)
Seat 7: Joaovdn (small blind) folded before Flop


*********** # 166 **************
PokerStars Hand #169677479640:  Hold'em No Limit ($0.01/$0.02 USD) - 20=
17/04/29 3:30:17 CUST [2017/04/28 13:30:17 ET]
Table 'Electra' 9-max Seat #7 is the button
Seat 1: IceMan 62289 ($1.97 in chips)=20
Seat 2: dadofaca ($2 in chips)=20
Seat 3: julio.jacob1 ($2.14 in chips)=20
Seat 5: Gonzalogo ($2.14 in chips)=20
Seat 6: the_wickstar ($2.08 in chips)=20
Seat 7: daNeck88 ($2 in chips)=20
Seat 9: ronan33 ($2.16 in chips)=20
ronan33: posts small blind $0.01
IceMan 62289: posts big blind $0.02
*** HOLE CARDS ***
Dealt to the_wickstar [6h 2c]
dadofaca: folds=20
julio.jacob1: folds=20
Gonzalogo: folds=20
the_wickstar: folds=20
daNeck88: folds=20
ronan33: raises $0.04 to $0.06
IceMan 62289: calls $0.04
*** FLOP *** [Th Qh Kh]
ronan33: bets $0.06
IceMan 62289: calls $0.06
*** TURN *** [Th Qh Kh] [8s]
ronan33: checks=20
IceMan 62289: bets $0.12
ronan33: calls $0.12
*** RIVER *** [Th Qh Kh 8s] [Td]
schiebe444 joins the table at seat #8=20
ronan33: bets $0.18
IceMan 62289: calls $0.18
*** SHOW DOWN ***
ronan33: shows [Ah As] (two pair, Aces and Tens)
IceMan 62289: mucks hand=20
ronan33 collected $0.81 from pot
*** SUMMARY ***
Total pot $0.84 | Rake $0.03=20
Board [Th Qh Kh 8s Td]
Seat 1: IceMan 62289 (big blind) mucked [Jd Ks]
Seat 2: dadofaca folded before Flop (didn't bet)
Seat 3: julio.jacob1 folded before Flop (didn't bet)
Seat 5: Gonzalogo folded before Flop (didn't bet)
Seat 6: the_wickstar folded before Flop (didn't bet)
Seat 7: daNeck88 (button) folded before Flop (didn't bet)
Seat 9: ronan33 (small blind) showed [Ah As] and won ($0.81) with two p=
air, Aces and Tens


*********** # 167 **************
PokerStars Hand #169677454419:  Hold'em No Limit ($0.01/$0.02 USD) - 20=
17/04/29 3:29:44 CUST [2017/04/28 13:29:44 ET]
Table 'Electra' 9-max Seat #6 is the button
Seat 1: IceMan 62289 ($1.97 in chips)=20
Seat 2: dadofaca ($2 in chips)=20
Seat 3: julio.jacob1 ($2.14 in chips)=20
Seat 5: Gonzalogo ($2.14 in chips)=20
Seat 6: the_wickstar ($2.08 in chips)=20
Seat 7: daNeck88 ($2.01 in chips)=20
Seat 9: ronan33 ($2.15 in chips)=20
daNeck88: posts small blind $0.01
elenkachumak: is sitting out=20
ronan33: posts big blind $0.02
elenkachumak leaves the table
*** HOLE CARDS ***
Dealt to the_wickstar [4d Td]
IceMan 62289: folds=20
dadofaca: folds=20
julio.jacob1: folds=20
Gonzalogo: folds=20
the_wickstar: folds=20
daNeck88: folds=20
Uncalled bet ($0.01) returned to ronan33
ronan33 collected $0.02 from pot
ronan33: doesn't show hand=20
*** SUMMARY ***
Total pot $0.02 | Rake $0=20
Seat 1: IceMan 62289 folded before Flop (didn't bet)
Seat 2: dadofaca folded before Flop (didn't bet)
Seat 3: julio.jacob1 folded before Flop (didn't bet)
Seat 5: Gonzalogo folded before Flop (didn't bet)
Seat 6: the_wickstar (button) folded before Flop (didn't bet)
Seat 7: daNeck88 (small blind) folded before Flop
Seat 9: ronan33 (big blind) collected ($0.02)


*********** # 168 **************
PokerStars Hand #169677454174:  Hold'em No Limit ($0.01/$0.02 USD) - 20=
17/04/29 3:29:44 CUST [2017/04/28 13:29:44 ET]
Table 'Scythia' 9-max Seat #4 is the button
Seat 3: the_wickstar ($0.43 in chips)=20
Seat 4: Lazomaz ($3.47 in chips)=20
Seat 6: CiaranMu ($1.98 in chips)=20
Seat 7: Joaovdn ($2.21 in chips)=20
Seat 8: vic_lucky777 ($1.06 in chips)=20
Seat 9: MAGNUSVAGNER ($2.69 in chips)=20
bootlessly will be allowed to play after the button
CiaranMu: posts small blind $0.01
Joaovdn: posts big blind $0.02
*** HOLE CARDS ***
Dealt to the_wickstar [6d Ks]
vic_lucky777: folds=20
MAGNUSVAGNER: folds=20
vic_lucky777 leaves the table
the_wickstar: folds=20
Lazomaz: raises $0.04 to $0.06
CiaranMu: calls $0.05
Joaovdn: calls $0.04
*** FLOP *** [7s 6c 2h]
CiaranMu: checks=20
Joaovdn: checks=20
Lazomaz: checks=20
*** TURN *** [7s 6c 2h] [5d]
CiaranMu: bets $0.08
Joaovdn: calls $0.08
Lazomaz: folds=20
*** RIVER *** [7s 6c 2h 5d] [2c]
CiaranMu: bets $0.16
Joaovdn: calls $0.16
*** SHOW DOWN ***
CiaranMu: shows [As 7c] (two pair, Sevens and Deuces)
Joaovdn: mucks hand=20
CiaranMu collected $0.64 from pot
*** SUMMARY ***
Total pot $0.66 | Rake $0.02=20
Board [7s 6c 2h 5d 2c]
Seat 3: the_wickstar folded before Flop (didn't bet)
Seat 4: Lazomaz (button) folded on the Turn
Seat 6: CiaranMu (small blind) showed [As 7c] and won ($0.64) with two =
pair, Sevens and Deuces
Seat 7: Joaovdn (big blind) mucked [7h Jh]
Seat 8: vic_lucky777 folded before Flop (didn't bet)
Seat 9: MAGNUSVAGNER folded before Flop (didn't bet)


*********** # 169 **************
PokerStars Hand #169677434632:  Hold'em No Limit ($0.01/$0.02 USD) - 20=
17/04/29 3:29:17 CUST [2017/04/28 13:29:17 ET]
Table 'Scythia' 9-max Seat #3 is the button
Seat 3: the_wickstar ($0.40 in chips)=20
Seat 4: Lazomaz ($3.48 in chips)=20
Seat 6: CiaranMu ($2 in chips)=20
Seat 7: Joaovdn ($2.21 in chips)=20
Seat 8: vic_lucky777 ($1.06 in chips)=20
Seat 9: MAGNUSVAGNER ($2.69 in chips)=20
Lazomaz: posts small blind $0.01
FidgetyWins: is sitting out=20
CiaranMu: posts big blind $0.02
*** HOLE CARDS ***
Dealt to the_wickstar [Tc Ac]
FidgetyWins leaves the table
Joaovdn: folds=20
vic_lucky777: folds=20
MAGNUSVAGNER: folds=20
the_wickstar: raises $0.04 to $0.06
PerpetualNew is disconnected=20
bootlessly joins the table at seat #5=20
Lazomaz: folds=20
CiaranMu: folds=20
Uncalled bet ($0.04) returned to the_wickstar
the_wickstar collected $0.05 from pot
*** SUMMARY ***
Total pot $0.05 | Rake $0=20
Seat 3: the_wickstar (button) collected ($0.05)
Seat 4: Lazomaz (small blind) folded before Flop
Seat 6: CiaranMu (big blind) folded before Flop
Seat 7: Joaovdn folded before Flop (didn't bet)
Seat 8: vic_lucky777 folded before Flop (didn't bet)
Seat 9: MAGNUSVAGNER folded before Flop (didn't bet)


*********** # 170 **************
PokerStars Hand #169677429260:  Hold'em No Limit ($0.01/$0.02 USD) - 20=
17/04/29 3:29:10 CUST [2017/04/28 13:29:10 ET]
Table 'Electra' 9-max Seat #5 is the button
Seat 1: IceMan 62289 ($1.97 in chips)=20
Seat 2: dadofaca ($2 in chips)=20
Seat 3: julio.jacob1 ($2.14 in chips)=20
Seat 5: Gonzalogo ($2.14 in chips)=20
Seat 6: the_wickstar ($2.09 in chips)=20
Seat 7: daNeck88 ($2 in chips)=20
Seat 8: elenkachumak ($1.28 in chips)=20
Seat 9: ronan33 ($2.15 in chips)=20
the_wickstar: posts small blind $0.01
daNeck88: posts big blind $0.02
*** HOLE CARDS ***
Dealt to the_wickstar [5d 3s]
elenkachumak: folds=20
ronan33: folds=20
IceMan 62289: folds=20
dadofaca: folds=20
PerpetualNew is disconnected=20
julio.jacob1: folds=20
Gonzalogo: folds=20
the_wickstar: folds=20
Uncalled bet ($0.01) returned to daNeck88
daNeck88 collected $0.02 from pot
daNeck88: doesn't show hand=20
*** SUMMARY ***
Total pot $0.02 | Rake $0=20
Seat 1: IceMan 62289 folded before Flop (didn't bet)
Seat 2: dadofaca folded before Flop (didn't bet)
Seat 3: julio.jacob1 folded before Flop (didn't bet)
Seat 5: Gonzalogo (button) folded before Flop (didn't bet)
Seat 6: the_wickstar (small blind) folded before Flop
Seat 7: daNeck88 (big blind) collected ($0.02)
Seat 8: elenkachumak folded before Flop (didn't bet)
Seat 9: ronan33 folded before Flop (didn't bet)


*********** # 171 **************
PokerStars Hand #169677411135:  Hold'em No Limit ($0.01/$0.02 USD) - 20=
17/04/29 3:28:45 CUST [2017/04/28 13:28:45 ET]
Table 'Scythia' 9-max Seat #9 is the button
Seat 3: the_wickstar ($0.41 in chips)=20
Seat 4: Lazomaz ($3.50 in chips)=20
Seat 5: FidgetyWins ($2.90 in chips)=20
Seat 7: Joaovdn ($2.18 in chips)=20
Seat 8: vic_lucky777 ($1.06 in chips)=20
Seat 9: MAGNUSVAGNER ($2.69 in chips)=20
the_wickstar: posts small blind $0.01
Lazomaz: posts big blind $0.02
CiaranMu: sits out=20
*** HOLE CARDS ***
Dealt to the_wickstar [7c 8d]
FidgetyWins: folds=20
Joaovdn: raises $0.04 to $0.06
vic_lucky777: folds=20
MAGNUSVAGNER: folds=20
the_wickstar: folds=20
Lazomaz: folds=20
Uncalled bet ($0.04) returned to Joaovdn
Joaovdn collected $0.05 from pot
Joaovdn: doesn't show hand=20
*** SUMMARY ***
Total pot $0.05 | Rake $0=20
Seat 3: the_wickstar (small blind) folded before Flop
Seat 4: Lazomaz (big blind) folded before Flop
Seat 5: FidgetyWins folded before Flop (didn't bet)
Seat 7: Joaovdn collected ($0.05)
Seat 8: vic_lucky777 folded before Flop (didn't bet)
Seat 9: MAGNUSVAGNER (button) folded before Flop (didn't bet)


*********** # 172 **************
PokerStars Hand #169677403475:  Hold'em No Limit ($0.01/$0.02 USD) - 20=
17/04/29 3:28:35 CUST [2017/04/28 13:28:35 ET]
Table 'Electra' 9-max Seat #3 is the button
Seat 1: IceMan 62289 ($1.97 in chips)=20
Seat 2: dadofaca ($2 in chips)=20
Seat 3: julio.jacob1 ($2.11 in chips)=20
Seat 5: Gonzalogo ($2.15 in chips)=20
Seat 6: the_wickstar ($2.11 in chips)=20
Seat 7: daNeck88 ($2 in chips)=20
Seat 8: elenkachumak ($1.28 in chips)=20
Seat 9: ronan33 ($2.15 in chips)=20
Gonzalogo: posts small blind $0.01
the_wickstar: posts big blind $0.02
*** HOLE CARDS ***
Dealt to the_wickstar [Td 8d]
daNeck88: folds=20
elenkachumak: folds=20
ronan33: folds=20
IceMan 62289: folds=20
dadofaca: folds=20
julio.jacob1: raises $0.04 to $0.06
Gonzalogo: folds=20
the_wickstar: folds=20
Uncalled bet ($0.04) returned to julio.jacob1
julio.jacob1 collected $0.05 from pot
julio.jacob1: doesn't show hand=20
*** SUMMARY ***
Total pot $0.05 | Rake $0=20
Seat 1: IceMan 62289 folded before Flop (didn't bet)
Seat 2: dadofaca folded before Flop (didn't bet)
Seat 3: julio.jacob1 (button) collected ($0.05)
Seat 5: Gonzalogo (small blind) folded before Flop
Seat 6: the_wickstar (big blind) folded before Flop
Seat 7: daNeck88 folded before Flop (didn't bet)
Seat 8: elenkachumak folded before Flop (didn't bet)
Seat 9: ronan33 folded before Flop (didn't bet)


*********** # 173 **************
PokerStars Hand #169677362034:  Hold'em No Limit ($0.01/$0.02 USD) - 20=
17/04/29 3:27:40 CUST [2017/04/28 13:27:40 ET]
Table 'Electra' 9-max Seat #2 is the button
Seat 1: IceMan 62289 ($1.97 in chips)=20
Seat 2: dadofaca ($2 in chips)=20
Seat 3: julio.jacob1 ($2.09 in chips)=20
Seat 5: Gonzalogo ($2.17 in chips)=20
Seat 6: the_wickstar ($2.11 in chips)=20
Seat 7: daNeck88 ($2 in chips)=20
Seat 8: elenkachumak ($1.28 in chips)=20
Seat 9: ronan33 ($2.15 in chips)=20
julio.jacob1: posts small blind $0.01
PerpetualNew has timed out
PerpetualNew: is sitting out=20
Gonzalogo: posts big blind $0.02
*** HOLE CARDS ***
Dealt to the_wickstar [Jh 2h]
the_wickstar: folds=20
daNeck88: folds=20
elenkachumak: folds=20
ronan33: folds=20
IceMan 62289: folds=20
dadofaca: folds=20
julio.jacob1: raises $0.04 to $0.06
Gonzalogo: folds=20
Uncalled bet ($0.04) returned to julio.jacob1
julio.jacob1 collected $0.04 from pot
julio.jacob1: doesn't show hand=20
*** SUMMARY ***
Total pot $0.04 | Rake $0=20
Seat 1: IceMan 62289 folded before Flop (didn't bet)
Seat 2: dadofaca (button) folded before Flop (didn't bet)
Seat 3: julio.jacob1 (small blind) collected ($0.04)
Seat 5: Gonzalogo (big blind) folded before Flop
Seat 6: the_wickstar folded before Flop (didn't bet)
Seat 7: daNeck88 folded before Flop (didn't bet)
Seat 8: elenkachumak folded before Flop (didn't bet)
Seat 9: ronan33 folded before Flop (didn't bet)


*********** # 174 **************
PokerStars Hand #169677353750:  Hold'em No Limit ($0.01/$0.02 USD) - 20=
17/04/29 3:27:29 CUST [2017/04/28 13:27:29 ET]
Table 'Scythia' 9-max Seat #8 is the button
Seat 1: PerpetualNew ($2 in chips)=20
Seat 2: Igor693 ($2.69 in chips)=20
Seat 3: the_wickstar ($0.41 in chips)=20
Seat 4: Lazomaz ($3.50 in chips)=20
Seat 5: FidgetyWins ($2.90 in chips)=20
Seat 7: Joaovdn ($2.15 in chips)=20
Seat 8: vic_lucky777 ($1.06 in chips)=20
Seat 9: MAGNUSVAGNER ($2.70 in chips)=20
MAGNUSVAGNER: posts small blind $0.01
PerpetualNew: posts big blind $0.02
CiaranMu: sits out=20
*** HOLE CARDS ***
Dealt to the_wickstar [Kh 9c]
Igor693: folds=20
Igor693 leaves the table
the_wickstar: folds=20
Lazomaz: folds=20
FidgetyWins: folds=20
Joaovdn: raises $0.04 to $0.06
vic_lucky777: folds=20
MAGNUSVAGNER: folds=20
PerpetualNew has timed out
PerpetualNew: folds=20
Uncalled bet ($0.04) returned to Joaovdn
Joaovdn collected $0.05 from pot
Joaovdn: doesn't show hand=20
*** SUMMARY ***
Total pot $0.05 | Rake $0=20
Seat 1: PerpetualNew (big blind) folded before Flop
Seat 2: Igor693 folded before Flop (didn't bet)
Seat 3: the_wickstar folded before Flop (didn't bet)
Seat 4: Lazomaz folded before Flop (didn't bet)
Seat 5: FidgetyWins folded before Flop (didn't bet)
Seat 7: Joaovdn collected ($0.05)
Seat 8: vic_lucky777 (button) folded before Flop (didn't bet)
Seat 9: MAGNUSVAGNER (small blind) folded before Flop


*********** # 175 **************
PokerStars Hand #169677331551:  Hold'em No Limit ($0.01/$0.02 USD) - 20=
17/04/29 3:26:58 CUST [2017/04/28 13:26:58 ET]
Table 'Scythia' 9-max Seat #7 is the button
Seat 2: Igor693 ($2.69 in chips)=20
Seat 3: the_wickstar ($0.38 in chips)=20
Seat 4: Lazomaz ($3.50 in chips)=20
Seat 5: FidgetyWins ($2.90 in chips)=20
Seat 7: Joaovdn ($2.15 in chips)=20
Seat 8: vic_lucky777 ($1.07 in chips)=20
Seat 9: MAGNUSVAGNER ($2.72 in chips)=20
vic_lucky777: posts small blind $0.01
MAGNUSVAGNER: posts big blind $0.02
CiaranMu: sits out=20
*** HOLE CARDS ***
Dealt to the_wickstar [Ah Kc]
Igor693: folds=20
PerpetualNew joins the table at seat #1=20
the_wickstar: raises $0.06 to $0.08
Lazomaz: folds=20
FidgetyWins: folds=20
Joaovdn: folds=20
vic_lucky777: folds=20
MAGNUSVAGNER: folds=20
Uncalled bet ($0.06) returned to the_wickstar
the_wickstar collected $0.05 from pot
*** SUMMARY ***
Total pot $0.05 | Rake $0=20
Seat 2: Igor693 folded before Flop (didn't bet)
Seat 3: the_wickstar collected ($0.05)
Seat 4: Lazomaz folded before Flop (didn't bet)
Seat 5: FidgetyWins folded before Flop (didn't bet)
Seat 7: Joaovdn (button) folded before Flop (didn't bet)
Seat 8: vic_lucky777 (small blind) folded before Flop
Seat 9: MAGNUSVAGNER (big blind) folded before Flop


*********** # 176 **************
PokerStars Hand #169677315335:  Hold'em No Limit ($0.01/$0.02 USD) - 20=
17/04/29 3:26:37 CUST [2017/04/28 13:26:37 ET]
Table 'Electra' 9-max Seat #1 is the button
Seat 1: IceMan 62289 ($1.97 in chips)=20
Seat 2: dadofaca ($2.01 in chips)=20
Seat 3: julio.jacob1 ($2.11 in chips)=20
Seat 5: Gonzalogo ($2 in chips)=20
Seat 6: the_wickstar ($2.11 in chips)=20
Seat 7: daNeck88 ($2.07 in chips)=20
Seat 8: elenkachumak ($1.28 in chips)=20
Seat 9: ronan33 ($2.15 in chips)=20
dadofaca: posts small blind $0.01
julio.jacob1: posts big blind $0.02
*** HOLE CARDS ***
Dealt to the_wickstar [9s 7h]
Gonzalogo: raises $0.04 to $0.06
PerpetualNew joins the table at seat #4=20
the_wickstar: folds=20
daNeck88: calls $0.06
elenkachumak: folds=20
ronan33: folds=20
IceMan 62289: folds=20
dadofaca: folds=20
julio.jacob1: folds=20
*** FLOP *** [7s 3c Kh]
Gonzalogo: bets $0.09
daNeck88: calls $0.09
*** TURN *** [7s 3c Kh] [As]
Gonzalogo: bets $0.21
daNeck88: folds=20
Uncalled bet ($0.21) returned to Gonzalogo
Gonzalogo collected $0.32 from pot
Gonzalogo: doesn't show hand=20
*** SUMMARY ***
Total pot $0.33 | Rake $0.01=20
Board [7s 3c Kh As]
Seat 1: IceMan 62289 (button) folded before Flop (didn't bet)
Seat 2: dadofaca (small blind) folded before Flop
Seat 3: julio.jacob1 (big blind) folded before Flop
Seat 5: Gonzalogo collected ($0.32)
Seat 6: the_wickstar folded before Flop (didn't bet)
Seat 7: daNeck88 folded on the Turn
Seat 8: elenkachumak folded before Flop (didn't bet)
Seat 9: ronan33 folded before Flop (didn't bet)


*********** # 177 **************
PokerStars Hand #169677307746:  Hold'em No Limit ($0.01/$0.02 USD) - 20=
17/04/29 3:26:26 CUST [2017/04/28 13:26:26 ET]
Table 'Scythia' 9-max Seat #5 is the button
Seat 1: 1Total_Flop1 ($0.93 in chips)=20
Seat 2: Igor693 ($2.69 in chips)=20
Seat 3: the_wickstar ($0.38 in chips)=20
Seat 4: Lazomaz ($3.50 in chips)=20
Seat 5: FidgetyWins ($2.90 in chips)=20
Seat 7: Joaovdn ($2.13 in chips)=20
Seat 8: vic_lucky777 ($1.09 in chips)=20
Seat 9: MAGNUSVAGNER ($2.72 in chips)=20
CiaranMu will be allowed to play after the button
Joaovdn: posts small blind $0.01
vic_lucky777: posts big blind $0.02
*** HOLE CARDS ***
Dealt to the_wickstar [4d 8d]
MAGNUSVAGNER: folds=20
1Total_Flop1: folds=20
Igor693: folds=20
the_wickstar: folds=20
1Total_Flop1 leaves the table
Lazomaz: folds=20
FidgetyWins: folds=20
Joaovdn: raises $0.04 to $0.06
vic_lucky777: folds=20
Uncalled bet ($0.04) returned to Joaovdn
Joaovdn collected $0.04 from pot
Joaovdn: doesn't show hand=20
*** SUMMARY ***
Total pot $0.04 | Rake $0=20
Seat 1: 1Total_Flop1 folded before Flop (didn't bet)
Seat 2: Igor693 folded before Flop (didn't bet)
Seat 3: the_wickstar folded before Flop (didn't bet)
Seat 4: Lazomaz folded before Flop (didn't bet)
Seat 5: FidgetyWins (button) folded before Flop (didn't bet)
Seat 7: Joaovdn (small blind) collected ($0.04)
Seat 8: vic_lucky777 (big blind) folded before Flop
Seat 9: MAGNUSVAGNER folded before Flop (didn't bet)


*********** # 178 **************
PokerStars Hand #169677275260:  Hold'em No Limit ($0.01/$0.02 USD) - 20=
17/04/29 3:25:43 CUST [2017/04/28 13:25:43 ET]
Table 'Electra' 9-max Seat #9 is the button
Seat 1: IceMan 62289 ($1.98 in chips)=20
Seat 2: dadofaca ($2.03 in chips)=20
Seat 3: julio.jacob1 ($2.08 in chips)=20
Seat 4: yjqian23 ($2.03 in chips)=20
Seat 5: Gonzalogo ($2 in chips)=20
Seat 6: the_wickstar ($2.11 in chips)=20
Seat 7: daNeck88 ($2.07 in chips)=20
Seat 8: elenkachumak ($1.28 in chips)=20
Seat 9: ronan33 ($2.15 in chips)=20
IceMan 62289: posts small blind $0.01
dadofaca: posts big blind $0.02
*** HOLE CARDS ***
Dealt to the_wickstar [Td Jh]
julio.jacob1: raises $0.04 to $0.06
yjqian23 has timed out
yjqian23: folds=20
Gonzalogo: folds=20
the_wickstar: folds=20
daNeck88: folds=20
elenkachumak: folds=20
yjqian23 leaves the table
ronan33: folds=20
IceMan 62289: folds=20
dadofaca: folds=20
Uncalled bet ($0.04) returned to julio.jacob1
julio.jacob1 collected $0.05 from pot
julio.jacob1: doesn't show hand=20
*** SUMMARY ***
Total pot $0.05 | Rake $0=20
Seat 1: IceMan 62289 (small blind) folded before Flop
Seat 2: dadofaca (big blind) folded before Flop
Seat 3: julio.jacob1 collected ($0.05)
Seat 4: yjqian23 folded before Flop (didn't bet)
Seat 5: Gonzalogo folded before Flop (didn't bet)
Seat 6: the_wickstar folded before Flop (didn't bet)
Seat 7: daNeck88 folded before Flop (didn't bet)
Seat 8: elenkachumak folded before Flop (didn't bet)
Seat 9: ronan33 (button) folded before Flop (didn't bet)


*********** # 179 **************
PokerStars Hand #169677263372:  Hold'em No Limit ($0.01/$0.02 USD) - 20=
17/04/29 3:25:27 CUST [2017/04/28 13:25:27 ET]
Table 'Scythia' 9-max Seat #4 is the button
Seat 1: 1Total_Flop1 ($1.48 in chips)=20
Seat 2: Igor693 ($2.69 in chips)=20
Seat 3: the_wickstar ($0.38 in chips)=20
Seat 4: Lazomaz ($3.50 in chips)=20
Seat 5: FidgetyWins ($2.91 in chips)=20
Seat 7: Joaovdn ($2.15 in chips)=20
Seat 8: vic_lucky777 ($0.55 in chips)=20
Seat 9: MAGNUSVAGNER ($2.72 in chips)=20
FidgetyWins: posts small blind $0.01
gastelo43: is sitting out=20
Joaovdn: posts big blind $0.02
*** HOLE CARDS ***
Dealt to the_wickstar [2h 5c]
vic_lucky777: calls $0.02
gastelo43 leaves the table
MAGNUSVAGNER: folds=20
CiaranMu joins the table at seat #6=20
1Total_Flop1: raises $0.08 to $0.10
Igor693: folds=20
the_wickstar: folds=20
Lazomaz: folds=20
FidgetyWins: folds=20
Joaovdn: folds=20
vic_lucky777: calls $0.08
*** FLOP *** [Td 8d Js]
vic_lucky777: bets $0.02
1Total_Flop1: raises $0.20 to $0.22
vic_lucky777: raises $0.23 to $0.45 and is all-in
1Total_Flop1: calls $0.23
*** TURN *** [Td 8d Js] [Ks]
*** RIVER *** [Td 8d Js Ks] [6c]
*** SHOW DOWN ***
vic_lucky777: shows [Kc Kd] (three of a kind, Kings)
1Total_Flop1: shows [8s Ts] (two pair, Tens and Eights)
vic_lucky777 collected $1.09 from pot
*** SUMMARY ***
Total pot $1.13 | Rake $0.04=20
Board [Td 8d Js Ks 6c]
Seat 1: 1Total_Flop1 showed [8s Ts] and lost with two pair, Tens and Ei=
ghts
Seat 2: Igor693 folded before Flop (didn't bet)
Seat 3: the_wickstar folded before Flop (didn't bet)
Seat 4: Lazomaz (button) folded before Flop (didn't bet)
Seat 5: FidgetyWins (small blind) folded before Flop
Seat 7: Joaovdn (big blind) folded before Flop
Seat 8: vic_lucky777 showed [Kc Kd] and won ($1.09) with three of a kin=
d, Kings
Seat 9: MAGNUSVAGNER folded before Flop (didn't bet)


*********** # 180 **************
PokerStars Hand #169677252854:  Hold'em No Limit ($0.01/$0.02 USD) - 20=
17/04/29 3:25:13 CUST [2017/04/28 13:25:13 ET]
Table 'Electra' 9-max Seat #8 is the button
Seat 1: IceMan 62289 ($2 in chips)=20
Seat 2: dadofaca ($2.03 in chips)=20
Seat 3: julio.jacob1 ($2.08 in chips)=20
Seat 4: yjqian23 ($2 in chips)=20
Seat 5: Gonzalogo ($2 in chips)=20
Seat 6: the_wickstar ($2.11 in chips)=20
Seat 7: daNeck88 ($2.07 in chips)=20
Seat 8: elenkachumak ($1.28 in chips)=20
Seat 9: ronan33 ($2.16 in chips)=20
ronan33: posts small blind $0.01
IceMan 62289: posts big blind $0.02
*** HOLE CARDS ***
Dealt to the_wickstar [6h 2s]
dadofaca: folds=20
julio.jacob1: folds=20
yjqian23: raises $0.02 to $0.04
Gonzalogo: folds=20
the_wickstar: folds=20
daNeck88: folds=20
elenkachumak: folds=20
ronan33: folds=20
IceMan 62289: folds=20
Uncalled bet ($0.02) returned to yjqian23
yjqian23 collected $0.05 from pot
*** SUMMARY ***
Total pot $0.05 | Rake $0=20
Seat 1: IceMan 62289 (big blind) folded before Flop
Seat 2: dadofaca folded before Flop (didn't bet)
Seat 3: julio.jacob1 folded before Flop (didn't bet)
Seat 4: yjqian23 collected ($0.05)
Seat 5: Gonzalogo folded before Flop (didn't bet)
Seat 6: the_wickstar folded before Flop (didn't bet)
Seat 7: daNeck88 folded before Flop (didn't bet)
Seat 8: elenkachumak (button) folded before Flop (didn't bet)
Seat 9: ronan33 (small blind) folded before Flop


*********** # 181 **************
PokerStars Hand #169677243637:  Hold'em No Limit ($0.01/$0.02 USD) - 20=
17/04/29 3:25:00 CUST [2017/04/28 13:25:00 ET]
Table 'Scythia' 9-max Seat #3 is the button
Seat 1: 1Total_Flop1 ($1.45 in chips)=20
Seat 2: Igor693 ($2.69 in chips)=20
Seat 3: the_wickstar ($0.38 in chips)=20
Seat 4: Lazomaz ($3.51 in chips)=20
Seat 5: FidgetyWins ($2.93 in chips)=20
Seat 6: gastelo43 ($0.93 in chips)=20
Seat 7: Joaovdn ($2.15 in chips)=20
Seat 8: vic_lucky777 ($0.55 in chips)=20
Seat 9: MAGNUSVAGNER ($2.72 in chips)=20
Lazomaz: posts small blind $0.01
FidgetyWins: posts big blind $0.02
*** HOLE CARDS ***
Dealt to the_wickstar [Qd 4s]
gastelo43: folds=20
Joaovdn: folds=20
vic_lucky777: folds=20
MAGNUSVAGNER: folds=20
1Total_Flop1: raises $0.04 to $0.06
Igor693: folds=20
the_wickstar: folds=20
Lazomaz: folds=20
FidgetyWins: folds=20
Uncalled bet ($0.04) returned to 1Total_Flop1
1Total_Flop1 collected $0.05 from pot
*** SUMMARY ***
Total pot $0.05 | Rake $0=20
Seat 1: 1Total_Flop1 collected ($0.05)
Seat 2: Igor693 folded before Flop (didn't bet)
Seat 3: the_wickstar (button) folded before Flop (didn't bet)
Seat 4: Lazomaz (small blind) folded before Flop
Seat 5: FidgetyWins (big blind) folded before Flop
Seat 6: gastelo43 folded before Flop (didn't bet)
Seat 7: Joaovdn folded before Flop (didn't bet)
Seat 8: vic_lucky777 folded before Flop (didn't bet)
Seat 9: MAGNUSVAGNER folded before Flop (didn't bet)


*********** # 182 **************
PokerStars Hand #169677229751:  Hold'em No Limit ($0.01/$0.02 USD) - 20=
17/04/29 3:24:41 CUST [2017/04/28 13:24:41 ET]
Table 'Electra' 9-max Seat #7 is the button
Seat 2: dadofaca ($2.03 in chips)=20
Seat 3: julio.jacob1 ($2.08 in chips)=20
Seat 4: yjqian23 ($2 in chips)=20
Seat 5: Gonzalogo ($2 in chips)=20
Seat 6: the_wickstar ($2.11 in chips)=20
Seat 7: daNeck88 ($2.07 in chips)=20
Seat 8: elenkachumak ($1.26 in chips)=20
Seat 9: ronan33 ($2.18 in chips)=20
elenkachumak: posts small blind $0.01
ronan33: posts big blind $0.02
IceMan 62289: sits out=20
*** HOLE CARDS ***
Dealt to the_wickstar [5h 9d]
dadofaca: folds=20
julio.jacob1: folds=20
yjqian23: folds=20
Gonzalogo: folds=20
the_wickstar: folds=20
daNeck88: folds=20
elenkachumak: raises $0.06 to $0.08
ronan33: folds=20
Uncalled bet ($0.06) returned to elenkachumak
elenkachumak collected $0.04 from pot
elenkachumak: doesn't show hand=20
*** SUMMARY ***
Total pot $0.04 | Rake $0=20
Seat 2: dadofaca folded before Flop (didn't bet)
Seat 3: julio.jacob1 folded before Flop (didn't bet)
Seat 4: yjqian23 folded before Flop (didn't bet)
Seat 5: Gonzalogo folded before Flop (didn't bet)
Seat 6: the_wickstar folded before Flop (didn't bet)
Seat 7: daNeck88 (button) folded before Flop (didn't bet)
Seat 8: elenkachumak (small blind) collected ($0.04)
Seat 9: ronan33 (big blind) folded before Flop


*********** # 183 **************
PokerStars Hand #169677212535:  Hold'em No Limit ($0.01/$0.02 USD) - 20=
17/04/29 3:24:18 CUST [2017/04/28 13:24:18 ET]
Table 'Scythia' 9-max Seat #2 is the button
Seat 1: 1Total_Flop1 ($1.45 in chips)=20
Seat 2: Igor693 ($2.69 in chips)=20
Seat 3: the_wickstar ($0.39 in chips)=20
Seat 4: Lazomaz ($3.53 in chips)=20
Seat 5: FidgetyWins ($2.93 in chips)=20
Seat 6: gastelo43 ($0.99 in chips)=20
Seat 7: Joaovdn ($2.07 in chips)=20
Seat 8: vic_lucky777 ($0.55 in chips)=20
Seat 9: MAGNUSVAGNER ($2.72 in chips)=20
the_wickstar: posts small blind $0.01
Lazomaz: posts big blind $0.02
*** HOLE CARDS ***
Dealt to the_wickstar [7c 4h]
FidgetyWins: folds=20
gastelo43: raises $0.04 to $0.06
Joaovdn: calls $0.06
vic_lucky777: folds=20
MAGNUSVAGNER: folds=20
1Total_Flop1: folds=20
Igor693: folds=20
the_wickstar: folds=20
Lazomaz: folds=20
*** FLOP *** [3h 2d 2s]
gastelo43: checks=20
Joaovdn: checks=20
*** TURN *** [3h 2d 2s] [Tc]
gastelo43: checks=20
Joaovdn: bets $0.06
gastelo43: folds=20
Uncalled bet ($0.06) returned to Joaovdn
Joaovdn collected $0.14 from pot
Joaovdn: doesn't show hand=20
*** SUMMARY ***
Total pot $0.15 | Rake $0.01=20
Board [3h 2d 2s Tc]
Seat 1: 1Total_Flop1 folded before Flop (didn't bet)
Seat 2: Igor693 (button) folded before Flop (didn't bet)
Seat 3: the_wickstar (small blind) folded before Flop
Seat 4: Lazomaz (big blind) folded before Flop
Seat 5: FidgetyWins folded before Flop (didn't bet)
Seat 6: gastelo43 folded on the Turn
Seat 7: Joaovdn collected ($0.14)
Seat 8: vic_lucky777 folded before Flop (didn't bet)
Seat 9: MAGNUSVAGNER folded before Flop (didn't bet)


*********** # 184 **************
PokerStars Hand #169677187609:  Hold'em No Limit ($0.01/$0.02 USD) - 20=
17/04/29 3:23:45 CUST [2017/04/28 13:23:45 ET]
Table 'Electra' 9-max Seat #6 is the button
Seat 2: dadofaca ($2.03 in chips)=20
Seat 3: julio.jacob1 ($2.08 in chips)=20
Seat 4: yjqian23 ($1.97 in chips)=20
Seat 5: Gonzalogo ($2 in chips)=20
Seat 6: the_wickstar ($2.11 in chips)=20
Seat 7: daNeck88 ($2.08 in chips)=20
Seat 8: elenkachumak ($1.28 in chips)=20
Seat 9: ronan33 ($2.18 in chips)=20
daNeck88: posts small blind $0.01
elenkachumak: posts big blind $0.02
IceMan 62289: sits out=20
*** HOLE CARDS ***
Dealt to the_wickstar [7s Td]
ronan33: folds=20
dadofaca: folds=20
julio.jacob1: folds=20
yjqian23: calls $0.02
Gonzalogo: folds=20
the_wickstar: folds=20
daNeck88: folds=20
elenkachumak: checks=20
*** FLOP *** [Qc Kc Jh]
elenkachumak: checks=20
yjqian23: bets $0.02
elenkachumak: folds=20
Uncalled bet ($0.02) returned to yjqian23
yjqian23 collected $0.05 from pot
*** SUMMARY ***
Total pot $0.05 | Rake $0=20
Board [Qc Kc Jh]
Seat 2: dadofaca folded before Flop (didn't bet)
Seat 3: julio.jacob1 folded before Flop (didn't bet)
Seat 4: yjqian23 collected ($0.05)
Seat 5: Gonzalogo folded before Flop (didn't bet)
Seat 6: the_wickstar (button) folded before Flop (didn't bet)
Seat 7: daNeck88 (small blind) folded before Flop
Seat 8: elenkachumak (big blind) folded on the Flop
Seat 9: ronan33 folded before Flop (didn't bet)


*********** # 185 **************
PokerStars Hand #169677159770:  Hold'em No Limit ($0.01/$0.02 USD) - 20=
17/04/29 3:23:08 CUST [2017/04/28 13:23:08 ET]
Table 'Scythia' 9-max Seat #1 is the button
Seat 1: 1Total_Flop1 ($1.89 in chips)=20
Seat 2: Igor693 ($2.70 in chips)=20
Seat 3: the_wickstar ($0.41 in chips)=20
Seat 4: Lazomaz ($3.53 in chips)=20
Seat 5: FidgetyWins ($2.93 in chips)=20
Seat 6: gastelo43 ($0.99 in chips)=20
Seat 7: Joaovdn ($1.63 in chips)=20
Seat 8: vic_lucky777 ($0.55 in chips)=20
Seat 9: MAGNUSVAGNER ($2.72 in chips)=20
Igor693: posts small blind $0.01
the_wickstar: posts big blind $0.02
*** HOLE CARDS ***
Dealt to the_wickstar [Kd 4d]
Lazomaz: folds=20
FidgetyWins: folds=20
gastelo43: folds=20
Joaovdn: raises $0.04 to $0.06
vic_lucky777: folds=20
MAGNUSVAGNER: folds=20
1Total_Flop1: calls $0.06
Igor693: folds=20
the_wickstar: folds=20
*** FLOP *** [3h 4s 7s]
Joaovdn: bets $0.06
1Total_Flop1: raises $0.10 to $0.16
Joaovdn: calls $0.10
*** TURN *** [3h 4s 7s] [Ad]
Joaovdn: bets $0.22
1Total_Flop1: calls $0.22
*** RIVER *** [3h 4s 7s Ad] [5h]
Joaovdn: bets $0.44
1Total_Flop1: folds=20
Uncalled bet ($0.44) returned to Joaovdn
Joaovdn collected $0.88 from pot
Joaovdn: doesn't show hand=20
*** SUMMARY ***
Total pot $0.91 | Rake $0.03=20
Board [3h 4s 7s Ad 5h]
Seat 1: 1Total_Flop1 (button) folded on the River
Seat 2: Igor693 (small blind) folded before Flop
Seat 3: the_wickstar (big blind) folded before Flop
Seat 4: Lazomaz folded before Flop (didn't bet)
Seat 5: FidgetyWins folded before Flop (didn't bet)
Seat 6: gastelo43 folded before Flop (didn't bet)
Seat 7: Joaovdn collected ($0.88)
Seat 8: vic_lucky777 folded before Flop (didn't bet)
Seat 9: MAGNUSVAGNER folded before Flop (didn't bet)


*********** # 186 **************
PokerStars Hand #169677131307:  Hold'em No Limit ($0.01/$0.02 USD) - 20=
17/04/29 3:22:30 CUST [2017/04/28 13:22:30 ET]
Table 'Scythia' 9-max Seat #9 is the button
Seat 1: 1Total_Flop1 ($1.90 in chips)=20
Seat 2: Igor693 ($2.65 in chips)=20
Seat 3: the_wickstar ($0.41 in chips)=20
Seat 4: Lazomaz ($3.53 in chips)=20
Seat 5: FidgetyWins ($2.93 in chips)=20
Seat 6: gastelo43 ($0.99 in chips)=20
Seat 7: Joaovdn ($1.63 in chips)=20
Seat 8: vic_lucky777 ($0.59 in chips)=20
Seat 9: MAGNUSVAGNER ($2.72 in chips)=20
1Total_Flop1: posts small blind $0.01
Igor693: posts big blind $0.02
*** HOLE CARDS ***
Dealt to the_wickstar [Jd 6d]
the_wickstar: folds=20
Lazomaz: folds=20
FidgetyWins: folds=20
gastelo43: folds=20
Joaovdn: folds=20
vic_lucky777: calls $0.02
MAGNUSVAGNER: folds=20
1Total_Flop1: folds=20
Igor693: raises $0.02 to $0.04
vic_lucky777: calls $0.02
*** FLOP *** [2h 3h Js]
Igor693: checks=20
vic_lucky777: checks=20
*** TURN *** [2h 3h Js] [2d]
Igor693: bets $0.05
vic_lucky777: folds=20
Uncalled bet ($0.05) returned to Igor693
Igor693 collected $0.09 from pot
Igor693: doesn't show hand=20
*** SUMMARY ***
Total pot $0.09 | Rake $0=20
Board [2h 3h Js 2d]
Seat 1: 1Total_Flop1 (small blind) folded before Flop
Seat 2: Igor693 (big blind) collected ($0.09)
Seat 3: the_wickstar folded before Flop (didn't bet)
Seat 4: Lazomaz folded before Flop (didn't bet)
Seat 5: FidgetyWins folded before Flop (didn't bet)
Seat 6: gastelo43 folded before Flop (didn't bet)
Seat 7: Joaovdn folded before Flop (didn't bet)
Seat 8: vic_lucky777 folded on the Turn
Seat 9: MAGNUSVAGNER (button) folded before Flop (didn't bet)


*********** # 187 **************
PokerStars Hand #169677123872:  Hold'em No Limit ($0.01/$0.02 USD) - 20=
17/04/29 3:22:19 CUST [2017/04/28 13:22:19 ET]
Table 'Electra' 9-max Seat #5 is the button
Seat 2: dadofaca ($2.03 in chips)=20
Seat 3: julio.jacob1 ($2.08 in chips)=20
Seat 4: yjqian23 ($1.97 in chips)=20
Seat 5: Gonzalogo ($2 in chips)=20
Seat 6: the_wickstar ($2.13 in chips)=20
Seat 7: daNeck88 ($2.06 in chips)=20
Seat 8: elenkachumak ($1.28 in chips)=20
Seat 9: ronan33 ($2.18 in chips)=20
the_wickstar: posts small blind $0.01
daNeck88: posts big blind $0.02
IceMan 62289: sits out=20
*** HOLE CARDS ***
Dealt to the_wickstar [Ah 6h]
elenkachumak: folds=20
ronan33: folds=20
dadofaca: folds=20
julio.jacob1: folds=20
yjqian23: folds=20
Gonzalogo: folds=20
the_wickstar: calls $0.01
daNeck88: checks=20
*** FLOP *** [Kd Tc 7s]
the_wickstar: checks=20
daNeck88: checks=20
*** TURN *** [Kd Tc 7s] [8s]
the_wickstar: checks=20
daNeck88: checks=20
*** RIVER *** [Kd Tc 7s 8s] [4s]
the_wickstar: checks=20
daNeck88: checks=20
*** SHOW DOWN ***
the_wickstar: shows [Ah 6h] (high card Ace)
daNeck88: shows [Qc 4d] (a pair of Fours)
daNeck88 collected $0.04 from pot
*** SUMMARY ***
Total pot $0.04 | Rake $0=20
Board [Kd Tc 7s 8s 4s]
Seat 2: dadofaca folded before Flop (didn't bet)
Seat 3: julio.jacob1 folded before Flop (didn't bet)
Seat 4: yjqian23 folded before Flop (didn't bet)
Seat 5: Gonzalogo (button) folded before Flop (didn't bet)
Seat 6: the_wickstar (small blind) showed [Ah 6h] and lost with high ca=
rd Ace
Seat 7: daNeck88 (big blind) showed [Qc 4d] and won ($0.04) with a pair=
 of Fours
Seat 8: elenkachumak folded before Flop (didn't bet)
Seat 9: ronan33 folded before Flop (didn't bet)


*********** # 188 **************
PokerStars Hand #169677098843:  Hold'em No Limit ($0.01/$0.02 USD) - 20=
17/04/29 3:21:46 CUST [2017/04/28 13:21:46 ET]
Table 'Electra' 9-max Seat #4 is the button
Seat 2: dadofaca ($2 in chips)=20
Seat 3: julio.jacob1 ($2.08 in chips)=20
Seat 4: yjqian23 ($1.97 in chips)=20
Seat 5: Gonzalogo ($2.01 in chips)=20
Seat 6: the_wickstar ($2.15 in chips)=20
Seat 7: daNeck88 ($2.06 in chips)=20
Seat 8: elenkachumak ($1.28 in chips)=20
Seat 9: ronan33 ($2.18 in chips)=20
Gonzalogo: posts small blind $0.01
the_wickstar: posts big blind $0.02
IceMan 62289: sits out=20
*** HOLE CARDS ***
Dealt to the_wickstar [6s 8c]
daNeck88: folds=20
elenkachumak: folds=20
ronan33: folds=20
dadofaca: raises $0.08 to $0.10
julio.jacob1: folds=20
yjqian23: folds=20
Gonzalogo: folds=20
the_wickstar: folds=20
Uncalled bet ($0.08) returned to dadofaca
dadofaca collected $0.05 from pot
dadofaca: doesn't show hand=20
*** SUMMARY ***
Total pot $0.05 | Rake $0=20
Seat 2: dadofaca collected ($0.05)
Seat 3: julio.jacob1 folded before Flop (didn't bet)
Seat 4: yjqian23 (button) folded before Flop (didn't bet)
Seat 5: Gonzalogo (small blind) folded before Flop
Seat 6: the_wickstar (big blind) folded before Flop
Seat 7: daNeck88 folded before Flop (didn't bet)
Seat 8: elenkachumak folded before Flop (didn't bet)
Seat 9: ronan33 folded before Flop (didn't bet)


*********** # 189 **************
PokerStars Hand #169677084943:  Hold'em No Limit ($0.01/$0.02 USD) - 20=
17/04/29 3:21:27 CUST [2017/04/28 13:21:27 ET]
Table 'Scythia' 9-max Seat #8 is the button
Seat 1: 1Total_Flop1 ($2.66 in chips)=20
Seat 2: Igor693 ($2.65 in chips)=20
Seat 3: the_wickstar ($0.41 in chips)=20
Seat 4: Lazomaz ($3.53 in chips)=20
Seat 5: FidgetyWins ($2.21 in chips)=20
Seat 6: gastelo43 ($0.99 in chips)=20
Seat 7: Joaovdn ($1.63 in chips)=20
Seat 8: vic_lucky777 ($0.59 in chips)=20
Seat 9: MAGNUSVAGNER ($2.73 in chips)=20
MAGNUSVAGNER: posts small blind $0.01
1Total_Flop1: posts big blind $0.02
*** HOLE CARDS ***
Dealt to the_wickstar [Kd 7c]
Igor693: folds=20
the_wickstar: folds=20
Lazomaz: folds=20
FidgetyWins: raises $0.04 to $0.06
gastelo43: folds=20
Joaovdn: folds=20
vic_lucky777: folds=20
MAGNUSVAGNER: folds=20
1Total_Flop1: calls $0.04
*** FLOP *** [Ah Ad 7h]
1Total_Flop1: checks=20
FidgetyWins: bets $0.08
1Total_Flop1: calls $0.08
*** TURN *** [Ah Ad 7h] [3d]
1Total_Flop1: checks=20
FidgetyWins: bets $0.12
1Total_Flop1: calls $0.12
*** RIVER *** [Ah Ad 7h 3d] [2s]
1Total_Flop1: bets $0.50
FidgetyWins: calls $0.50
*** SHOW DOWN ***
1Total_Flop1: shows [Qc As] (three of a kind, Aces)
FidgetyWins: shows [Kh Ac] (three of a kind, Aces - King kicker)
FidgetyWins collected $1.48 from pot
*** SUMMARY ***
Total pot $1.53 | Rake $0.05=20
Board [Ah Ad 7h 3d 2s]
Seat 1: 1Total_Flop1 (big blind) showed [Qc As] and lost with three of =
a kind, Aces
Seat 2: Igor693 folded before Flop (didn't bet)
Seat 3: the_wickstar folded before Flop (didn't bet)
Seat 4: Lazomaz folded before Flop (didn't bet)
Seat 5: FidgetyWins showed [Kh Ac] and won ($1.48) with three of a kind=
, Aces
Seat 6: gastelo43 folded before Flop (didn't bet)
Seat 7: Joaovdn folded before Flop (didn't bet)
Seat 8: vic_lucky777 (button) folded before Flop (didn't bet)
Seat 9: MAGNUSVAGNER (small blind) folded before Flop


*********** # 190 **************
PokerStars Hand #169677067103:  Hold'em No Limit ($0.01/$0.02 USD) - 20=
17/04/29 3:21:03 CUST [2017/04/28 13:21:03 ET]
Table 'Electra' 9-max Seat #3 is the button
Seat 2: dadofaca ($2 in chips)=20
Seat 3: julio.jacob1 ($2.08 in chips)=20
Seat 4: yjqian23 ($1.98 in chips)=20
Seat 5: Gonzalogo ($2.03 in chips)=20
Seat 6: the_wickstar ($2.15 in chips)=20
Seat 7: daNeck88 ($2.03 in chips)=20
Seat 8: elenkachumak ($1.28 in chips)=20
Seat 9: ronan33 ($2.18 in chips)=20
yjqian23: posts small blind $0.01
Gonzalogo: posts big blind $0.02
IceMan 62289: sits out=20
*** HOLE CARDS ***
Dealt to the_wickstar [7d 6c]
the_wickstar: folds=20
daNeck88: raises $0.04 to $0.06
elenkachumak: folds=20
ronan33: folds=20
dadofaca: folds=20
julio.jacob1: folds=20
yjqian23: folds=20
Gonzalogo: folds=20
Uncalled bet ($0.04) returned to daNeck88
daNeck88 collected $0.05 from pot
daNeck88: doesn't show hand=20
*** SUMMARY ***
Total pot $0.05 | Rake $0=20
Seat 2: dadofaca folded before Flop (didn't bet)
Seat 3: julio.jacob1 (button) folded before Flop (didn't bet)
Seat 4: yjqian23 (small blind) folded before Flop
Seat 5: Gonzalogo (big blind) folded before Flop
Seat 6: the_wickstar folded before Flop (didn't bet)
Seat 7: daNeck88 collected ($0.05)
Seat 8: elenkachumak folded before Flop (didn't bet)
Seat 9: ronan33 folded before Flop (didn't bet)


*********** # 191 **************
PokerStars Hand #169677058708:  Hold'em No Limit ($0.01/$0.02 USD) - 20=
17/04/29 3:20:52 CUST [2017/04/28 13:20:52 ET]
Table 'Scythia' 9-max Seat #7 is the button
Seat 1: 1Total_Flop1 ($2.66 in chips)=20
Seat 2: Igor693 ($2.65 in chips)=20
Seat 3: the_wickstar ($0.41 in chips)=20
Seat 4: Lazomaz ($3.53 in chips)=20
Seat 5: FidgetyWins ($2.21 in chips)=20
Seat 6: gastelo43 ($0.99 in chips)=20
Seat 7: Joaovdn ($1.63 in chips)=20
Seat 8: vic_lucky777 ($0.61 in chips)=20
Seat 9: MAGNUSVAGNER ($2.71 in chips)=20
vic_lucky777: posts small blind $0.01
MAGNUSVAGNER: posts big blind $0.02
*** HOLE CARDS ***
Dealt to the_wickstar [4c As]
1Total_Flop1: folds=20
Igor693: folds=20
the_wickstar: folds=20
Lazomaz: folds=20
FidgetyWins: folds=20
gastelo43: folds=20
Joaovdn: folds=20
vic_lucky777: calls $0.01
MAGNUSVAGNER: checks=20
*** FLOP *** [4d Ts 5c]
vic_lucky777: checks=20
MAGNUSVAGNER: bets $0.04
vic_lucky777: folds=20
Uncalled bet ($0.04) returned to MAGNUSVAGNER
MAGNUSVAGNER collected $0.04 from pot
MAGNUSVAGNER: doesn't show hand=20
*** SUMMARY ***
Total pot $0.04 | Rake $0=20
Board [4d Ts 5c]
Seat 1: 1Total_Flop1 folded before Flop (didn't bet)
Seat 2: Igor693 folded before Flop (didn't bet)
Seat 3: the_wickstar folded before Flop (didn't bet)
Seat 4: Lazomaz folded before Flop (didn't bet)
Seat 5: FidgetyWins folded before Flop (didn't bet)
Seat 6: gastelo43 folded before Flop (didn't bet)
Seat 7: Joaovdn (button) folded before Flop (didn't bet)
Seat 8: vic_lucky777 (small blind) folded on the Flop
Seat 9: MAGNUSVAGNER (big blind) collected ($0.04)


*********** # 192 **************
PokerStars Hand #169677048663:  Hold'em No Limit ($0.01/$0.02 USD) - 20=
17/04/29 3:20:38 CUST [2017/04/28 13:20:38 ET]
Table 'Electra' 9-max Seat #2 is the button
Seat 2: dadofaca ($2 in chips)=20
Seat 3: julio.jacob1 ($2.09 in chips)=20
Seat 4: yjqian23 ($2 in chips)=20
Seat 5: Gonzalogo ($2 in chips)=20
Seat 6: the_wickstar ($2.15 in chips)=20
Seat 7: daNeck88 ($2.03 in chips)=20
Seat 8: elenkachumak ($1.28 in chips)=20
Seat 9: ronan33 ($2.18 in chips)=20
julio.jacob1: posts small blind $0.01
yjqian23: posts big blind $0.02
IceMan 62289: sits out=20
*** HOLE CARDS ***
Dealt to the_wickstar [4h 3h]
Gonzalogo: raises $0.04 to $0.06
the_wickstar: folds=20
daNeck88: folds=20
elenkachumak: folds=20
ronan33: folds=20
dadofaca: folds=20
julio.jacob1: folds=20
yjqian23: folds=20
Uncalled bet ($0.04) returned to Gonzalogo
Gonzalogo collected $0.05 from pot
Gonzalogo: doesn't show hand=20
*** SUMMARY ***
Total pot $0.05 | Rake $0=20
Seat 2: dadofaca (button) folded before Flop (didn't bet)
Seat 3: julio.jacob1 (small blind) folded before Flop
Seat 4: yjqian23 (big blind) folded before Flop
Seat 5: Gonzalogo collected ($0.05)
Seat 6: the_wickstar folded before Flop (didn't bet)
Seat 7: daNeck88 folded before Flop (didn't bet)
Seat 8: elenkachumak folded before Flop (didn't bet)
Seat 9: ronan33 folded before Flop (didn't bet)


*********** # 193 **************
PokerStars Hand #169677025156:  Hold'em No Limit ($0.01/$0.02 USD) - 20=
17/04/29 3:20:06 CUST [2017/04/28 13:20:06 ET]
Table 'Electra' 9-max Seat #9 is the button
Seat 2: dadofaca ($2 in chips)=20
Seat 3: julio.jacob1 ($2.11 in chips)=20
Seat 5: Gonzalogo ($2 in chips)=20
Seat 6: the_wickstar ($2.15 in chips)=20
Seat 7: daNeck88 ($2.03 in chips)=20
Seat 8: elenkachumak ($1.28 in chips)=20
Seat 9: ronan33 ($2.15 in chips)=20
dadofaca: posts small blind $0.01
julio.jacob1: posts big blind $0.02
yjqian23: sits out=20
*** HOLE CARDS ***
Dealt to the_wickstar [6h 8s]
Gonzalogo: folds=20
IceMan 62289 joins the table at seat #1=20
the_wickstar: folds=20
daNeck88: folds=20
elenkachumak: folds=20
ronan33: raises $0.02 to $0.04
dadofaca: folds=20
julio.jacob1: folds=20
Uncalled bet ($0.02) returned to ronan33
ronan33 collected $0.05 from pot
ronan33: doesn't show hand=20
*** SUMMARY ***
Total pot $0.05 | Rake $0=20
Seat 2: dadofaca (small blind) folded before Flop
Seat 3: julio.jacob1 (big blind) folded before Flop
Seat 5: Gonzalogo folded before Flop (didn't bet)
Seat 6: the_wickstar folded before Flop (didn't bet)
Seat 7: daNeck88 folded before Flop (didn't bet)
Seat 8: elenkachumak folded before Flop (didn't bet)
Seat 9: ronan33 (button) collected ($0.05)


*********** # 194 **************
PokerStars Hand #169677010421:  Hold'em No Limit ($0.01/$0.02 USD) - 20=
17/04/29 3:19:47 CUST [2017/04/28 13:19:47 ET]
Table 'Scythia' 9-max Seat #6 is the button
Seat 1: 1Total_Flop1 ($2.66 in chips)=20
Seat 2: Igor693 ($2.23 in chips)=20
Seat 3: the_wickstar ($0.41 in chips)=20
Seat 4: Lazomaz ($3.53 in chips)=20
Seat 5: FidgetyWins ($2.21 in chips)=20
Seat 6: gastelo43 ($0.99 in chips)=20
Seat 7: Joaovdn ($2.06 in chips)=20
Seat 8: vic_lucky777 ($0.63 in chips)=20
Seat 9: MAGNUSVAGNER ($2.71 in chips)=20
Joaovdn: posts small blind $0.01
vic_lucky777: posts big blind $0.02
*** HOLE CARDS ***
Dealt to the_wickstar [8d 5s]
MAGNUSVAGNER: folds=20
1Total_Flop1: folds=20
Igor693: raises $0.04 to $0.06
the_wickstar: folds=20
Lazomaz: folds=20
FidgetyWins: folds=20
gastelo43: folds=20
Joaovdn: calls $0.05
vic_lucky777: folds=20
*** FLOP *** [6h 3h 6s]
Joaovdn: checks=20
Igor693: bets $0.11
Joaovdn: calls $0.11
*** TURN *** [6h 3h 6s] [8h]
Joaovdn: checks=20
Igor693: bets $0.26
Joaovdn: calls $0.26
*** RIVER *** [6h 3h 6s 8h] [3c]
Joaovdn: checks=20
Igor693: bets $0.43
Joaovdn: folds=20
Uncalled bet ($0.43) returned to Igor693
Igor693 collected $0.85 from pot
Igor693: doesn't show hand=20
*** SUMMARY ***
Total pot $0.88 | Rake $0.03=20
Board [6h 3h 6s 8h 3c]
Seat 1: 1Total_Flop1 folded before Flop (didn't bet)
Seat 2: Igor693 collected ($0.85)
Seat 3: the_wickstar folded before Flop (didn't bet)
Seat 4: Lazomaz folded before Flop (didn't bet)
Seat 5: FidgetyWins folded before Flop (didn't bet)
Seat 6: gastelo43 (button) folded before Flop (didn't bet)
Seat 7: Joaovdn (small blind) folded on the River
Seat 8: vic_lucky777 (big blind) folded before Flop
Seat 9: MAGNUSVAGNER folded before Flop (didn't bet)


*********** # 195 **************
PokerStars Hand #169676998693:  Hold'em No Limit ($0.01/$0.02 USD) - 20=
17/04/29 3:19:31 CUST [2017/04/28 13:19:31 ET]
Table 'Electra' 9-max Seat #8 is the button
Seat 2: dadofaca ($2 in chips)=20
Seat 3: julio.jacob1 ($2.11 in chips)=20
Seat 5: Gonzalogo ($2 in chips)=20
Seat 6: the_wickstar ($2.15 in chips)=20
Seat 7: daNeck88 ($2 in chips)=20
Seat 8: elenkachumak ($1.28 in chips)=20
Seat 9: ronan33 ($2.16 in chips)=20
ronan33: posts small blind $0.01
mabuliang: is sitting out=20
dadofaca: posts big blind $0.02
yjqian23: sits out=20
*** HOLE CARDS ***
Dealt to the_wickstar [4c 9d]
mabuliang leaves the table
julio.jacob1: folds=20
Gonzalogo: folds=20
the_wickstar: folds=20
daNeck88: raises $0.04 to $0.06
elenkachumak: folds=20
ronan33: folds=20
dadofaca: folds=20
Uncalled bet ($0.04) returned to daNeck88
daNeck88 collected $0.05 from pot
daNeck88: doesn't show hand=20
*** SUMMARY ***
Total pot $0.05 | Rake $0=20
Seat 2: dadofaca (big blind) folded before Flop
Seat 3: julio.jacob1 folded before Flop (didn't bet)
Seat 5: Gonzalogo folded before Flop (didn't bet)
Seat 6: the_wickstar folded before Flop (didn't bet)
Seat 7: daNeck88 collected ($0.05)
Seat 8: elenkachumak (button) folded before Flop (didn't bet)
Seat 9: ronan33 (small blind) folded before Flop


*********** # 196 **************
PokerStars Hand #169676966482:  Hold'em No Limit ($0.01/$0.02 USD) - 20=
17/04/29 3:18:47 CUST [2017/04/28 13:18:47 ET]
Table 'Scythia' 9-max Seat #5 is the button
Seat 1: 1Total_Flop1 ($2.66 in chips)=20
Seat 2: Igor693 ($2.23 in chips)=20
Seat 3: the_wickstar ($0.68 in chips)=20
Seat 4: Lazomaz ($3.53 in chips)=20
Seat 5: FidgetyWins ($2.21 in chips)=20
Seat 6: gastelo43 ($1 in chips)=20
Seat 7: Joaovdn ($1.80 in chips)=20
Seat 8: vic_lucky777 ($0.63 in chips)=20
Seat 9: MAGNUSVAGNER ($2.71 in chips)=20
gastelo43: posts small blind $0.01
Joaovdn: posts big blind $0.02
*** HOLE CARDS ***
Dealt to the_wickstar [Kc Ks]
vic_lucky777: folds=20
MAGNUSVAGNER: folds=20
1Total_Flop1: folds=20
Igor693: folds=20
the_wickstar: raises $0.04 to $0.06
Lazomaz: folds=20
FidgetyWins: folds=20
gastelo43: folds=20
Joaovdn: calls $0.04
*** FLOP *** [7d 2d 6h]
Joaovdn: checks=20
the_wickstar: bets $0.07
Joaovdn: calls $0.07
*** TURN *** [7d 2d 6h] [As]
Joaovdn: checks=20
the_wickstar: checks=20
*** RIVER *** [7d 2d 6h As] [Jh]
Joaovdn: bets $0.14
the_wickstar: calls $0.14
*** SHOW DOWN ***
Joaovdn: shows [Ad 4c] (a pair of Aces)
the_wickstar: mucks hand=20
Joaovdn collected $0.53 from pot
*** SUMMARY ***
Total pot $0.55 | Rake $0.02=20
Board [7d 2d 6h As Jh]
Seat 1: 1Total_Flop1 folded before Flop (didn't bet)
Seat 2: Igor693 folded before Flop (didn't bet)
Seat 3: the_wickstar mucked [Kc Ks]
Seat 4: Lazomaz folded before Flop (didn't bet)
Seat 5: FidgetyWins (button) folded before Flop (didn't bet)
Seat 6: gastelo43 (small blind) folded before Flop
Seat 7: Joaovdn (big blind) showed [Ad 4c] and won ($0.53) with a pair =
of Aces
Seat 8: vic_lucky777 folded before Flop (didn't bet)
Seat 9: MAGNUSVAGNER folded before Flop (didn't bet)


*********** # 197 **************
PokerStars Hand #169676964165:  Hold'em No Limit ($0.01/$0.02 USD) - 20=
17/04/29 3:18:44 CUST [2017/04/28 13:18:44 ET]
Table 'Electra' 9-max Seat #7 is the button
Seat 1: mabuliang ($2.70 in chips)=20
Seat 2: dadofaca ($2 in chips)=20
Seat 3: julio.jacob1 ($2.11 in chips)=20
Seat 5: Gonzalogo ($2 in chips)=20
Seat 6: the_wickstar ($2.15 in chips)=20
Seat 7: daNeck88 ($2 in chips)=20
Seat 8: elenkachumak ($1.34 in chips)=20
Seat 9: ronan33 ($2.05 in chips)=20
elenkachumak: posts small blind $0.01
ronan33: posts big blind $0.02
yjqian23: sits out=20
*** HOLE CARDS ***
Dealt to the_wickstar [5c Ks]
mabuliang: folds=20
dadofaca: folds=20
julio.jacob1: folds=20
Gonzalogo: raises $0.04 to $0.06
the_wickstar: folds=20
daNeck88: folds=20
elenkachumak: calls $0.05
ronan33: calls $0.04
*** FLOP *** [Ac 4c 9s]
elenkachumak: checks=20
ronan33: bets $0.11
Gonzalogo: folds=20
elenkachumak: folds=20
Uncalled bet ($0.11) returned to ronan33
ronan33 collected $0.17 from pot
ronan33: doesn't show hand=20
*** SUMMARY ***
Total pot $0.18 | Rake $0.01=20
Board [Ac 4c 9s]
Seat 1: mabuliang folded before Flop (didn't bet)
Seat 2: dadofaca folded before Flop (didn't bet)
Seat 3: julio.jacob1 folded before Flop (didn't bet)
Seat 5: Gonzalogo folded on the Flop
Seat 6: the_wickstar folded before Flop (didn't bet)
Seat 7: daNeck88 (button) folded before Flop (didn't bet)
Seat 8: elenkachumak (small blind) folded on the Flop
Seat 9: ronan33 (big blind) collected ($0.17)


*********** # 198 **************
PokerStars Hand #169676912919:  Hold'em No Limit ($0.01/$0.02 USD) - 20=
17/04/29 3:17:34 CUST [2017/04/28 13:17:34 ET]
Table 'Electra' 9-max Seat #6 is the button
Seat 1: mabuliang ($2.70 in chips)=20
Seat 2: dadofaca ($2 in chips)=20
Seat 3: julio.jacob1 ($2.11 in chips)=20
Seat 5: Gonzalogo ($2 in chips)=20
Seat 6: the_wickstar ($2.09 in chips)=20
Seat 7: daNeck88 ($2 in chips)=20
Seat 8: elenkachumak ($1.39 in chips)=20
Seat 9: ronan33 ($2.05 in chips)=20
daNeck88: posts small blind $0.01
elenkachumak: posts big blind $0.02
yjqian23: sits out=20
*** HOLE CARDS ***
Dealt to the_wickstar [3s Ah]
ronan33: folds=20
mabuliang: folds=20
dadofaca: folds=20
julio.jacob1: folds=20
Gonzalogo: folds=20
the_wickstar: calls $0.02
daNeck88: folds=20
elenkachumak: checks=20
*** FLOP *** [Jd Jh 8c]
elenkachumak: checks=20
the_wickstar: checks=20
*** TURN *** [Jd Jh 8c] [Ks]
elenkachumak: checks=20
the_wickstar: bets $0.03
elenkachumak: calls $0.03
*** RIVER *** [Jd Jh 8c Ks] [3h]
elenkachumak: checks=20
the_wickstar: bets $0.11
elenkachumak: folds=20
Uncalled bet ($0.11) returned to the_wickstar
the_wickstar collected $0.11 from pot
*** SUMMARY ***
Total pot $0.11 | Rake $0=20
Board [Jd Jh 8c Ks 3h]
Seat 1: mabuliang folded before Flop (didn't bet)
Seat 2: dadofaca folded before Flop (didn't bet)
Seat 3: julio.jacob1 folded before Flop (didn't bet)
Seat 5: Gonzalogo folded before Flop (didn't bet)
Seat 6: the_wickstar (button) collected ($0.11)
Seat 7: daNeck88 (small blind) folded before Flop
Seat 8: elenkachumak (big blind) folded on the River
Seat 9: ronan33 folded before Flop (didn't bet)


*********** # 199 **************
PokerStars Hand #169676909564:  Hold'em No Limit ($0.01/$0.02 USD) - 20=
17/04/29 3:17:30 CUST [2017/04/28 13:17:30 ET]
Table 'Scythia' 9-max Seat #4 is the button
Seat 1: 1Total_Flop1 ($2.66 in chips)=20
Seat 2: Igor693 ($2.23 in chips)=20
Seat 3: the_wickstar ($0.86 in chips)=20
Seat 4: Lazomaz ($3.53 in chips)=20
Seat 5: FidgetyWins ($2 in chips)=20
Seat 6: gastelo43 ($1.02 in chips)=20
Seat 7: Joaovdn ($1.80 in chips)=20
Seat 8: vic_lucky777 ($0.65 in chips)=20
Seat 9: MAGNUSVAGNER ($2.71 in chips)=20
FidgetyWins: posts small blind $0.01
gastelo43: posts big blind $0.02
*** HOLE CARDS ***
Dealt to the_wickstar [Qc Kh]
Joaovdn: folds=20
vic_lucky777: calls $0.02
MAGNUSVAGNER: folds=20
1Total_Flop1 has timed out
1Total_Flop1: folds=20
Igor693: folds=20
the_wickstar: raises $0.04 to $0.06
Lazomaz: folds=20
FidgetyWins: raises $0.12 to $0.18
gastelo43: folds=20
vic_lucky777: folds=20
the_wickstar: calls $0.12
*** FLOP *** [3c 4h 7s]
FidgetyWins: bets $0.26
the_wickstar: folds=20
Uncalled bet ($0.26) returned to FidgetyWins
FidgetyWins collected $0.39 from pot
FidgetyWins: doesn't show hand=20
*** SUMMARY ***
Total pot $0.40 | Rake $0.01=20
Board [3c 4h 7s]
Seat 1: 1Total_Flop1 folded before Flop (didn't bet)
Seat 2: Igor693 folded before Flop (didn't bet)
Seat 3: the_wickstar folded on the Flop
Seat 4: Lazomaz (button) folded before Flop (didn't bet)
Seat 5: FidgetyWins (small blind) collected ($0.39)
Seat 6: gastelo43 (big blind) folded before Flop
Seat 7: Joaovdn folded before Flop (didn't bet)
Seat 8: vic_lucky777 folded before Flop
Seat 9: MAGNUSVAGNER folded before Flop (didn't bet)


*********** # 200 **************
PokerStars Hand #169676889437:  Hold'em No Limit ($0.01/$0.02 USD) - 20=
17/04/29 3:17:02 CUST [2017/04/28 13:17:02 ET]
Table 'Scythia' 9-max Seat #3 is the button
Seat 1: 1Total_Flop1 ($2.66 in chips)=20
Seat 2: Igor693 ($2.23 in chips)=20
Seat 3: the_wickstar ($0.86 in chips)=20
Seat 4: Lazomaz ($3.54 in chips)=20
Seat 5: FidgetyWins ($2.02 in chips)=20
Seat 6: gastelo43 ($1.02 in chips)=20
Seat 7: Joaovdn ($1.77 in chips)=20
Seat 8: vic_lucky777 ($0.65 in chips)=20
Seat 9: MAGNUSVAGNER ($2.71 in chips)=20
Lazomaz: posts small blind $0.01
FidgetyWins: posts big blind $0.02
*** HOLE CARDS ***
Dealt to the_wickstar [4c Qc]
gastelo43: folds=20
Joaovdn: raises $0.04 to $0.06
vic_lucky777: folds=20
MAGNUSVAGNER: folds=20
1Total_Flop1: folds=20
Igor693: folds=20
the_wickstar: folds=20
Lazomaz: folds=20
FidgetyWins: folds=20
Uncalled bet ($0.04) returned to Joaovdn
Joaovdn collected $0.05 from pot
Joaovdn: doesn't show hand=20
*** SUMMARY ***
Total pot $0.05 | Rake $0=20
Seat 1: 1Total_Flop1 folded before Flop (didn't bet)
Seat 2: Igor693 folded before Flop (didn't bet)
Seat 3: the_wickstar (button) folded before Flop (didn't bet)
Seat 4: Lazomaz (small blind) folded before Flop
Seat 5: FidgetyWins (big blind) folded before Flop
Seat 6: gastelo43 folded before Flop (didn't bet)
Seat 7: Joaovdn collected ($0.05)
Seat 8: vic_lucky777 folded before Flop (didn't bet)
Seat 9: MAGNUSVAGNER folded before Flop (didn't bet)



If you have any questions, please contact us at "PokerStars Support" <s=
upport@pokerstars.com>


