Delivered-To: sherhan.wicky@gmail.com
Received: by 10.79.136.132 with SMTP id k126csp160564ivd;
        Thu, 4 May 2017 20:35:54 -0700 (PDT)
X-Received: by 10.80.172.134 with SMTP id x6mr31735722edc.115.1493955354443;
        Thu, 04 May 2017 20:35:54 -0700 (PDT)
Return-Path: <support@pokerstars.com>
Received: from mx13.pokerstars.eu (mx13.pokerstars.eu. [77.87.179.125])
        by mx.google.com with ESMTPS id s40si2771324edd.47.2017.05.04.20.35.53
        for <sherhan.wicky@gmail.com>
        (version=TLS1_2 cipher=ECDHE-RSA-AES128-GCM-SHA256 bits=128/128);
        Thu, 04 May 2017 20:35:54 -0700 (PDT)
Received-SPF: pass (google.com: domain of support@pokerstars.com designates 77.87.179.125 as permitted sender) client-ip=77.87.179.125;
Authentication-Results: mx.google.com;
       dkim=pass (test mode) header.i=@pokerstars.com;
       spf=pass (google.com: domain of support@pokerstars.com designates 77.87.179.125 as permitted sender) smtp.mailfrom=support@pokerstars.com;
       dmarc=pass (p=NONE sp=NONE dis=NONE) header.from=pokerstars.com
Received: by mx13.pokerstars.eu (mailer, from userid 503)
	id 55F611FC449E; Thu,  4 May 2017 23:35:53 -0400 (EDT)
DKIM-Signature: v=1; a=rsa-sha1; c=relaxed; d=pokerstars.com; h=date
	:from:to:subject:message-id:mime-version:content-type
	:content-transfer-encoding; s=s1024; bh=INsXBJmK5TlcHT/m7t0LrSIs
	MhI=; b=FJySSxDAh3xOP1Cc9rvku1BNuAf5C9j1NP1p/JOcAVdJV/DunqEE1n8b
	svkU5l9DUMv/c3AJopCFQl3fo/Zjx7TcvgT3xkKgSjqmZdz24yF7p4qGVmgSoiuO
	qO7NjnTEcaRlaxunyWeDSl5YjpgCgqhUnfAh//qizLl7RK9J9Zw=
X-PS-ID: c2hlcmhhbi53aWNreUBnbWFpbC5jb20=
Received: from pokerstars.com (IOM-20-81 [192.168.8.81])
	by mx13.pokerstars.eu (mailer) with SMTP id 3E83E1FC36E1
	for <sherhan.wicky@gmail.com>; Thu,  4 May 2017 23:35:53 -0400 (EDT)
Date: Thu, 4 May 2017 23:35:53 -0400
From: "PokerStars Support" <support@pokerstars.com>
To: sherhan.wicky@gmail.com
Subject: PokerStars Hand History Request - last 1 day of play
Message-Id: <590BF319.B37A869D4ED10@pokerstars.com>
MIME-Version: 1.0
Content-Type: text/plain;
 charset="windows-1252"
Content-Transfer-Encoding: quoted-printable


Transcript for last 1 day of play requested by the_wickstar (sherhan.wi=
cky@gmail.com)

*********** # 1 **************
PokerStars Hand #169970921293:  Hold'em No Limit ($0.01/$0.02 USD) - 20=
17/05/05 13:34:34 CUST [2017/05/04 23:34:34 ET]
Table 'Alascattalo II' 9-max Seat #8 is the button
Seat 1: the_wickstar ($1.10 in chips)=20
Seat 2: cobo190 ($3.67 in chips)=20
Seat 3: Achilles2582 ($2.49 in chips)=20
Seat 4: rssollero ($2 in chips)=20
Seat 5: rickgrimesI ($2.33 in chips)=20
Seat 6: 6yka Bu/lkuH ($2 in chips)=20
Seat 7: Matheuz7 ($2.08 in chips)=20
Seat 8: CrazyyParis ($2.03 in chips)=20
Seat 9: H1JackH1gh ($2 in chips)=20
H1JackH1gh: posts small blind $0.01
the_wickstar: posts big blind $0.02
*** HOLE CARDS ***
Dealt to the_wickstar [Kd 7s]
cobo190: folds=20
Achilles2582: folds=20
rssollero: folds=20
rickgrimesI: raises $0.04 to $0.06
6yka Bu/lkuH: folds=20
Matheuz7: folds=20
CrazyyParis: folds=20
H1JackH1gh is disconnected=20
H1JackH1gh has timed out while disconnected
H1JackH1gh: folds=20
the_wickstar: folds=20
Uncalled bet ($0.04) returned to rickgrimesI
rickgrimesI collected $0.05 from pot
rickgrimesI: doesn't show hand=20
*** SUMMARY ***
Total pot $0.05 | Rake $0=20
Seat 1: the_wickstar (big blind) folded before Flop
Seat 2: cobo190 folded before Flop (didn't bet)
Seat 3: Achilles2582 folded before Flop (didn't bet)
Seat 4: rssollero folded before Flop (didn't bet)
Seat 5: rickgrimesI collected ($0.05)
Seat 6: 6yka Bu/lkuH folded before Flop (didn't bet)
Seat 7: Matheuz7 folded before Flop (didn't bet)
Seat 8: CrazyyParis (button) folded before Flop (didn't bet)
Seat 9: H1JackH1gh (small blind) folded before Flop


*********** # 2 **************
PokerStars Hand #169970313162:  Hold'em No Limit ($0.01/$0.02 USD) - 20=
17/05/05 13:02:45 CUST [2017/05/04 23:02:45 ET]
Table 'Pasiphae' 6-max Seat #2 is the button
Seat 1: gus2456 ($3.23 in chips)=20
Seat 2: the_wickstar ($1.08 in chips)=20
Seat 3: DanuBajusz ($2.64 in chips)=20
Seat 4: 12mk@ace ($1.20 in chips)=20
Seat 6: fschandler ($5.85 in chips)=20
DanuBajusz: posts small blind $0.01
12mk@ace: posts big blind $0.02
*** HOLE CARDS ***
Dealt to the_wickstar [2s 7s]
fschandler: raises $0.04 to $0.06
gus2456: folds=20
the_wickstar: folds=20
the_wickstar leaves the table
DanuBajusz: folds=20
12mk@ace: raises $0.26 to $0.32
fschandler: calls $0.26
*** FLOP *** [2h 8s 9s]
12mk@ace: bets $0.20
fschandler: folds=20
Uncalled bet ($0.20) returned to 12mk@ace
12mk@ace collected $0.63 from pot
12mk@ace: doesn't show hand=20
*** SUMMARY ***
Total pot $0.65 | Rake $0.02=20
Board [2h 8s 9s]
Seat 1: gus2456 folded before Flop (didn't bet)
Seat 2: the_wickstar (button) folded before Flop (didn't bet)
Seat 3: DanuBajusz (small blind) folded before Flop
Seat 4: 12mk@ace (big blind) collected ($0.63)
Seat 6: fschandler folded on the Flop


*********** # 3 **************
PokerStars Hand #169970309110:  Hold'em No Limit ($0.01/$0.02 USD) - 20=
17/05/05 13:02:33 CUST [2017/05/04 23:02:33 ET]
Table 'Pasiphae' 6-max Seat #1 is the button
Seat 1: gus2456 ($3.23 in chips)=20
Seat 2: the_wickstar ($1.09 in chips)=20
Seat 3: DanuBajusz ($2.63 in chips)=20
Seat 4: 12mk@ace ($1.20 in chips)=20
Seat 6: fschandler ($5.85 in chips)=20
the_wickstar: posts small blind $0.01
DanuBajusz: posts big blind $0.02
*** HOLE CARDS ***
Dealt to the_wickstar [Td 5c]
12mk@ace: folds=20
fschandler: folds=20
gus2456: folds=20
the_wickstar: folds=20
Uncalled bet ($0.01) returned to DanuBajusz
DanuBajusz collected $0.02 from pot
DanuBajusz: doesn't show hand=20
*** SUMMARY ***
Total pot $0.02 | Rake $0=20
Seat 1: gus2456 (button) folded before Flop (didn't bet)
Seat 2: the_wickstar (small blind) folded before Flop
Seat 3: DanuBajusz (big blind) collected ($0.02)
Seat 4: 12mk@ace folded before Flop (didn't bet)
Seat 6: fschandler folded before Flop (didn't bet)


*********** # 4 **************
PokerStars Hand #169970300303:  Hold'em No Limit ($0.01/$0.02 USD) - 20=
17/05/05 13:02:06 CUST [2017/05/04 23:02:06 ET]
Table 'Charon' 9-max Seat #8 is the button
Seat 1: Torchidze ($2 in chips)=20
Seat 2: ShiQiang778 ($4.40 in chips)=20
Seat 3: el6cs ($1.80 in chips)=20
Seat 4: display_vip ($1.06 in chips)=20
Seat 6: the_wickstar ($1.29 in chips)=20
Seat 7: ClemenTMienT ($3.07 in chips)=20
Seat 8: Matheuz7 ($2 in chips)=20
Seat 9: Smit0714 ($3.05 in chips)=20
Smit0714: posts small blind $0.01
Torchidze: posts big blind $0.02
LiLZhiMiNG: sits out=20
*** HOLE CARDS ***
Dealt to the_wickstar [6c 8d]
ShiQiang778: folds=20
el6cs: folds=20
display_vip: folds=20
the_wickstar: folds=20
ClemenTMienT: folds=20
Matheuz7: folds=20
Smit0714: raises $0.03 to $0.05
Torchidze: raises $0.12 to $0.17
the_wickstar leaves the table
Smit0714: calls $0.12
*** FLOP *** [4c 3c Jd]
Crage79 joins the table at seat #6=20
Smit0714: checks=20
Torchidze: checks=20
*** TURN *** [4c 3c Jd] [5s]
Smit0714: checks=20
Torchidze: bets $0.21
Smit0714: calls $0.21
*** RIVER *** [4c 3c Jd 5s] [Ks]
Smit0714: checks=20
Torchidze: checks=20
*** SHOW DOWN ***
Smit0714: shows [9h 9c] (a pair of Nines)
Torchidze: shows [Ts Td] (a pair of Tens)
Torchidze collected $0.73 from pot
*** SUMMARY ***
Total pot $0.76 | Rake $0.03=20
Board [4c 3c Jd 5s Ks]
Seat 1: Torchidze (big blind) showed [Ts Td] and won ($0.73) with a pai=
r of Tens
Seat 2: ShiQiang778 folded before Flop (didn't bet)
Seat 3: el6cs folded before Flop (didn't bet)
Seat 4: display_vip folded before Flop (didn't bet)
Seat 6: the_wickstar folded before Flop (didn't bet)
Seat 7: ClemenTMienT folded before Flop (didn't bet)
Seat 8: Matheuz7 (button) folded before Flop (didn't bet)
Seat 9: Smit0714 (small blind) showed [9h 9c] and lost with a pair of N=
ines


*********** # 5 **************
PokerStars Hand #169970298494:  Hold'em No Limit ($0.01/$0.02 USD) - 20=
17/05/05 13:02:00 CUST [2017/05/04 23:02:00 ET]
Table 'Pasiphae' 6-max Seat #6 is the button
Seat 1: gus2456 ($3.24 in chips)=20
Seat 2: the_wickstar ($1.11 in chips)=20
Seat 3: DanuBajusz ($2.71 in chips)=20
Seat 4: 12mk@ace ($0.80 in chips)=20
Seat 6: fschandler ($6.17 in chips)=20
gus2456: posts small blind $0.01
the_wickstar: posts big blind $0.02
12mk@ace: posts big blind $0.02
*** HOLE CARDS ***
Dealt to the_wickstar [4c 7c]
arjam-theone leaves the table
DanuBajusz: raises $0.06 to $0.08
12mk@ace: raises $0.24 to $0.32
fschandler: calls $0.32
gus2456: folds=20
the_wickstar: folds=20
DanuBajusz: folds=20
*** FLOP *** [2h Qh Kd]
12mk@ace: bets $0.48 and is all-in
fschandler: folds=20
Uncalled bet ($0.48) returned to 12mk@ace
12mk@ace collected $0.72 from pot
12mk@ace: doesn't show hand=20
*** SUMMARY ***
Total pot $0.75 | Rake $0.03=20
Board [2h Qh Kd]
Seat 1: gus2456 (small blind) folded before Flop
Seat 2: the_wickstar (big blind) folded before Flop
Seat 3: DanuBajusz folded before Flop
Seat 4: 12mk@ace collected ($0.72)
Seat 6: fschandler (button) folded on the Flop


*********** # 6 **************
PokerStars Hand #169970291422:  Hold'em No Limit ($0.01/$0.02 USD) - 20=
17/05/05 13:01:38 CUST [2017/05/04 23:01:38 ET]
Table 'Pasiphae' 6-max Seat #3 is the button
Seat 1: gus2456 ($3.26 in chips)=20
Seat 2: the_wickstar ($1.13 in chips)=20
Seat 3: DanuBajusz ($2.71 in chips)=20
Seat 6: fschandler ($6.13 in chips)=20
12mk@ace will be allowed to play after the button
fschandler: posts small blind $0.01
gus2456: posts big blind $0.02
*** HOLE CARDS ***
Dealt to the_wickstar [4h Jc]
the_wickstar: calls $0.02
DanuBajusz: folds=20
fschandler: raises $0.04 to $0.06
gus2456: folds=20
the_wickstar: folds=20
Uncalled bet ($0.04) returned to fschandler
fschandler collected $0.06 from pot
fschandler: doesn't show hand=20
*** SUMMARY ***
Total pot $0.06 | Rake $0=20
Seat 1: gus2456 (big blind) folded before Flop
Seat 2: the_wickstar folded before Flop
Seat 3: DanuBajusz (button) folded before Flop (didn't bet)
Seat 6: fschandler (small blind) collected ($0.06)


*********** # 7 **************
PokerStars Hand #169970287798:  Hold'em No Limit ($0.01/$0.02 USD) - 20=
17/05/05 13:01:27 CUST [2017/05/04 23:01:27 ET]
Table 'Charon' 9-max Seat #7 is the button
Seat 2: ShiQiang778 ($4.40 in chips)=20
Seat 3: el6cs ($1.80 in chips)=20
Seat 4: display_vip ($1.06 in chips)=20
Seat 6: the_wickstar ($1.26 in chips)=20
Seat 7: ClemenTMienT ($3.07 in chips)=20
Seat 8: Matheuz7 ($2 in chips)=20
Seat 9: Smit0714 ($3.07 in chips)=20
Matheuz7: posts small blind $0.01
Smit0714: posts big blind $0.02
Torchidze: sits out=20
*** HOLE CARDS ***
Dealt to the_wickstar [6s Kh]
ShiQiang778: folds=20
el6cs: folds=20
LiLZhiMiNG joins the table at seat #5=20
display_vip: folds=20
the_wickstar: calls $0.02
ClemenTMienT: folds=20
Matheuz7: folds=20
Smit0714: checks=20
*** FLOP *** [4s Ks 9d]
Smit0714: checks=20
the_wickstar: bets $0.03
Smit0714: folds=20
Uncalled bet ($0.03) returned to the_wickstar
the_wickstar collected $0.05 from pot
*** SUMMARY ***
Total pot $0.05 | Rake $0=20
Board [4s Ks 9d]
Seat 2: ShiQiang778 folded before Flop (didn't bet)
Seat 3: el6cs folded before Flop (didn't bet)
Seat 4: display_vip folded before Flop (didn't bet)
Seat 6: the_wickstar collected ($0.05)
Seat 7: ClemenTMienT (button) folded before Flop (didn't bet)
Seat 8: Matheuz7 (small blind) folded before Flop
Seat 9: Smit0714 (big blind) folded on the Flop


*********** # 8 **************
PokerStars Hand #169970283528:  Hold'em No Limit ($0.01/$0.02 USD) - 20=
17/05/05 13:01:14 CUST [2017/05/04 23:01:14 ET]
Table 'Pasiphae' 6-max Seat #2 is the button
Seat 1: gus2456 ($3.26 in chips)=20
Seat 2: the_wickstar ($1.10 in chips)=20
Seat 3: DanuBajusz ($2.72 in chips)=20
Seat 6: fschandler ($6.15 in chips)=20
DanuBajusz: posts small blind $0.01
Dziura111: is sitting out=20
Dziura111 leaves the table
fschandler: posts big blind $0.02
*** HOLE CARDS ***
Dealt to the_wickstar [6c Qs]
gus2456: folds=20
the_wickstar: calls $0.02
DanuBajusz: folds=20
fschandler: checks=20
*** FLOP *** [Ah 8d Ac]
fschandler: checks=20
12mk@ace joins the table at seat #4=20
the_wickstar: bets $0.05
fschandler: folds=20
Uncalled bet ($0.05) returned to the_wickstar
the_wickstar collected $0.05 from pot
*** SUMMARY ***
Total pot $0.05 | Rake $0=20
Board [Ah 8d Ac]
Seat 1: gus2456 folded before Flop (didn't bet)
Seat 2: the_wickstar (button) collected ($0.05)
Seat 3: DanuBajusz (small blind) folded before Flop
Seat 6: fschandler (big blind) folded on the Flop


*********** # 9 **************
PokerStars Hand #169970280962:  Hold'em No Limit ($0.01/$0.02 USD) - 20=
17/05/05 13:01:05 CUST [2017/05/04 23:01:05 ET]
Table 'Charon' 9-max Seat #6 is the button
Seat 2: ShiQiang778 ($4.40 in chips)=20
Seat 3: el6cs ($1.77 in chips)=20
Seat 4: display_vip ($1.06 in chips)=20
Seat 6: the_wickstar ($1.26 in chips)=20
Seat 7: ClemenTMienT ($3.08 in chips)=20
Seat 8: Matheuz7 ($2 in chips)=20
Seat 9: Smit0714 ($3.07 in chips)=20
ClemenTMienT: posts small blind $0.01
Matheuz7: posts big blind $0.02
Torchidze: sits out=20
*** HOLE CARDS ***
Dealt to the_wickstar [Ts 4c]
Smit0714: folds=20
ShiQiang778: folds=20
el6cs: raises $0.04 to $0.06
Preto026 leaves the table
display_vip: folds=20
the_wickstar: folds=20
ClemenTMienT: folds=20
Matheuz7: folds=20
Uncalled bet ($0.04) returned to el6cs
el6cs collected $0.05 from pot
el6cs: doesn't show hand=20
*** SUMMARY ***
Total pot $0.05 | Rake $0=20
Seat 2: ShiQiang778 folded before Flop (didn't bet)
Seat 3: el6cs collected ($0.05)
Seat 4: display_vip folded before Flop (didn't bet)
Seat 6: the_wickstar (button) folded before Flop (didn't bet)
Seat 7: ClemenTMienT (small blind) folded before Flop
Seat 8: Matheuz7 (big blind) folded before Flop
Seat 9: Smit0714 folded before Flop (didn't bet)


*********** # 10 **************
PokerStars Hand #169970277582:  Hold'em No Limit ($0.01/$0.02 USD) - 20=
17/05/05 13:00:55 CUST [2017/05/04 23:00:55 ET]
Table 'Pasiphae' 6-max Seat #1 is the button
Seat 1: gus2456 ($3.26 in chips)=20
Seat 2: the_wickstar ($1.11 in chips)=20
Seat 3: DanuBajusz ($2.71 in chips)=20
Seat 4: Dziura111 ($2.41 in chips)=20
Seat 6: fschandler ($6.15 in chips)=20
the_wickstar: posts small blind $0.01
DanuBajusz: posts big blind $0.02
*** HOLE CARDS ***
Dealt to the_wickstar [9h Th]
Dziura111: folds=20
fschandler: folds=20
gus2456: folds=20
the_wickstar: folds=20
Uncalled bet ($0.01) returned to DanuBajusz
DanuBajusz collected $0.02 from pot
DanuBajusz: doesn't show hand=20
*** SUMMARY ***
Total pot $0.02 | Rake $0=20
Seat 1: gus2456 (button) folded before Flop (didn't bet)
Seat 2: the_wickstar (small blind) folded before Flop
Seat 3: DanuBajusz (big blind) collected ($0.02)
Seat 4: Dziura111 folded before Flop (didn't bet)
Seat 6: fschandler folded before Flop (didn't bet)


*********** # 11 **************
PokerStars Hand #169970272279:  Hold'em No Limit ($0.01/$0.02 USD) - 20=
17/05/05 13:00:38 CUST [2017/05/04 23:00:38 ET]
Table 'Pasiphae' 6-max Seat #6 is the button
Seat 1: gus2456 ($3.27 in chips)=20
Seat 2: the_wickstar ($1.13 in chips)=20
Seat 3: DanuBajusz ($2.68 in chips)=20
Seat 4: Dziura111 ($2.41 in chips)=20
Seat 6: fschandler ($6.15 in chips)=20
gus2456: posts small blind $0.01
the_wickstar: posts big blind $0.02
*** HOLE CARDS ***
Dealt to the_wickstar [9s 8h]
DanuBajusz: raises $0.04 to $0.06
Dziura111: folds=20
fschandler: folds=20
gus2456: folds=20
the_wickstar: folds=20
Uncalled bet ($0.04) returned to DanuBajusz
DanuBajusz collected $0.05 from pot
DanuBajusz: doesn't show hand=20
*** SUMMARY ***
Total pot $0.05 | Rake $0=20
Seat 1: gus2456 (small blind) folded before Flop
Seat 2: the_wickstar (big blind) folded before Flop
Seat 3: DanuBajusz collected ($0.05)
Seat 4: Dziura111 folded before Flop (didn't bet)
Seat 6: fschandler (button) folded before Flop (didn't bet)


*********** # 12 **************
PokerStars Hand #169970264789:  Hold'em No Limit ($0.01/$0.02 USD) - 20=
17/05/05 13:00:13 CUST [2017/05/04 23:00:13 ET]
Table 'Pasiphae' 6-max Seat #4 is the button
Seat 1: gus2456 ($3.29 in chips)=20
Seat 2: the_wickstar ($1.13 in chips)=20
Seat 3: DanuBajusz ($2.65 in chips)=20
Seat 4: Dziura111 ($2.41 in chips)=20
Seat 6: fschandler ($6.16 in chips)=20
fschandler: posts small blind $0.01
gus2456: posts big blind $0.02
*** HOLE CARDS ***
Dealt to the_wickstar [6s 4h]
the_wickstar: folds=20
DanuBajusz: raises $0.04 to $0.06
Dziura111: folds=20
fschandler: folds=20
gus2456: folds=20
Uncalled bet ($0.04) returned to DanuBajusz
DanuBajusz collected $0.05 from pot
DanuBajusz: doesn't show hand=20
*** SUMMARY ***
Total pot $0.05 | Rake $0=20
Seat 1: gus2456 (big blind) folded before Flop
Seat 2: the_wickstar folded before Flop (didn't bet)
Seat 3: DanuBajusz collected ($0.05)
Seat 4: Dziura111 (button) folded before Flop (didn't bet)
Seat 6: fschandler (small blind) folded before Flop


*********** # 13 **************
PokerStars Hand #169970260855:  Hold'em No Limit ($0.01/$0.02 USD) - 20=
17/05/05 13:00:00 CUST [2017/05/04 23:00:00 ET]
Table 'Pasiphae' 6-max Seat #3 is the button
Seat 1: gus2456 ($3.29 in chips)=20
Seat 2: the_wickstar ($1.10 in chips)=20
Seat 3: DanuBajusz ($2.65 in chips)=20
Seat 4: Dziura111 ($2.42 in chips)=20
Seat 6: fschandler ($6.18 in chips)=20
Dziura111: posts small blind $0.01
fschandler: posts big blind $0.02
*** HOLE CARDS ***
Dealt to the_wickstar [Ac 9h]
gus2456: folds=20
the_wickstar: raises $0.02 to $0.04
DanuBajusz: folds=20
Dziura111: folds=20
fschandler: folds=20
Uncalled bet ($0.02) returned to the_wickstar
the_wickstar collected $0.05 from pot
*** SUMMARY ***
Total pot $0.05 | Rake $0=20
Seat 1: gus2456 folded before Flop (didn't bet)
Seat 2: the_wickstar collected ($0.05)
Seat 3: DanuBajusz (button) folded before Flop (didn't bet)
Seat 4: Dziura111 (small blind) folded before Flop
Seat 6: fschandler (big blind) folded before Flop


*********** # 14 **************
PokerStars Hand #169970257071:  Hold'em No Limit ($0.01/$0.02 USD) - 20=
17/05/05 12:59:47 CUST [2017/05/04 22:59:47 ET]
Table 'Charon' 9-max Seat #4 is the button
Seat 2: ShiQiang778 ($4.40 in chips)=20
Seat 3: el6cs ($1.89 in chips)=20
Seat 4: display_vip ($1.06 in chips)=20
Seat 5: Preto026 ($0.59 in chips)=20
Seat 6: the_wickstar ($0.60 in chips)=20
Seat 7: ClemenTMienT ($3.08 in chips)=20
Seat 9: Smit0714 ($3.07 in chips)=20
Preto026: posts small blind $0.01
the_wickstar: posts big blind $0.02
Matheuz7: sits out=20
Torchidze: sits out=20
*** HOLE CARDS ***
Dealt to the_wickstar [Kd Kh]
ClemenTMienT: folds=20
Smit0714: folds=20
ShiQiang778: folds=20
el6cs: raises $0.04 to $0.06
display_vip: folds=20
Preto026: calls $0.05
the_wickstar: raises $0.06 to $0.12
el6cs: calls $0.06
Preto026: calls $0.06
*** FLOP *** [Js 4c 9c]
Preto026: bets $0.04
the_wickstar: raises $0.31 to $0.35
el6cs: folds=20
Preto026: raises $0.12 to $0.47 and is all-in
the_wickstar: calls $0.12
*** TURN *** [Js 4c 9c] [Ad]
*** RIVER *** [Js 4c 9c Ad] [4d]
*** SHOW DOWN ***
Preto026: shows [Qc 9d] (two pair, Nines and Fours)
the_wickstar: shows [Kd Kh] (two pair, Kings and Fours)
the_wickstar collected $1.25 from pot
*** SUMMARY ***
Total pot $1.30 | Rake $0.05=20
Board [Js 4c 9c Ad 4d]
Seat 2: ShiQiang778 folded before Flop (didn't bet)
Seat 3: el6cs folded on the Flop
Seat 4: display_vip (button) folded before Flop (didn't bet)
Seat 5: Preto026 (small blind) showed [Qc 9d] and lost with two pair, N=
ines and Fours
Seat 6: the_wickstar (big blind) showed [Kd Kh] and won ($1.25) with tw=
o pair, Kings and Fours
Seat 7: ClemenTMienT folded before Flop (didn't bet)
Seat 9: Smit0714 folded before Flop (didn't bet)


*********** # 15 **************
PokerStars Hand #169970254679:  Hold'em No Limit ($0.01/$0.02 USD) - 20=
17/05/05 12:59:39 CUST [2017/05/04 22:59:39 ET]
Table 'Pasiphae' 6-max Seat #2 is the button
Seat 1: gus2456 ($3.29 in chips)=20
Seat 2: the_wickstar ($1.10 in chips)=20
Seat 3: DanuBajusz ($2.63 in chips)=20
Seat 4: Dziura111 ($2.44 in chips)=20
Seat 6: fschandler ($6.18 in chips)=20
DanuBajusz: posts small blind $0.01
Dziura111: posts big blind $0.02
*** HOLE CARDS ***
Dealt to the_wickstar [Jc 7s]
fschandler: folds=20
gus2456: folds=20
the_wickstar: folds=20
DanuBajusz: raises $0.04 to $0.06
Dziura111: folds=20
Uncalled bet ($0.04) returned to DanuBajusz
DanuBajusz collected $0.04 from pot
DanuBajusz: doesn't show hand=20
*** SUMMARY ***
Total pot $0.04 | Rake $0=20
Seat 1: gus2456 folded before Flop (didn't bet)
Seat 2: the_wickstar (button) folded before Flop (didn't bet)
Seat 3: DanuBajusz (small blind) collected ($0.04)
Seat 4: Dziura111 (big blind) folded before Flop
Seat 6: fschandler folded before Flop (didn't bet)


*********** # 16 **************
PokerStars Hand #169970249673:  Hold'em No Limit ($0.01/$0.02 USD) - 20=
17/05/05 12:59:22 CUST [2017/05/04 22:59:22 ET]
Table 'Pasiphae' 6-max Seat #1 is the button
Seat 1: gus2456 ($3.26 in chips)=20
Seat 2: the_wickstar ($1.11 in chips)=20
Seat 3: DanuBajusz ($2.65 in chips)=20
Seat 4: Dziura111 ($2.44 in chips)=20
Seat 6: fschandler ($6.18 in chips)=20
the_wickstar: posts small blind $0.01
DanuBajusz: posts big blind $0.02
*** HOLE CARDS ***
Dealt to the_wickstar [2d Qs]
Dziura111: folds=20
fschandler: folds=20
gus2456: raises $0.04 to $0.06
the_wickstar: folds=20
DanuBajusz: folds=20
Uncalled bet ($0.04) returned to gus2456
gus2456 collected $0.05 from pot
gus2456: doesn't show hand=20
*** SUMMARY ***
Total pot $0.05 | Rake $0=20
Seat 1: gus2456 (button) collected ($0.05)
Seat 2: the_wickstar (small blind) folded before Flop
Seat 3: DanuBajusz (big blind) folded before Flop
Seat 4: Dziura111 folded before Flop (didn't bet)
Seat 6: fschandler folded before Flop (didn't bet)


*********** # 17 **************
PokerStars Hand #169970246690:  Hold'em No Limit ($0.01/$0.02 USD) - 20=
17/05/05 12:59:12 CUST [2017/05/04 22:59:12 ET]
Table 'Pasiphae' 6-max Seat #6 is the button
Seat 1: gus2456 ($3.27 in chips)=20
Seat 2: the_wickstar ($1.10 in chips)=20
Seat 3: DanuBajusz ($2.65 in chips)=20
Seat 4: Dziura111 ($2.44 in chips)=20
Seat 6: fschandler ($6.18 in chips)=20
gus2456: posts small blind $0.01
the_wickstar: posts big blind $0.02
*** HOLE CARDS ***
Dealt to the_wickstar [9s 8h]
DanuBajusz: folds=20
Dziura111: folds=20
fschandler: folds=20
gus2456: folds=20
Uncalled bet ($0.01) returned to the_wickstar
the_wickstar collected $0.02 from pot
*** SUMMARY ***
Total pot $0.02 | Rake $0=20
Seat 1: gus2456 (small blind) folded before Flop
Seat 2: the_wickstar (big blind) collected ($0.02)
Seat 3: DanuBajusz folded before Flop (didn't bet)
Seat 4: Dziura111 folded before Flop (didn't bet)
Seat 6: fschandler (button) folded before Flop (didn't bet)


*********** # 18 **************
PokerStars Hand #169969972016:  Hold'em No Limit ($0.01/$0.02 USD) - 20=
17/05/05 12:45:04 CUST [2017/05/04 22:45:04 ET]
Table 'Charon' 9-max Seat #4 is the button
Seat 1: boogiehoss ($2.29 in chips)=20
Seat 2: ShiQiang778 ($4 in chips)=20
Seat 4: display_vip ($1.29 in chips)=20
Seat 5: rssollero ($2 in chips)=20
Seat 6: the_wickstar ($0.62 in chips)=20
Seat 7: ClemenTMienT ($2.74 in chips)=20
Seat 8: Pull Ragatio ($1.64 in chips)=20
Seat 9: Smit0714 ($2 in chips)=20
rssollero: posts small blind $0.01
the_wickstar: posts big blind $0.02
*** HOLE CARDS ***
Dealt to the_wickstar [6s 2s]
ClemenTMienT: folds=20
Pull Ragatio: calls $0.02
Smit0714: folds=20
boogiehoss: folds=20
ShiQiang778: calls $0.02
display_vip: raises $0.02 to $0.04
rssollero: calls $0.03
the_wickstar has timed out
the_wickstar: folds=20
Pull Ragatio: calls $0.02
ShiQiang778: calls $0.02
*** FLOP *** [Jd Kc 6h]
rssollero: checks=20
Pull Ragatio: bets $0.06
ShiQiang778: raises $0.06 to $0.12
display_vip: folds=20
rssollero: folds=20
Pull Ragatio: calls $0.06
*** TURN *** [Jd Kc 6h] [9h]
Pull Ragatio: checks=20
ShiQiang778: bets $0.21
Pull Ragatio: calls $0.21
*** RIVER *** [Jd Kc 6h 9h] [Ah]
Pull Ragatio: checks=20
ShiQiang778: bets $0.41
Pull Ragatio: folds=20
Uncalled bet ($0.41) returned to ShiQiang778
ShiQiang778 collected $0.81 from pot
*** SUMMARY ***
Total pot $0.84 | Rake $0.03=20
Board [Jd Kc 6h 9h Ah]
Seat 1: boogiehoss folded before Flop (didn't bet)
Seat 2: ShiQiang778 collected ($0.81)
Seat 4: display_vip (button) folded on the Flop
Seat 5: rssollero (small blind) folded on the Flop
Seat 6: the_wickstar (big blind) folded before Flop
Seat 7: ClemenTMienT folded before Flop (didn't bet)
Seat 8: Pull Ragatio folded on the River
Seat 9: Smit0714 folded before Flop (didn't bet)


*********** # 19 **************
PokerStars Hand #169969939380:  Hold'em No Limit ($0.01/$0.02 USD) - 20=
17/05/05 12:43:24 CUST [2017/05/04 22:43:24 ET]
Table 'Charon' 9-max Seat #3 is the button
Seat 1: boogiehoss ($2.29 in chips)=20
Seat 2: ShiQiang778 ($3.87 in chips)=20
Seat 3: el6cs ($1.94 in chips)=20
Seat 4: display_vip ($1.35 in chips)=20
Seat 5: rssollero ($2 in chips)=20
Seat 6: the_wickstar ($0.62 in chips)=20
Seat 7: ClemenTMienT ($2.74 in chips)=20
Seat 8: Pull Ragatio ($1.70 in chips)=20
Seat 9: Smit0714 ($2 in chips)=20
display_vip: posts small blind $0.01
rssollero: posts big blind $0.02
*** HOLE CARDS ***
Dealt to the_wickstar [7c Ad]
the_wickstar: folds=20
el6cs is disconnected=20
ClemenTMienT: folds=20
Pull Ragatio: calls $0.02
Smit0714: folds=20
boogiehoss: folds=20
ShiQiang778: calls $0.02
el6cs has timed out while disconnected
el6cs: folds=20
display_vip: raises $0.04 to $0.06
rssollero: folds=20
Pull Ragatio: calls $0.04
ShiQiang778: calls $0.04
*** FLOP *** [3h Jc 2c]
display_vip: checks=20
Pull Ragatio: checks=20
ShiQiang778: checks=20
*** TURN *** [3h Jc 2c] [Js]
display_vip: checks=20
Pull Ragatio: checks=20
ShiQiang778: checks=20
*** RIVER *** [3h Jc 2c Js] [5h]
display_vip: checks=20
Pull Ragatio: checks=20
ShiQiang778: bets $0.10
display_vip: folds=20
Pull Ragatio: folds=20
Uncalled bet ($0.10) returned to ShiQiang778
ShiQiang778 collected $0.19 from pot
*** SUMMARY ***
Total pot $0.20 | Rake $0.01=20
Board [3h Jc 2c Js 5h]
Seat 1: boogiehoss folded before Flop (didn't bet)
Seat 2: ShiQiang778 collected ($0.19)
Seat 3: el6cs (button) folded before Flop (didn't bet)
Seat 4: display_vip (small blind) folded on the River
Seat 5: rssollero (big blind) folded before Flop
Seat 6: the_wickstar folded before Flop (didn't bet)
Seat 7: ClemenTMienT folded before Flop (didn't bet)
Seat 8: Pull Ragatio folded on the River
Seat 9: Smit0714 folded before Flop (didn't bet)


*********** # 20 **************
PokerStars Hand #169969911001:  Hold'em No Limit ($0.01/$0.02 USD) - 20=
17/05/05 12:41:58 CUST [2017/05/04 22:41:58 ET]
Table 'Charon' 9-max Seat #2 is the button
Seat 1: boogiehoss ($2.29 in chips)=20
Seat 2: ShiQiang778 ($3.87 in chips)=20
Seat 3: el6cs ($1.95 in chips)=20
Seat 4: display_vip ($1.37 in chips)=20
Seat 5: rssollero ($2 in chips)=20
Seat 6: the_wickstar ($0.70 in chips)=20
Seat 7: ClemenTMienT ($2.74 in chips)=20
Seat 8: Pull Ragatio ($1.60 in chips)=20
Seat 9: Smit0714 ($2 in chips)=20
el6cs: posts small blind $0.01
display_vip: posts big blind $0.02
*** HOLE CARDS ***
Dealt to the_wickstar [9d Ad]
rssollero: folds=20
the_wickstar: raises $0.02 to $0.04
ClemenTMienT: folds=20
Pull Ragatio: calls $0.04
Smit0714: folds=20
boogiehoss: folds=20
ShiQiang778: folds=20
el6cs: folds=20
display_vip: folds=20
*** FLOP *** [6c 7d 6s]
the_wickstar: checks=20
Pull Ragatio: bets $0.04
the_wickstar: calls $0.04
*** TURN *** [6c 7d 6s] [Tc]
the_wickstar: checks=20
Pull Ragatio: bets $0.26
the_wickstar: folds=20
Uncalled bet ($0.26) returned to Pull Ragatio
Pull Ragatio collected $0.18 from pot
*** SUMMARY ***
Total pot $0.19 | Rake $0.01=20
Board [6c 7d 6s Tc]
Seat 1: boogiehoss folded before Flop (didn't bet)
Seat 2: ShiQiang778 (button) folded before Flop (didn't bet)
Seat 3: el6cs (small blind) folded before Flop
Seat 4: display_vip (big blind) folded before Flop
Seat 5: rssollero folded before Flop (didn't bet)
Seat 6: the_wickstar folded on the Turn
Seat 7: ClemenTMienT folded before Flop (didn't bet)
Seat 8: Pull Ragatio collected ($0.18)
Seat 9: Smit0714 folded before Flop (didn't bet)


*********** # 21 **************
PokerStars Hand #169969900750:  Hold'em No Limit ($0.01/$0.02 USD) - 20=
17/05/05 12:41:29 CUST [2017/05/04 22:41:29 ET]
Table 'Charon' 9-max Seat #1 is the button
Seat 1: boogiehoss ($2.29 in chips)=20
Seat 2: ShiQiang778 ($3.88 in chips)=20
Seat 3: el6cs ($1.97 in chips)=20
Seat 4: display_vip ($1.37 in chips)=20
Seat 5: rssollero ($2 in chips)=20
Seat 6: the_wickstar ($0.70 in chips)=20
Seat 7: ClemenTMienT ($2.74 in chips)=20
Seat 8: Pull Ragatio ($1.57 in chips)=20
Seat 9: Smit0714 ($2 in chips)=20
ShiQiang778: posts small blind $0.01
el6cs: posts big blind $0.02
*** HOLE CARDS ***
Dealt to the_wickstar [6d Qh]
display_vip: folds=20
rssollero: folds=20
the_wickstar: folds=20
ClemenTMienT: folds=20
Pull Ragatio: raises $0.02 to $0.04
Smit0714: folds=20
boogiehoss: folds=20
ShiQiang778: folds=20
el6cs: folds=20
Uncalled bet ($0.02) returned to Pull Ragatio
Pull Ragatio collected $0.05 from pot
*** SUMMARY ***
Total pot $0.05 | Rake $0=20
Seat 1: boogiehoss (button) folded before Flop (didn't bet)
Seat 2: ShiQiang778 (small blind) folded before Flop
Seat 3: el6cs (big blind) folded before Flop
Seat 4: display_vip folded before Flop (didn't bet)
Seat 5: rssollero folded before Flop (didn't bet)
Seat 6: the_wickstar folded before Flop (didn't bet)
Seat 7: ClemenTMienT folded before Flop (didn't bet)
Seat 8: Pull Ragatio collected ($0.05)
Seat 9: Smit0714 folded before Flop (didn't bet)


*********** # 22 **************
PokerStars Hand #169969886439:  Hold'em No Limit ($0.01/$0.02 USD) - 20=
17/05/05 12:40:48 CUST [2017/05/04 22:40:48 ET]
Table 'Charon' 9-max Seat #9 is the button
Seat 1: boogiehoss ($2.30 in chips)=20
Seat 2: ShiQiang778 ($3.90 in chips)=20
Seat 3: el6cs ($1.97 in chips)=20
Seat 4: display_vip ($1.37 in chips)=20
Seat 5: rssollero ($2 in chips)=20
Seat 6: the_wickstar ($0.67 in chips)=20
Seat 7: ClemenTMienT ($2.74 in chips)=20
Seat 8: Pull Ragatio ($1.57 in chips)=20
Seat 9: Smit0714 ($2 in chips)=20
boogiehoss: posts small blind $0.01
ShiQiang778: posts big blind $0.02
*** HOLE CARDS ***
Dealt to the_wickstar [Td As]
el6cs: folds=20
display_vip: folds=20
rssollero: folds=20
the_wickstar: raises $0.02 to $0.04
ClemenTMienT: folds=20
Pull Ragatio: folds=20
Smit0714: folds=20
boogiehoss: folds=20
ShiQiang778: folds=20
Uncalled bet ($0.02) returned to the_wickstar
the_wickstar collected $0.05 from pot
*** SUMMARY ***
Total pot $0.05 | Rake $0=20
Seat 1: boogiehoss (small blind) folded before Flop
Seat 2: ShiQiang778 (big blind) folded before Flop
Seat 3: el6cs folded before Flop (didn't bet)
Seat 4: display_vip folded before Flop (didn't bet)
Seat 5: rssollero folded before Flop (didn't bet)
Seat 6: the_wickstar collected ($0.05)
Seat 7: ClemenTMienT folded before Flop (didn't bet)
Seat 8: Pull Ragatio folded before Flop (didn't bet)
Seat 9: Smit0714 (button) folded before Flop (didn't bet)


*********** # 23 **************
PokerStars Hand #169969872136:  Hold'em No Limit ($0.01/$0.02 USD) - 20=
17/05/05 12:40:07 CUST [2017/05/04 22:40:07 ET]
Table 'Charon' 9-max Seat #8 is the button
Seat 1: boogiehoss ($2.32 in chips)=20
Seat 2: ShiQiang778 ($3.90 in chips)=20
Seat 3: el6cs ($1.97 in chips)=20
Seat 4: display_vip ($1.37 in chips)=20
Seat 5: rssollero ($2 in chips)=20
Seat 6: the_wickstar ($0.60 in chips)=20
Seat 7: ClemenTMienT ($2.74 in chips)=20
Seat 8: Pull Ragatio ($1.61 in chips)=20
Seat 9: Smit0714 ($2.01 in chips)=20
Smit0714: posts small blind $0.01
boogiehoss: posts big blind $0.02
*** HOLE CARDS ***
Dealt to the_wickstar [Kc Qd]
ShiQiang778: folds=20
el6cs: folds=20
display_vip: folds=20
rssollero: folds=20
the_wickstar: raises $0.02 to $0.04
ClemenTMienT: folds=20
Pull Ragatio: calls $0.04
Smit0714: folds=20
boogiehoss: folds=20
*** FLOP *** [Qc 9s 6d]
the_wickstar: bets $0.07
Pull Ragatio: folds=20
Uncalled bet ($0.07) returned to the_wickstar
the_wickstar collected $0.11 from pot
*** SUMMARY ***
Total pot $0.11 | Rake $0=20
Board [Qc 9s 6d]
Seat 1: boogiehoss (big blind) folded before Flop
Seat 2: ShiQiang778 folded before Flop (didn't bet)
Seat 3: el6cs folded before Flop (didn't bet)
Seat 4: display_vip folded before Flop (didn't bet)
Seat 5: rssollero folded before Flop (didn't bet)
Seat 6: the_wickstar collected ($0.11)
Seat 7: ClemenTMienT folded before Flop (didn't bet)
Seat 8: Pull Ragatio (button) folded on the Flop
Seat 9: Smit0714 (small blind) folded before Flop


*********** # 24 **************
PokerStars Hand #169969841578:  Hold'em No Limit ($0.01/$0.02 USD) - 20=
17/05/05 12:38:39 CUST [2017/05/04 22:38:39 ET]
Table 'Charon' 9-max Seat #7 is the button
Seat 1: boogiehoss ($2.32 in chips)=20
Seat 2: ShiQiang778 ($3.90 in chips)=20
Seat 3: el6cs ($1.97 in chips)=20
Seat 4: display_vip ($1.37 in chips)=20
Seat 5: rssollero ($2 in chips)=20
Seat 6: the_wickstar ($0.60 in chips)=20
Seat 7: ClemenTMienT ($2.74 in chips)=20
Seat 8: Pull Ragatio ($1.60 in chips)=20
Seat 9: Smit0714 ($2.03 in chips)=20
Pull Ragatio: posts small blind $0.01
Smit0714: posts big blind $0.02
*** HOLE CARDS ***
Dealt to the_wickstar [8h Td]
boogiehoss: folds=20
ShiQiang778: folds=20
el6cs: folds=20
display_vip: folds=20
rssollero: raises $0.02 to $0.04
the_wickstar: folds=20
ClemenTMienT: folds=20
Pull Ragatio: calls $0.03
Smit0714: folds=20
*** FLOP *** [Js Jh 3d]
Pull Ragatio: bets $0.04
rssollero: raises $0.09 to $0.13
Pull Ragatio: calls $0.09
*** TURN *** [Js Jh 3d] [Ac]
Pull Ragatio: checks=20
rssollero: checks=20
*** RIVER *** [Js Jh 3d Ac] [Kd]
Pull Ragatio: checks=20
rssollero: checks=20
*** SHOW DOWN ***
Pull Ragatio: shows [3h 9d] (two pair, Jacks and Threes)
rssollero: shows [5c 3c] (two pair, Jacks and Threes)
Pull Ragatio collected $0.18 from pot
rssollero collected $0.17 from pot
*** SUMMARY ***
Total pot $0.36 | Rake $0.01=20
Board [Js Jh 3d Ac Kd]
Seat 1: boogiehoss folded before Flop (didn't bet)
Seat 2: ShiQiang778 folded before Flop (didn't bet)
Seat 3: el6cs folded before Flop (didn't bet)
Seat 4: display_vip folded before Flop (didn't bet)
Seat 5: rssollero showed [5c 3c] and won ($0.17) with two pair, Jacks a=
nd Threes
Seat 6: the_wickstar folded before Flop (didn't bet)
Seat 7: ClemenTMienT (button) folded before Flop (didn't bet)
Seat 8: Pull Ragatio (small blind) showed [3h 9d] and won ($0.18) with =
two pair, Jacks and Threes
Seat 9: Smit0714 (big blind) folded before Flop


*********** # 25 **************
PokerStars Hand #169969819684:  Hold'em No Limit ($0.01/$0.02 USD) - 20=
17/05/05 12:37:36 CUST [2017/05/04 22:37:36 ET]
Table 'Charon' 9-max Seat #6 is the button
Seat 1: boogiehoss ($2.32 in chips)=20
Seat 2: ShiQiang778 ($3.90 in chips)=20
Seat 3: el6cs ($1.97 in chips)=20
Seat 4: display_vip ($0.97 in chips)=20
Seat 5: rssollero ($2 in chips)=20
Seat 6: the_wickstar ($0.60 in chips)=20
Seat 7: ClemenTMienT ($2.75 in chips)=20
Seat 8: Pull Ragatio ($2.02 in chips)=20
Seat 9: Smit0714 ($2.03 in chips)=20
ClemenTMienT: posts small blind $0.01
Pull Ragatio: posts big blind $0.02
*** HOLE CARDS ***
Dealt to the_wickstar [8c 2c]
Smit0714: folds=20
boogiehoss: folds=20
ShiQiang778: folds=20
el6cs: folds=20
display_vip: raises $0.04 to $0.06
rssollero: folds=20
the_wickstar: folds=20
ClemenTMienT: folds=20
Pull Ragatio: calls $0.04
*** FLOP *** [Tc 3h Jc]
Pull Ragatio: checks=20
display_vip: checks=20
*** TURN *** [Tc 3h Jc] [Qh]
Pull Ragatio: checks=20
display_vip: bets $0.12
Pull Ragatio: calls $0.12
*** RIVER *** [Tc 3h Jc Qh] [6d]
Pull Ragatio: checks=20
display_vip: bets $0.24
Pull Ragatio: calls $0.24
*** SHOW DOWN ***
display_vip: shows [Jh Jd] (three of a kind, Jacks)
Pull Ragatio: mucks hand=20
display_vip collected $0.82 from pot
*** SUMMARY ***
Total pot $0.85 | Rake $0.03=20
Board [Tc 3h Jc Qh 6d]
Seat 1: boogiehoss folded before Flop (didn't bet)
Seat 2: ShiQiang778 folded before Flop (didn't bet)
Seat 3: el6cs folded before Flop (didn't bet)
Seat 4: display_vip showed [Jh Jd] and won ($0.82) with three of a kind=
, Jacks
Seat 5: rssollero folded before Flop (didn't bet)
Seat 6: the_wickstar (button) folded before Flop (didn't bet)
Seat 7: ClemenTMienT (small blind) folded before Flop
Seat 8: Pull Ragatio (big blind) mucked [Qc 7s]
Seat 9: Smit0714 folded before Flop (didn't bet)


*********** # 26 **************
PokerStars Hand #169969808382: Tournament #1897347969, 5 SC Hold'em No =
Limit - Level II (40/80) - 2017/05/05 12:37:04 CUST [2017/05/04 22:37:0=
4 ET]
Table '1897347969 3' 9-max Seat #5 is the button
Seat 1: Antwerken (3030 in chips)=20
Seat 2: nano19072013 (2993 in chips)=20
Seat 3: Disciple -98 (3516 in chips)=20
Seat 4: scooby196504 (2481 in chips)=20
Seat 5: yjs2013 (2775 in chips)=20
Seat 6: the_wickstar (2916 in chips)=20
Seat 8: bygoddin (7850 in chips)=20
Seat 9: ManfrediFag (3061 in chips)=20
Antwerken: posts the ante 10
nano19072013: posts the ante 10
Disciple -98: posts the ante 10
scooby196504: posts the ante 10
yjs2013: posts the ante 10
the_wickstar: posts the ante 10
bygoddin: posts the ante 10
ManfrediFag: posts the ante 10
the_wickstar: posts small blind 40
bygoddin: posts big blind 80
*** HOLE CARDS ***
Dealt to the_wickstar [Ts Ks]
ManfrediFag: folds=20
Antwerken: folds=20
nano19072013: folds=20
Disciple -98: raises 280 to 360
scooby196504: folds=20
yjs2013: folds=20
the_wickstar: calls 320
bygoddin: raises 7480 to 7840 and is all-in
Disciple -98: calls 3146 and is all-in
the_wickstar: calls 2546 and is all-in
Uncalled bet (4334) returned to bygoddin
*** FLOP *** [6h 6d 8s]
*** TURN *** [6h 6d 8s] [5h]
*** RIVER *** [6h 6d 8s 5h] [3d]
*** SHOW DOWN ***
bygoddin: shows [Kd Qc] (a pair of Sixes)
Disciple -98: shows [2d 2h] (two pair, Sixes and Deuces)
Disciple -98 collected 1200 from side pot
the_wickstar: shows [Ts Ks] (a pair of Sixes)
Disciple -98 collected 8798 from main pot
the_wickstar finished the tournament in 134th place
*** SUMMARY ***
Total pot 9998 Main pot 8798. Side pot 1200. | Rake 0=20
Board [6h 6d 8s 5h 3d]
Seat 1: Antwerken folded before Flop (didn't bet)
Seat 2: nano19072013 folded before Flop (didn't bet)
Seat 3: Disciple -98 showed [2d 2h] and won (9998) with two pair, Sixes=
 and Deuces
Seat 4: scooby196504 folded before Flop (didn't bet)
Seat 5: yjs2013 (button) folded before Flop (didn't bet)
Seat 6: the_wickstar (small blind) showed [Ts Ks] and lost with a pair =
of Sixes
Seat 8: bygoddin (big blind) showed [Kd Qc] and lost with a pair of Six=
es
Seat 9: ManfrediFag folded before Flop (didn't bet)


*********** # 27 **************
PokerStars Hand #169969799492:  Hold'em No Limit ($0.01/$0.02 USD) - 20=
17/05/05 12:36:38 CUST [2017/05/04 22:36:38 ET]
Table 'Charon' 9-max Seat #5 is the button
Seat 1: boogiehoss ($2.32 in chips)=20
Seat 2: ShiQiang778 ($3.90 in chips)=20
Seat 3: el6cs ($1.97 in chips)=20
Seat 4: display_vip ($0.97 in chips)=20
Seat 5: rssollero ($2 in chips)=20
Seat 6: the_wickstar ($0.53 in chips)=20
Seat 7: ClemenTMienT ($2.83 in chips)=20
Seat 8: Pull Ragatio ($2.02 in chips)=20
Seat 9: Smit0714 ($2.03 in chips)=20
the_wickstar: posts small blind $0.01
ClemenTMienT: posts big blind $0.02
*** HOLE CARDS ***
Dealt to the_wickstar [Ad Ah]
Pull Ragatio: folds=20
Smit0714: folds=20
boogiehoss: folds=20
ShiQiang778: folds=20
el6cs: folds=20
display_vip: folds=20
rssollero: folds=20
the_wickstar: calls $0.01
ClemenTMienT: checks=20
*** FLOP *** [5s 3s 9c]
the_wickstar: bets $0.02
ClemenTMienT: calls $0.02
*** TURN *** [5s 3s 9c] [As]
the_wickstar: bets $0.04
ClemenTMienT: calls $0.04
*** RIVER *** [5s 3s 9c As] [Kh]
the_wickstar: bets $0.15
ClemenTMienT: folds=20
Uncalled bet ($0.15) returned to the_wickstar
the_wickstar collected $0.15 from pot
*** SUMMARY ***
Total pot $0.16 | Rake $0.01=20
Board [5s 3s 9c As Kh]
Seat 1: boogiehoss folded before Flop (didn't bet)
Seat 2: ShiQiang778 folded before Flop (didn't bet)
Seat 3: el6cs folded before Flop (didn't bet)
Seat 4: display_vip folded before Flop (didn't bet)
Seat 5: rssollero (button) folded before Flop (didn't bet)
Seat 6: the_wickstar (small blind) collected ($0.15)
Seat 7: ClemenTMienT (big blind) folded on the River
Seat 8: Pull Ragatio folded before Flop (didn't bet)
Seat 9: Smit0714 folded before Flop (didn't bet)


*********** # 28 **************
PokerStars Hand #169969785548: Tournament #1897347969, 5 SC Hold'em No =
Limit - Level II (40/80) - 2017/05/05 12:35:58 CUST [2017/05/04 22:35:5=
8 ET]
Table '1897347969 3' 9-max Seat #4 is the button
Seat 1: Antwerken (3200 in chips)=20
Seat 2: nano19072013 (3163 in chips)=20
Seat 3: Disciple -98 (3526 in chips)=20
Seat 4: scooby196504 (2651 in chips)=20
Seat 5: yjs2013 (2825 in chips)=20
Seat 6: the_wickstar (3086 in chips)=20
Seat 7: mangust5411 (2963 in chips)=20
Seat 8: bygoddin (7860 in chips)=20
Seat 9: ManfrediFag (3231 in chips)=20
Antwerken: posts the ante 10
nano19072013: posts the ante 10
Disciple -98: posts the ante 10
scooby196504: posts the ante 10
yjs2013: posts the ante 10
the_wickstar: posts the ante 10
mangust5411: posts the ante 10
bygoddin: posts the ante 10
ManfrediFag: posts the ante 10
yjs2013: posts small blind 40
the_wickstar: posts big blind 80
*** HOLE CARDS ***
Dealt to the_wickstar [3d 6c]
mangust5411: raises 80 to 160
bygoddin: folds=20
ManfrediFag: calls 160
Antwerken: calls 160
nano19072013: calls 160
Disciple -98: folds=20
scooby196504: calls 160
yjs2013: folds=20
the_wickstar: calls 80
*** FLOP *** [9h As Ac]
the_wickstar: checks=20
mangust5411: bets 560
ManfrediFag: folds=20
Antwerken: folds=20
nano19072013: folds=20
scooby196504: folds=20
the_wickstar: folds=20
Uncalled bet (560) returned to mangust5411
mangust5411 collected 1090 from pot
*** SUMMARY ***
Total pot 1090 | Rake 0=20
Board [9h As Ac]
Seat 1: Antwerken folded on the Flop
Seat 2: nano19072013 folded on the Flop
Seat 3: Disciple -98 folded before Flop (didn't bet)
Seat 4: scooby196504 (button) folded on the Flop
Seat 5: yjs2013 (small blind) folded before Flop
Seat 6: the_wickstar (big blind) folded on the Flop
Seat 7: mangust5411 collected (1090)
Seat 8: bygoddin folded before Flop (didn't bet)
Seat 9: ManfrediFag folded on the Flop


*********** # 29 **************
PokerStars Hand #169969764989: Tournament #1897347969, 5 SC Hold'em No =
Limit - Level II (40/80) - 2017/05/05 12:35:26 CUST [2017/05/04 22:35:2=
6 ET]
Table '1897347969 3' 9-max Seat #3 is the button
Seat 1: Antwerken (3000 in chips)=20
Seat 2: nano19072013 (3173 in chips)=20
Seat 3: Disciple -98 (3536 in chips)=20
Seat 4: scooby196504 (2701 in chips)=20
Seat 5: yjs2013 (2915 in chips)=20
Seat 6: the_wickstar (3096 in chips)=20
Seat 7: mangust5411 (2973 in chips)=20
Seat 8: bygoddin (7870 in chips)=20
Seat 9: ManfrediFag (3241 in chips)=20
Antwerken: posts the ante 10
nano19072013: posts the ante 10
Disciple -98: posts the ante 10
scooby196504: posts the ante 10
yjs2013: posts the ante 10
the_wickstar: posts the ante 10
mangust5411: posts the ante 10
bygoddin: posts the ante 10
ManfrediFag: posts the ante 10
scooby196504: posts small blind 40
yjs2013: posts big blind 80
*** HOLE CARDS ***
Dealt to the_wickstar [Kd 9c]
the_wickstar: folds=20
mangust5411: folds=20
bygoddin: folds=20
ManfrediFag: folds=20
Antwerken: raises 290 to 370
nano19072013: folds=20
Disciple -98: folds=20
scooby196504: folds=20
yjs2013: folds=20
Uncalled bet (290) returned to Antwerken
Antwerken collected 290 from pot
Antwerken: doesn't show hand=20
*** SUMMARY ***
Total pot 290 | Rake 0=20
Seat 1: Antwerken collected (290)
Seat 2: nano19072013 folded before Flop (didn't bet)
Seat 3: Disciple -98 (button) folded before Flop (didn't bet)
Seat 4: scooby196504 (small blind) folded before Flop
Seat 5: yjs2013 (big blind) folded before Flop
Seat 6: the_wickstar folded before Flop (didn't bet)
Seat 7: mangust5411 folded before Flop (didn't bet)
Seat 8: bygoddin folded before Flop (didn't bet)
Seat 9: ManfrediFag folded before Flop (didn't bet)


*********** # 30 **************
PokerStars Hand #169969758666:  Hold'em No Limit ($0.01/$0.02 USD) - 20=
17/05/05 12:35:08 CUST [2017/05/04 22:35:08 ET]
Table 'Charon' 9-max Seat #4 is the button
Seat 1: boogiehoss ($2.32 in chips)=20
Seat 2: ShiQiang778 ($3.90 in chips)=20
Seat 3: el6cs ($1.97 in chips)=20
Seat 4: display_vip ($0.97 in chips)=20
Seat 5: rssollero ($2 in chips)=20
Seat 6: the_wickstar ($0.83 in chips)=20
Seat 7: ClemenTMienT ($2.83 in chips)=20
Seat 8: Pull Ragatio ($1.73 in chips)=20
Seat 9: Smit0714 ($2.03 in chips)=20
rssollero: posts small blind $0.01
the_wickstar: posts big blind $0.02
*** HOLE CARDS ***
Dealt to the_wickstar [4s 2h]
ClemenTMienT: folds=20
Pull Ragatio: calls $0.02
Smit0714: folds=20
boogiehoss: folds=20
ShiQiang778: folds=20
el6cs: folds=20
display_vip: folds=20
rssollero: folds=20
the_wickstar: checks=20
*** FLOP *** [Ad 4c Qs]
the_wickstar: checks=20
Pull Ragatio: bets $0.08
the_wickstar: calls $0.08
*** TURN *** [Ad 4c Qs] [5s]
the_wickstar: checks=20
Pull Ragatio: bets $0.08
the_wickstar: raises $0.12 to $0.20
Pull Ragatio: calls $0.12
*** RIVER *** [Ad 4c Qs 5s] [8d]
the_wickstar: checks=20
Pull Ragatio: checks=20
*** SHOW DOWN ***
the_wickstar: shows [4s 2h] (a pair of Fours)
Pull Ragatio: shows [6h 5h] (a pair of Fives)
Pull Ragatio collected $0.59 from pot
*** SUMMARY ***
Total pot $0.61 | Rake $0.02=20
Board [Ad 4c Qs 5s 8d]
Seat 1: boogiehoss folded before Flop (didn't bet)
Seat 2: ShiQiang778 folded before Flop (didn't bet)
Seat 3: el6cs folded before Flop (didn't bet)
Seat 4: display_vip (button) folded before Flop (didn't bet)
Seat 5: rssollero (small blind) folded before Flop
Seat 6: the_wickstar (big blind) showed [4s 2h] and lost with a pair of=
 Fours
Seat 7: ClemenTMienT folded before Flop (didn't bet)
Seat 8: Pull Ragatio showed [6h 5h] and won ($0.59) with a pair of Fives
Seat 9: Smit0714 folded before Flop (didn't bet)


*********** # 31 **************
PokerStars Hand #169969745997: Tournament #1897347969, 5 SC Hold'em No =
Limit - Level II (40/80) - 2017/05/05 12:34:32 CUST [2017/05/04 22:34:3=
2 ET]
Table '1897347969 3' 9-max Seat #2 is the button
Seat 2: nano19072013 (3183 in chips)=20
Seat 3: Disciple -98 (3586 in chips)=20
Seat 4: scooby196504 (2791 in chips)=20
Seat 5: yjs2013 (2925 in chips)=20
Seat 6: the_wickstar (2496 in chips)=20
Seat 7: mangust5411 (2983 in chips)=20
Seat 8: bygoddin (8290 in chips)=20
Seat 9: ManfrediFag (3251 in chips)=20
nano19072013: posts the ante 10
Disciple -98: posts the ante 10
scooby196504: posts the ante 10
yjs2013: posts the ante 10
the_wickstar: posts the ante 10
mangust5411: posts the ante 10
bygoddin: posts the ante 10
ManfrediFag: posts the ante 10
Disciple -98: posts small blind 40
scooby196504: posts big blind 80
*** HOLE CARDS ***
Dealt to the_wickstar [Ts Qd]
yjs2013: folds=20
the_wickstar: raises 80 to 160
mangust5411: folds=20
bygoddin: calls 160
ManfrediFag: folds=20
nano19072013: folds=20
Disciple -98: folds=20
scooby196504: folds=20
*** FLOP *** [3c 3d 8h]
the_wickstar: checks=20
bygoddin: checks=20
*** TURN *** [3c 3d 8h] [Qs]
the_wickstar: bets 250
bygoddin: calls 250
*** RIVER *** [3c 3d 8h Qs] [8d]
the_wickstar: checks=20
bygoddin: checks=20
*** SHOW DOWN ***
the_wickstar: shows [Ts Qd] (two pair, Queens and Eights)
bygoddin: mucks hand=20
the_wickstar collected 1020 from pot
*** SUMMARY ***
Total pot 1020 | Rake 0=20
Board [3c 3d 8h Qs 8d]
Seat 2: nano19072013 (button) folded before Flop (didn't bet)
Seat 3: Disciple -98 (small blind) folded before Flop
Seat 4: scooby196504 (big blind) folded before Flop
Seat 5: yjs2013 folded before Flop (didn't bet)
Seat 6: the_wickstar showed [Ts Qd] and won (1020) with two pair, Queen=
s and Eights
Seat 7: mangust5411 folded before Flop (didn't bet)
Seat 8: bygoddin mucked [Ks Td]
Seat 9: ManfrediFag folded before Flop (didn't bet)


*********** # 32 **************
PokerStars Hand #169969736599:  Hold'em No Limit ($0.01/$0.02 USD) - 20=
17/05/05 12:34:05 CUST [2017/05/04 22:34:05 ET]
Table 'Charon' 9-max Seat #3 is the button
Seat 1: boogiehoss ($2.32 in chips)=20
Seat 2: ShiQiang778 ($3.90 in chips)=20
Seat 3: el6cs ($1.97 in chips)=20
Seat 4: display_vip ($0.98 in chips)=20
Seat 5: rssollero ($2 in chips)=20
Seat 6: the_wickstar ($0.83 in chips)=20
Seat 7: ClemenTMienT ($2.58 in chips)=20
Seat 8: Pull Ragatio ($1.97 in chips)=20
Seat 9: Smit0714 ($2.03 in chips)=20
display_vip: posts small blind $0.01
rssollero: posts big blind $0.02
*** HOLE CARDS ***
Dealt to the_wickstar [Tc 9d]
the_wickstar: folds=20
ClemenTMienT: raises $0.04 to $0.06
Pull Ragatio: calls $0.06
Smit0714: folds=20
boogiehoss: folds=20
ShiQiang778: folds=20
el6cs: folds=20
display_vip: folds=20
rssollero: folds=20
*** FLOP *** [7h 5c 7c]
ClemenTMienT: bets $0.06
Pull Ragatio: calls $0.06
*** TURN *** [7h 5c 7c] [9h]
ClemenTMienT: bets $0.12
Pull Ragatio: calls $0.12
*** RIVER *** [7h 5c 7c 9h] [Jd]
ClemenTMienT: checks=20
Pull Ragatio: checks=20
*** SHOW DOWN ***
ClemenTMienT: shows [Ad Ks] (a pair of Sevens)
Pull Ragatio: mucks hand=20
ClemenTMienT collected $0.49 from pot
*** SUMMARY ***
Total pot $0.51 | Rake $0.02=20
Board [7h 5c 7c 9h Jd]
Seat 1: boogiehoss folded before Flop (didn't bet)
Seat 2: ShiQiang778 folded before Flop (didn't bet)
Seat 3: el6cs (button) folded before Flop (didn't bet)
Seat 4: display_vip (small blind) folded before Flop
Seat 5: rssollero (big blind) folded before Flop
Seat 6: the_wickstar folded before Flop (didn't bet)
Seat 7: ClemenTMienT showed [Ad Ks] and won ($0.49) with a pair of Seve=
ns
Seat 8: Pull Ragatio mucked [8h Ac]
Seat 9: Smit0714 folded before Flop (didn't bet)


*********** # 33 **************
PokerStars Hand #169969723018: Tournament #1897347969, 5 SC Hold'em No =
Limit - Level II (40/80) - 2017/05/05 12:33:26 CUST [2017/05/04 22:33:2=
6 ET]
Table '1897347969 3' 9-max Seat #9 is the button
Seat 2: nano19072013 (3273 in chips)=20
Seat 3: Disciple -98 (2956 in chips)=20
Seat 4: scooby196504 (2801 in chips)=20
Seat 5: yjs2013 (2935 in chips)=20
Seat 6: the_wickstar (2986 in chips)=20
Seat 7: mangust5411 (2993 in chips)=20
Seat 8: bygoddin (8300 in chips)=20
Seat 9: ManfrediFag (3261 in chips)=20
nano19072013: posts the ante 10
Disciple -98: posts the ante 10
scooby196504: posts the ante 10
yjs2013: posts the ante 10
the_wickstar: posts the ante 10
mangust5411: posts the ante 10
bygoddin: posts the ante 10
ManfrediFag: posts the ante 10
nano19072013: posts small blind 40
Disciple -98: posts big blind 80
*** HOLE CARDS ***
Dealt to the_wickstar [7h 8h]
scooby196504: folds=20
yjs2013: folds=20
the_wickstar: calls 80
mangust5411: folds=20
bygoddin: folds=20
ManfrediFag: folds=20
nano19072013: calls 40
Disciple -98: raises 400 to 480
the_wickstar: calls 400
nano19072013: folds=20
*** FLOP *** [Jc 6d 3s]
Disciple -98: bets 560
the_wickstar: folds=20
Uncalled bet (560) returned to Disciple -98
Disciple -98 collected 1120 from pot
*** SUMMARY ***
Total pot 1120 | Rake 0=20
Board [Jc 6d 3s]
Seat 2: nano19072013 (small blind) folded before Flop
Seat 3: Disciple -98 (big blind) collected (1120)
Seat 4: scooby196504 folded before Flop (didn't bet)
Seat 5: yjs2013 folded before Flop (didn't bet)
Seat 6: the_wickstar folded on the Flop
Seat 7: mangust5411 folded before Flop (didn't bet)
Seat 8: bygoddin folded before Flop (didn't bet)
Seat 9: ManfrediFag (button) folded before Flop (didn't bet)


*********** # 34 **************
PokerStars Hand #169969715960:  Hold'em No Limit ($0.01/$0.02 USD) - 20=
17/05/05 12:33:06 CUST [2017/05/04 22:33:06 ET]
Table 'Charon' 9-max Seat #2 is the button
Seat 1: boogiehoss ($2.32 in chips)=20
Seat 2: ShiQiang778 ($3.90 in chips)=20
Seat 3: el6cs ($1.98 in chips)=20
Seat 4: display_vip ($1 in chips)=20
Seat 5: rssollero ($2 in chips)=20
Seat 6: the_wickstar ($0.80 in chips)=20
Seat 7: ClemenTMienT ($2.58 in chips)=20
Seat 8: Pull Ragatio ($1.97 in chips)=20
Seat 9: Smit0714 ($2.03 in chips)=20
el6cs: posts small blind $0.01
display_vip: posts big blind $0.02
*** HOLE CARDS ***
Dealt to the_wickstar [8s 8d]
rssollero has timed out
rssollero: folds=20
the_wickstar: raises $0.02 to $0.04
ClemenTMienT: folds=20
Pull Ragatio: folds=20
Smit0714: folds=20
boogiehoss: folds=20
ShiQiang778: folds=20
el6cs: folds=20
display_vip: folds=20
Uncalled bet ($0.02) returned to the_wickstar
the_wickstar collected $0.05 from pot
*** SUMMARY ***
Total pot $0.05 | Rake $0=20
Seat 1: boogiehoss folded before Flop (didn't bet)
Seat 2: ShiQiang778 (button) folded before Flop (didn't bet)
Seat 3: el6cs (small blind) folded before Flop
Seat 4: display_vip (big blind) folded before Flop
Seat 5: rssollero folded before Flop (didn't bet)
Seat 6: the_wickstar collected ($0.05)
Seat 7: ClemenTMienT folded before Flop (didn't bet)
Seat 8: Pull Ragatio folded before Flop (didn't bet)
Seat 9: Smit0714 folded before Flop (didn't bet)


*********** # 35 **************
PokerStars Hand #169969703794:  Hold'em No Limit ($0.01/$0.02 USD) - 20=
17/05/05 12:32:31 CUST [2017/05/04 22:32:31 ET]
Table 'Charon' 9-max Seat #1 is the button
Seat 1: boogiehoss ($2.32 in chips)=20
Seat 2: ShiQiang778 ($3.91 in chips)=20
Seat 3: el6cs ($2 in chips)=20
Seat 5: rssollero ($2 in chips)=20
Seat 6: the_wickstar ($0.80 in chips)=20
Seat 7: ClemenTMienT ($2.58 in chips)=20
Seat 8: Pull Ragatio ($1.97 in chips)=20
Seat 9: Smit0714 ($2 in chips)=20
ShiQiang778: posts small blind $0.01
el6cs: posts big blind $0.02
*** HOLE CARDS ***
Dealt to the_wickstar [5h Qd]
display_vip joins the table at seat #4=20
rssollero: folds=20
the_wickstar: folds=20
ClemenTMienT: folds=20
Pull Ragatio: folds=20
Smit0714: raises $0.03 to $0.05
boogiehoss: folds=20
ShiQiang778: folds=20
el6cs: folds=20
Uncalled bet ($0.03) returned to Smit0714
Smit0714 collected $0.05 from pot
Smit0714: doesn't show hand=20
*** SUMMARY ***
Total pot $0.05 | Rake $0=20
Seat 1: boogiehoss (button) folded before Flop (didn't bet)
Seat 2: ShiQiang778 (small blind) folded before Flop
Seat 3: el6cs (big blind) folded before Flop
Seat 5: rssollero folded before Flop (didn't bet)
Seat 6: the_wickstar folded before Flop (didn't bet)
Seat 7: ClemenTMienT folded before Flop (didn't bet)
Seat 8: Pull Ragatio folded before Flop (didn't bet)
Seat 9: Smit0714 collected ($0.05)


*********** # 36 **************
PokerStars Hand #169969689075: Tournament #1897347969, 5 SC Hold'em No =
Limit - Level I (30/60) - 2017/05/05 12:31:49 CUST [2017/05/04 22:31:49=
 ET]
Table '1897347969 3' 9-max Seat #8 is the button
Seat 2: nano19072013 (2986 in chips)=20
Seat 3: Disciple -98 (2963 in chips)=20
Seat 4: scooby196504 (2986 in chips)=20
Seat 5: yjs2013 (2942 in chips)=20
Seat 6: the_wickstar (2993 in chips)=20
Seat 7: mangust5411 (3000 in chips)=20
Seat 8: bygoddin (8307 in chips)=20
Seat 9: ManfrediFag (3328 in chips)=20
nano19072013: posts the ante 7
Disciple -98: posts the ante 7
scooby196504: posts the ante 7
yjs2013: posts the ante 7
the_wickstar: posts the ante 7
mangust5411: posts the ante 7
bygoddin: posts the ante 7
ManfrediFag: posts the ante 7
ManfrediFag: posts small blind 30
nano19072013: posts big blind 60
*** HOLE CARDS ***
Dealt to the_wickstar [3h 9s]
Disciple -98: folds=20
scooby196504: calls 60
yjs2013: folds=20
the_wickstar: folds=20
mangust5411: folds=20
bygoddin: folds=20
ManfrediFag: calls 30
nano19072013: checks=20
*** FLOP *** [Qc 3c Kh]
ManfrediFag: checks=20
nano19072013: checks=20
scooby196504: checks=20
*** TURN *** [Qc 3c Kh] [7s]
ManfrediFag: checks=20
nano19072013: bets 118
scooby196504: calls 118
ManfrediFag: folds=20
*** RIVER *** [Qc 3c Kh 7s] [8d]
nano19072013: bets 236
scooby196504: folds=20
Uncalled bet (236) returned to nano19072013
nano19072013 collected 472 from pot
*** SUMMARY ***
Total pot 472 | Rake 0=20
Board [Qc 3c Kh 7s 8d]
Seat 2: nano19072013 (big blind) collected (472)
Seat 3: Disciple -98 folded before Flop (didn't bet)
Seat 4: scooby196504 folded on the River
Seat 5: yjs2013 folded before Flop (didn't bet)
Seat 6: the_wickstar folded before Flop (didn't bet)
Seat 7: mangust5411 folded before Flop (didn't bet)
Seat 8: bygoddin (button) folded before Flop (didn't bet)
Seat 9: ManfrediFag (small blind) folded on the Turn


*********** # 37 **************
PokerStars Hand #169969678698:  Hold'em No Limit ($0.01/$0.02 USD) - 20=
17/05/05 12:31:20 CUST [2017/05/04 22:31:20 ET]
Table 'Charon' 9-max Seat #9 is the button
Seat 1: boogiehoss ($2.33 in chips)=20
Seat 2: ShiQiang778 ($3.93 in chips)=20
Seat 4: EmirUSik ($5.10 in chips)=20
Seat 5: rssollero ($2 in chips)=20
Seat 6: the_wickstar ($0.80 in chips)=20
Seat 7: ClemenTMienT ($2.50 in chips)=20
Seat 8: Pull Ragatio ($2.03 in chips)=20
Seat 9: Smit0714 ($2 in chips)=20
boogiehoss: posts small blind $0.01
ShiQiang778: posts big blind $0.02
el6cs: sits out=20
*** HOLE CARDS ***
Dealt to the_wickstar [3h Qh]
EmirUSik: folds=20
EmirUSik leaves the table
rssollero: folds=20
the_wickstar: folds=20
ClemenTMienT: raises $0.04 to $0.06
Pull Ragatio: calls $0.06
Smit0714: folds=20
boogiehoss: folds=20
ShiQiang778: folds=20
*** FLOP *** [Jc 7d Ah]
ClemenTMienT: bets $0.06
Pull Ragatio: folds=20
Uncalled bet ($0.06) returned to ClemenTMienT
ClemenTMienT collected $0.14 from pot
*** SUMMARY ***
Total pot $0.15 | Rake $0.01=20
Board [Jc 7d Ah]
Seat 1: boogiehoss (small blind) folded before Flop
Seat 2: ShiQiang778 (big blind) folded before Flop
Seat 4: EmirUSik folded before Flop (didn't bet)
Seat 5: rssollero folded before Flop (didn't bet)
Seat 6: the_wickstar folded before Flop (didn't bet)
Seat 7: ClemenTMienT collected ($0.14)
Seat 8: Pull Ragatio folded on the Flop
Seat 9: Smit0714 (button) folded before Flop (didn't bet)


*********** # 38 **************
PokerStars Hand #169969669795: Tournament #1897347969, 5 SC Hold'em No =
Limit - Level I (30/60) - 2017/05/05 12:30:55 CUST [2017/05/04 22:30:55=
 ET]
Table '1897347969 3' 9-max Seat #6 is the button
Seat 1: BRUNO_POK88 (6504 in chips)=20
Seat 2: nano19072013 (2993 in chips)=20
Seat 3: Disciple -98 (2970 in chips)=20
Seat 4: scooby196504 (2993 in chips)=20
Seat 5: yjs2013 (2949 in chips)=20
Seat 6: the_wickstar (3000 in chips)=20
Seat 8: bygoddin (8554 in chips)=20
Seat 9: ManfrediFag (2979 in chips)=20
BRUNO_POK88: posts the ante 7
nano19072013: posts the ante 7
Disciple -98: posts the ante 7
scooby196504: posts the ante 7
yjs2013: posts the ante 7
the_wickstar: posts the ante 7
bygoddin: posts the ante 7
ManfrediFag: posts the ante 7
bygoddin: posts small blind 30
ManfrediFag: posts big blind 60
*** HOLE CARDS ***
Dealt to the_wickstar [2d Qs]
BRUNO_POK88: calls 60
nano19072013: folds=20
Disciple -98: folds=20
scooby196504: folds=20
yjs2013: folds=20
the_wickstar: folds=20
bygoddin: calls 30
ManfrediFag: raises 180 to 240
BRUNO_POK88: folds=20
bygoddin: calls 180
*** FLOP *** [Th 3h Js]
bygoddin: checks=20
ManfrediFag: bets 417
bygoddin: folds=20
Uncalled bet (417) returned to ManfrediFag
ManfrediFag collected 596 from pot
ManfrediFag: doesn't show hand=20
*** SUMMARY ***
Total pot 596 | Rake 0=20
Board [Th 3h Js]
Seat 1: BRUNO_POK88 folded before Flop
Seat 2: nano19072013 folded before Flop (didn't bet)
Seat 3: Disciple -98 folded before Flop (didn't bet)
Seat 4: scooby196504 folded before Flop (didn't bet)
Seat 5: yjs2013 folded before Flop (didn't bet)
Seat 6: the_wickstar (button) folded before Flop (didn't bet)
Seat 8: bygoddin (small blind) folded on the Flop
Seat 9: ManfrediFag (big blind) collected (596)


*********** # 39 **************
PokerStars Hand #169969669130:  Hold'em No Limit ($0.01/$0.02 USD) - 20=
17/05/05 12:30:53 CUST [2017/05/04 22:30:53 ET]
Table 'Charon' 9-max Seat #8 is the button
Seat 1: boogiehoss ($2.35 in chips)=20
Seat 2: ShiQiang778 ($3.93 in chips)=20
Seat 4: EmirUSik ($5.10 in chips)=20
Seat 5: rssollero ($2 in chips)=20
Seat 6: the_wickstar ($0.77 in chips)=20
Seat 7: ClemenTMienT ($2.50 in chips)=20
Seat 8: Pull Ragatio ($2.03 in chips)=20
Seat 9: Smit0714 ($2 in chips)=20
Smit0714: posts small blind $0.01
boogiehoss: posts big blind $0.02
el6cs: sits out=20
*** HOLE CARDS ***
Dealt to the_wickstar [Ts Kh]
ShiQiang778: folds=20
EmirUSik: folds=20
rssollero: folds=20
the_wickstar: raises $0.04 to $0.06
ClemenTMienT: folds=20
Pull Ragatio: folds=20
Smit0714: folds=20
boogiehoss: folds=20
Uncalled bet ($0.04) returned to the_wickstar
the_wickstar collected $0.05 from pot
*** SUMMARY ***
Total pot $0.05 | Rake $0=20
Seat 1: boogiehoss (big blind) folded before Flop
Seat 2: ShiQiang778 folded before Flop (didn't bet)
Seat 4: EmirUSik folded before Flop (didn't bet)
Seat 5: rssollero folded before Flop (didn't bet)
Seat 6: the_wickstar collected ($0.05)
Seat 7: ClemenTMienT folded before Flop (didn't bet)
Seat 8: Pull Ragatio (button) folded before Flop (didn't bet)
Seat 9: Smit0714 (small blind) folded before Flop


*********** # 40 **************
PokerStars Hand #169969648459: Tournament #1897347969, 5 SC Hold'em No =
Limit - Level I (30/60) - 2017/05/05 12:29:55 CUST [2017/05/04 22:29:55=
 ET]
Table '1897347969 3' 9-max Seat #5 is the button
Seat 1: BRUNO_POK88 (6511 in chips)=20
Seat 2: nano19072013 (3000 in chips)=20
Seat 3: Disciple -98 (5956 in chips)=20
Seat 4: scooby196504 (3000 in chips)=20
Seat 5: yjs2013 (2956 in chips)=20
Seat 6: the_wickstar (2547 in chips)=20
Seat 8: bygoddin (2986 in chips)=20
Seat 9: ManfrediFag (2986 in chips)=20
BRUNO_POK88: posts the ante 7
nano19072013: posts the ante 7
Disciple -98: posts the ante 7
scooby196504: posts the ante 7
yjs2013: posts the ante 7
the_wickstar: posts the ante 7
bygoddin: posts the ante 7
ManfrediFag: posts the ante 7
the_wickstar: posts small blind 30
bygoddin: posts big blind 60
*** HOLE CARDS ***
Dealt to the_wickstar [Qs Qc]
ManfrediFag: folds=20
BRUNO_POK88: folds=20
nano19072013: folds=20
Disciple -98: raises 300 to 360
scooby196504: folds=20
yjs2013: folds=20
the_wickstar: raises 300 to 660
bygoddin: raises 2319 to 2979 and is all-in
Disciple -98: raises 2970 to 5949 and is all-in
the_wickstar: calls 1880 and is all-in
Uncalled bet (2970) returned to Disciple -98
*** FLOP *** [Ah 6c 7c]
*** TURN *** [Ah 6c 7c] [Ks]
*** RIVER *** [Ah 6c 7c Ks] [8c]
*** SHOW DOWN ***
bygoddin: shows [9d Tc] (a straight, Six to Ten)
Disciple -98: shows [6d 6h] (three of a kind, Sixes)
bygoddin collected 878 from side pot
the_wickstar: shows [Qs Qc] (a pair of Queens)
bygoddin collected 7676 from main pot
the_wickstar re-buys and receives 3000 chips for 5 StarsCoin
*** SUMMARY ***
Total pot 8554 Main pot 7676. Side pot 878. | Rake 0=20
Board [Ah 6c 7c Ks 8c]
Seat 1: BRUNO_POK88 folded before Flop (didn't bet)
Seat 2: nano19072013 folded before Flop (didn't bet)
Seat 3: Disciple -98 showed [6d 6h] and lost with three of a kind, Sixes
Seat 4: scooby196504 folded before Flop (didn't bet)
Seat 5: yjs2013 (button) folded before Flop (didn't bet)
Seat 6: the_wickstar (small blind) showed [Qs Qc] and lost with a pair =
of Queens
Seat 8: bygoddin (big blind) showed [9d Tc] and won (8554) with a strai=
ght, Six to Ten
Seat 9: ManfrediFag folded before Flop (didn't bet)


*********** # 41 **************
PokerStars Hand #169969635051:  Hold'em No Limit ($0.01/$0.02 USD) - 20=
17/05/05 12:29:17 CUST [2017/05/04 22:29:17 ET]
Table 'Charon' 9-max Seat #7 is the button
Seat 1: boogiehoss ($2.35 in chips)=20
Seat 2: ShiQiang778 ($3.93 in chips)=20
Seat 4: EmirUSik ($5.10 in chips)=20
Seat 5: rssollero ($2 in chips)=20
Seat 6: the_wickstar ($0.77 in chips)=20
Seat 7: ClemenTMienT ($2.50 in chips)=20
Seat 8: Pull Ragatio ($1.49 in chips)=20
Seat 9: Smit0714 ($2 in chips)=20
Pull Ragatio: posts small blind $0.01
Smit0714: posts big blind $0.02
el6cs: sits out=20
*** HOLE CARDS ***
Dealt to the_wickstar [Kc 3d]
boogiehoss: folds=20
ShiQiang778: folds=20
EmirUSik: folds=20
rssollero: calls $0.02
the_wickstar: folds=20
ClemenTMienT: folds=20
Pull Ragatio: calls $0.01
Smit0714: checks=20
*** FLOP *** [7d 8s Qd]
Pull Ragatio: checks=20
Smit0714: checks=20
rssollero: bets $0.04
Pull Ragatio: calls $0.04
Smit0714: folds=20
*** TURN *** [7d 8s Qd] [Th]
Pull Ragatio: checks=20
rssollero: bets $0.07
Pull Ragatio: raises $0.07 to $0.14
rssollero: calls $0.07
*** RIVER *** [7d 8s Qd Th] [Kh]
Pull Ragatio: bets $0.36
rssollero: calls $0.36
*** SHOW DOWN ***
Pull Ragatio: shows [Qh Kd] (two pair, Kings and Queens)
rssollero: mucks hand=20
Pull Ragatio collected $1.10 from pot
*** SUMMARY ***
Total pot $1.14 | Rake $0.04=20
Board [7d 8s Qd Th Kh]
Seat 1: boogiehoss folded before Flop (didn't bet)
Seat 2: ShiQiang778 folded before Flop (didn't bet)
Seat 4: EmirUSik folded before Flop (didn't bet)
Seat 5: rssollero mucked [8c 7c]
Seat 6: the_wickstar folded before Flop (didn't bet)
Seat 7: ClemenTMienT (button) folded before Flop (didn't bet)
Seat 8: Pull Ragatio (small blind) showed [Qh Kd] and won ($1.10) with =
two pair, Kings and Queens
Seat 9: Smit0714 (big blind) folded on the Flop


*********** # 42 **************
PokerStars Hand #169969629049: Tournament #1897347969, 5 SC Hold'em No =
Limit - Level I (30/60) - 2017/05/05 12:29:00 CUST [2017/05/04 22:29:00=
 ET]
Table '1897347969 3' 9-max Seat #3 is the button
Seat 1: BRUNO_POK88 (6000 in chips)=20
Seat 3: Disciple -98 (5963 in chips)=20
Seat 4: scooby196504 (3000 in chips) out of hand (moved from another ta=
ble into small blind)
Seat 5: yjs2013 (2993 in chips)=20
Seat 6: the_wickstar (2993 in chips)=20
Seat 7: famacia1970 (9065 in chips)=20
Seat 8: bygoddin (2993 in chips)=20
Seat 9: ManfrediFag (2993 in chips)=20
BRUNO_POK88: posts the ante 7
Disciple -98: posts the ante 7
yjs2013: posts the ante 7
the_wickstar: posts the ante 7
famacia1970: posts the ante 7
bygoddin: posts the ante 7
ManfrediFag: posts the ante 7
yjs2013: posts small blind 30
the_wickstar: posts big blind 60
*** HOLE CARDS ***
Dealt to the_wickstar [Ad 7h]
famacia1970: folds=20
bygoddin: folds=20
ManfrediFag: folds=20
BRUNO_POK88: calls 60
Disciple -98: folds=20
yjs2013: folds=20
the_wickstar: checks=20
*** FLOP *** [4d 4s 5s]
the_wickstar: checks=20
BRUNO_POK88: checks=20
*** TURN *** [4d 4s 5s] [2s]
nano19072013 is disconnected=20
the_wickstar: checks=20
BRUNO_POK88: checks=20
*** RIVER *** [4d 4s 5s 2s] [Ac]
the_wickstar: bets 60
BRUNO_POK88: raises 319 to 379
the_wickstar: calls 319
*** SHOW DOWN ***
BRUNO_POK88: shows [3d 3h] (a straight, Ace to Five)
the_wickstar: mucks hand=20
BRUNO_POK88 collected 957 from pot
*** SUMMARY ***
Total pot 957 | Rake 0=20
Board [4d 4s 5s 2s Ac]
Seat 1: BRUNO_POK88 showed [3d 3h] and won (957) with a straight, Ace t=
o Five
Seat 3: Disciple -98 (button) folded before Flop (didn't bet)
Seat 5: yjs2013 (small blind) folded before Flop
Seat 6: the_wickstar (big blind) mucked [Ad 7h]
Seat 7: famacia1970 folded before Flop (didn't bet)
Seat 8: bygoddin folded before Flop (didn't bet)
Seat 9: ManfrediFag folded before Flop (didn't bet)


*********** # 43 **************
PokerStars Hand #169969608715: Tournament #1897347969, 5 SC Hold'em No =
Limit - Level I (30/60) - 2017/05/05 12:28:02 CUST [2017/05/04 22:28:02=
 ET]
Table '1897347969 3' 9-max Seat #2 is the button
Disciple -98 re-buys and receives 3000 chips for 5 StarsCoin
Seat 2: rastablant (3000 in chips)=20
Seat 3: Disciple -98 (6000 in chips)=20
Seat 4: M_M@TRIX23 (3000 in chips)=20
Seat 5: yjs2013 (3000 in chips)=20
Seat 6: the_wickstar (3000 in chips)=20
Seat 7: famacia1970 (3000 in chips)=20
Seat 8: bygoddin (3000 in chips)=20
Seat 9: ManfrediFag (3000 in chips)=20
rastablant: posts the ante 7
Disciple -98: posts the ante 7
M_M@TRIX23: posts the ante 7
yjs2013: posts the ante 7
the_wickstar: posts the ante 7
famacia1970: posts the ante 7
bygoddin: posts the ante 7
ManfrediFag: posts the ante 7
Disciple -98: posts small blind 30
M_M@TRIX23: posts big blind 60
*** HOLE CARDS ***
Dealt to the_wickstar [3c 8h]
yjs2013: folds=20
the_wickstar: folds=20
famacia1970: raises 240 to 300
bygoddin: folds=20
ManfrediFag: folds=20
rastablant: calls 300
Disciple -98: folds=20
M_M@TRIX23: raises 2693 to 2993 and is all-in
BRUNO_POK88 re-buys and receives 3000 chips for 5 StarsCoin
famacia1970: calls 2693 and is all-in
rastablant: calls 2693 and is all-in
*** FLOP *** [Ts 5c 8d]
*** TURN *** [Ts 5c 8d] [Ad]
*** RIVER *** [Ts 5c 8d Ad] [Qh]
*** SHOW DOWN ***
M_M@TRIX23: shows [Kc Kh] (a pair of Kings)
famacia1970: shows [Ac Td] (two pair, Aces and Tens)
rastablant: shows [Jd Qd] (a pair of Queens)
famacia1970 collected 9065 from pot
rastablant finished the tournament in 142nd place
M_M@TRIX23 finished the tournament in 142nd place
*** SUMMARY ***
Total pot 9065 | Rake 0=20
Board [Ts 5c 8d Ad Qh]
Seat 2: rastablant (button) showed [Jd Qd] and lost with a pair of Quee=
ns
Seat 3: Disciple -98 (small blind) folded before Flop
Seat 4: M_M@TRIX23 (big blind) showed [Kc Kh] and lost with a pair of K=
ings
Seat 5: yjs2013 folded before Flop (didn't bet)
Seat 6: the_wickstar folded before Flop (didn't bet)
Seat 7: famacia1970 showed [Ac Td] and won (9065) with two pair, Aces a=
nd Tens
Seat 8: bygoddin folded before Flop (didn't bet)
Seat 9: ManfrediFag folded before Flop (didn't bet)


*********** # 44 **************
PokerStars Hand #169969591241:  Hold'em No Limit ($0.01/$0.02 USD) - 20=
17/05/05 12:27:09 CUST [2017/05/04 22:27:09 ET]
Table 'Charon' 9-max Seat #6 is the button
Seat 1: boogiehoss ($2.35 in chips)=20
Seat 2: ShiQiang778 ($3.93 in chips)=20
Seat 4: EmirUSik ($5.10 in chips)=20
Seat 5: rssollero ($2 in chips)=20
Seat 6: the_wickstar ($1.11 in chips)=20
Seat 7: ClemenTMienT ($2.01 in chips)=20
Seat 8: Pull Ragatio ($1.65 in chips)=20
ClemenTMienT: posts small blind $0.01
Pull Ragatio: posts big blind $0.02
JulianSaubid leaves the table
el6cs: sits out=20
*** HOLE CARDS ***
Dealt to the_wickstar [9s 9h]
Smit0714 joins the table at seat #9=20
boogiehoss: folds=20
ShiQiang778: folds=20
EmirUSik: folds=20
rssollero: calls $0.02
the_wickstar: calls $0.02
ClemenTMienT: calls $0.01
Pull Ragatio: checks=20
*** FLOP *** [8h Ac Jd]
ClemenTMienT: checks=20
Pull Ragatio: checks=20
rssollero: checks=20
the_wickstar: bets $0.04
ClemenTMienT: calls $0.04
Pull Ragatio: calls $0.04
el6cs is disconnected=20
rssollero: folds=20
*** TURN *** [8h Ac Jd] [9d]
ClemenTMienT: checks=20
Pull Ragatio: checks=20
the_wickstar: bets $0.10
ClemenTMienT: calls $0.10
Pull Ragatio: calls $0.10
*** RIVER *** [8h Ac Jd 9d] [Qh]
ClemenTMienT: bets $0.18
Pull Ragatio: folds=20
the_wickstar: calls $0.18
*** SHOW DOWN ***
ClemenTMienT: shows [Td Kd] (a straight, Ten to Ace)
the_wickstar: mucks hand=20
ClemenTMienT collected $0.83 from pot
*** SUMMARY ***
Total pot $0.86 | Rake $0.03=20
Board [8h Ac Jd 9d Qh]
Seat 1: boogiehoss folded before Flop (didn't bet)
Seat 2: ShiQiang778 folded before Flop (didn't bet)
Seat 4: EmirUSik folded before Flop (didn't bet)
Seat 5: rssollero folded on the Flop
Seat 6: the_wickstar (button) mucked [9s 9h]
Seat 7: ClemenTMienT (small blind) showed [Td Kd] and won ($0.83) with =
a straight, Ten to Ace
Seat 8: Pull Ragatio (big blind) folded on the River


*********** # 45 **************
PokerStars Hand #169969554081:  Hold'em No Limit ($0.01/$0.02 USD) - 20=
17/05/05 12:25:23 CUST [2017/05/04 22:25:23 ET]
Table 'Charon' 9-max Seat #5 is the button
Seat 1: boogiehoss ($2.35 in chips)=20
Seat 2: ShiQiang778 ($3.93 in chips)=20
Seat 4: EmirUSik ($3.51 in chips)=20
Seat 5: rssollero ($2 in chips)=20
Seat 6: the_wickstar ($1.12 in chips)=20
Seat 7: ClemenTMienT ($2.03 in chips)=20
Seat 8: Pull Ragatio ($1.65 in chips)=20
Seat 9: JulianSaubid ($1.62 in chips)=20
the_wickstar: posts small blind $0.01
ClemenTMienT: posts big blind $0.02
el6cs: sits out=20
*** HOLE CARDS ***
Dealt to the_wickstar [2d 8c]
Pull Ragatio: folds=20
JulianSaubid: raises $0.04 to $0.06
boogiehoss: folds=20
ShiQiang778: folds=20
EmirUSik: calls $0.06
rssollero: calls $0.06
the_wickstar: folds=20
ClemenTMienT: folds=20
*** FLOP *** [Qh Ac Td]
JulianSaubid: checks=20
EmirUSik: bets $0.15
rssollero: folds=20
JulianSaubid: raises $0.25 to $0.40
EmirUSik: raises $0.50 to $0.90
JulianSaubid: calls $0.50
*** TURN *** [Qh Ac Td] [Js]
JulianSaubid: bets $0.66 and is all-in
EmirUSik: calls $0.66
*** RIVER *** [Qh Ac Td Js] [9s]
*** SHOW DOWN ***
JulianSaubid: shows [9d Jh] (two pair, Jacks and Nines)
EmirUSik: shows [Ts Ah] (two pair, Aces and Tens)
EmirUSik collected $3.21 from pot
*** SUMMARY ***
Total pot $3.33 | Rake $0.12=20
Board [Qh Ac Td Js 9s]
Seat 1: boogiehoss folded before Flop (didn't bet)
Seat 2: ShiQiang778 folded before Flop (didn't bet)
Seat 4: EmirUSik showed [Ts Ah] and won ($3.21) with two pair, Aces and=
 Tens
Seat 5: rssollero (button) folded on the Flop
Seat 6: the_wickstar (small blind) folded before Flop
Seat 7: ClemenTMienT (big blind) folded before Flop
Seat 8: Pull Ragatio folded before Flop (didn't bet)
Seat 9: JulianSaubid showed [9d Jh] and lost with two pair, Jacks and N=
ines


*********** # 46 **************
PokerStars Hand #169969523617:  Hold'em No Limit ($0.01/$0.02 USD) - 20=
17/05/05 12:23:58 CUST [2017/05/04 22:23:58 ET]
Table 'Charon' 9-max Seat #4 is the button
Seat 1: boogiehoss ($2.35 in chips)=20
Seat 2: ShiQiang778 ($3.93 in chips)=20
Seat 4: EmirUSik ($3.51 in chips)=20
Seat 5: rssollero ($2 in chips)=20
Seat 6: the_wickstar ($1.10 in chips)=20
Seat 7: ClemenTMienT ($2.03 in chips)=20
Seat 8: Pull Ragatio ($1.65 in chips)=20
Seat 9: JulianSaubid ($1.62 in chips)=20
rssollero: posts small blind $0.01
the_wickstar: posts big blind $0.02
el6cs: sits out=20
*** HOLE CARDS ***
Dealt to the_wickstar [Qd 6d]
ClemenTMienT: folds=20
Pull Ragatio: folds=20
JulianSaubid: folds=20
boogiehoss: folds=20
ShiQiang778: folds=20
EmirUSik: folds=20
rssollero: calls $0.01
the_wickstar: checks=20
*** FLOP *** [9c 8d Qc]
rssollero: checks=20
the_wickstar: checks=20
*** TURN *** [9c 8d Qc] [6h]
rssollero: checks=20
the_wickstar: bets $0.02
rssollero: folds=20
Uncalled bet ($0.02) returned to the_wickstar
the_wickstar collected $0.04 from pot
*** SUMMARY ***
Total pot $0.04 | Rake $0=20
Board [9c 8d Qc 6h]
Seat 1: boogiehoss folded before Flop (didn't bet)
Seat 2: ShiQiang778 folded before Flop (didn't bet)
Seat 4: EmirUSik (button) folded before Flop (didn't bet)
Seat 5: rssollero (small blind) folded on the Turn
Seat 6: the_wickstar (big blind) collected ($0.04)
Seat 7: ClemenTMienT folded before Flop (didn't bet)
Seat 8: Pull Ragatio folded before Flop (didn't bet)
Seat 9: JulianSaubid folded before Flop (didn't bet)


*********** # 47 **************
PokerStars Hand #169941535393:  Hold'em No Limit ($0.01/$0.02 USD) - 20=
17/05/05 1:11:33 CUST [2017/05/04 11:11:33 ET]
Table 'Benetnash' 9-max Seat #3 is the button
Seat 1: KoXa8319 ($2.14 in chips)=20
Seat 2: Tadeusz 1947 ($0.65 in chips)=20
Seat 3: wolf.ukr ($2.85 in chips)=20
Seat 4: sem do it ($1.28 in chips)=20
Seat 5: sunnyray25 ($2.14 in chips)=20
Seat 6: the_wickstar ($3.71 in chips)=20
Seat 7: dymarko ($2 in chips)=20
Seat 8: gastelo43 ($0.88 in chips)=20
Seat 9: gizmondouk ($2.50 in chips)=20
sem do it: posts small blind $0.01
sunnyray25: posts big blind $0.02
*** HOLE CARDS ***
Dealt to the_wickstar [Qs 4h]
the_wickstar: folds=20
dymarko: folds=20
gastelo43: folds=20
gizmondouk: folds=20
KoXa8319: folds=20
Tadeusz 1947: folds=20
wolf.ukr: raises $0.04 to $0.06
sem do it: folds=20
sunnyray25: calls $0.04
*** FLOP *** [9s Js 8h]
the_wickstar leaves the table
nikolai218 joins the table at seat #6=20
sunnyray25: bets $0.10
wolf.ukr: calls $0.10
*** TURN *** [9s Js 8h] [2c]
sunnyray25: bets $0.24
wolf.ukr: calls $0.24
*** RIVER *** [9s Js 8h 2c] [6c]
sunnyray25: bets $0.43
wolf.ukr: calls $0.43
*** SHOW DOWN ***
sunnyray25: shows [Ac Th] (high card Ace)
wolf.ukr: shows [Jh 8s] (two pair, Jacks and Eights)
wolf.ukr collected $1.61 from pot
*** SUMMARY ***
Total pot $1.67 | Rake $0.06=20
Board [9s Js 8h 2c 6c]
Seat 1: KoXa8319 folded before Flop (didn't bet)
Seat 2: Tadeusz 1947 folded before Flop (didn't bet)
Seat 3: wolf.ukr (button) showed [Jh 8s] and won ($1.61) with two pair,=
 Jacks and Eights
Seat 4: sem do it (small blind) folded before Flop
Seat 5: sunnyray25 (big blind) showed [Ac Th] and lost with high card A=
ce
Seat 6: the_wickstar folded before Flop (didn't bet)
Seat 7: dymarko folded before Flop (didn't bet)
Seat 8: gastelo43 folded before Flop (didn't bet)
Seat 9: gizmondouk folded before Flop (didn't bet)


*********** # 48 **************
PokerStars Hand #169941504155:  Hold'em No Limit ($0.01/$0.02 USD) - 20=
17/05/05 1:10:45 CUST [2017/05/04 11:10:45 ET]
Table 'Benetnash' 9-max Seat #2 is the button
Seat 1: KoXa8319 ($2.06 in chips)=20
Seat 2: Tadeusz 1947 ($0.65 in chips)=20
Seat 3: wolf.ukr ($2.91 in chips)=20
Seat 4: sem do it ($1.30 in chips)=20
Seat 5: sunnyray25 ($2.14 in chips)=20
Seat 6: the_wickstar ($3.71 in chips)=20
Seat 7: dymarko ($2 in chips)=20
Seat 8: gastelo43 ($0.88 in chips)=20
Seat 9: gizmondouk ($2.50 in chips)=20
wolf.ukr: posts small blind $0.01
sem do it: posts big blind $0.02
*** HOLE CARDS ***
Dealt to the_wickstar [3d Qs]
sunnyray25: folds=20
the_wickstar: folds=20
dymarko: folds=20
gastelo43: folds=20
gizmondouk: folds=20
KoXa8319: raises $0.04 to $0.06
Tadeusz 1947: folds=20
wolf.ukr: calls $0.05
sem do it: folds=20
*** FLOP *** [9c 8s Ah]
wolf.ukr: checks=20
KoXa8319: checks=20
*** TURN *** [9c 8s Ah] [Kc]
wolf.ukr: checks=20
KoXa8319: checks=20
*** RIVER *** [9c 8s Ah Kc] [8c]
wolf.ukr: checks=20
KoXa8319: checks=20
*** SHOW DOWN ***
wolf.ukr: shows [Tc Jd] (a pair of Eights)
KoXa8319: shows [6d 6c] (two pair, Eights and Sixes)
KoXa8319 collected $0.14 from pot
*** SUMMARY ***
Total pot $0.14 | Rake $0=20
Board [9c 8s Ah Kc 8c]
Seat 1: KoXa8319 showed [6d 6c] and won ($0.14) with two pair, Eights a=
nd Sixes
Seat 2: Tadeusz 1947 (button) folded before Flop (didn't bet)
Seat 3: wolf.ukr (small blind) showed [Tc Jd] and lost with a pair of E=
ights
Seat 4: sem do it (big blind) folded before Flop
Seat 5: sunnyray25 folded before Flop (didn't bet)
Seat 6: the_wickstar folded before Flop (didn't bet)
Seat 7: dymarko folded before Flop (didn't bet)
Seat 8: gastelo43 folded before Flop (didn't bet)
Seat 9: gizmondouk folded before Flop (didn't bet)


*********** # 49 **************
PokerStars Hand #169941489397:  Hold'em No Limit ($0.01/$0.02 USD) - 20=
17/05/05 1:10:22 CUST [2017/05/04 11:10:22 ET]
Table 'Benetnash' 9-max Seat #1 is the button
Seat 1: KoXa8319 ($2.06 in chips)=20
Seat 2: Tadeusz 1947 ($0.66 in chips)=20
Seat 3: wolf.ukr ($2.90 in chips)=20
Seat 4: sem do it ($1.30 in chips)=20
Seat 5: sunnyray25 ($2.14 in chips)=20
Seat 6: the_wickstar ($3.71 in chips)=20
Seat 7: dymarko ($2 in chips)=20
Seat 8: gastelo43 ($0.88 in chips)=20
Seat 9: gizmondouk ($2.50 in chips)=20
Tadeusz 1947: posts small blind $0.01
wolf.ukr: posts big blind $0.02
*** HOLE CARDS ***
Dealt to the_wickstar [2h 5c]
sem do it: folds=20
sunnyray25: folds=20
the_wickstar: folds=20
dymarko: folds=20
gastelo43: folds=20
gizmondouk: folds=20
KoXa8319: folds=20
Tadeusz 1947: folds=20
Uncalled bet ($0.01) returned to wolf.ukr
wolf.ukr collected $0.02 from pot
*** SUMMARY ***
Total pot $0.02 | Rake $0=20
Seat 1: KoXa8319 (button) folded before Flop (didn't bet)
Seat 2: Tadeusz 1947 (small blind) folded before Flop
Seat 3: wolf.ukr (big blind) collected ($0.02)
Seat 4: sem do it folded before Flop (didn't bet)
Seat 5: sunnyray25 folded before Flop (didn't bet)
Seat 6: the_wickstar folded before Flop (didn't bet)
Seat 7: dymarko folded before Flop (didn't bet)
Seat 8: gastelo43 folded before Flop (didn't bet)
Seat 9: gizmondouk folded before Flop (didn't bet)


*********** # 50 **************
PokerStars Hand #169941460351:  Hold'em No Limit ($0.01/$0.02 USD) - 20=
17/05/05 1:09:36 CUST [2017/05/04 11:09:36 ET]
Table 'Benetnash' 9-max Seat #9 is the button
Seat 1: KoXa8319 ($2.12 in chips)=20
Seat 2: Tadeusz 1947 ($0.68 in chips)=20
Seat 3: wolf.ukr ($2.90 in chips)=20
Seat 4: sem do it ($1.30 in chips)=20
Seat 5: sunnyray25 ($2.06 in chips)=20
Seat 6: the_wickstar ($3.71 in chips)=20
Seat 7: dymarko ($2 in chips)=20
Seat 8: gastelo43 ($0.88 in chips)=20
Seat 9: gizmondouk ($2.50 in chips)=20
KoXa8319: posts small blind $0.01
Tadeusz 1947: posts big blind $0.02
*** HOLE CARDS ***
Dealt to the_wickstar [6s 6d]
wolf.ukr: folds=20
sem do it: folds=20
sunnyray25: raises $0.04 to $0.06
the_wickstar: folds=20
dymarko: folds=20
gastelo43: folds=20
gizmondouk: folds=20
KoXa8319: calls $0.05
Tadeusz 1947: folds=20
*** FLOP *** [8c 9c 2h]
KoXa8319: checks=20
sunnyray25: bets $0.08
KoXa8319: folds=20
Uncalled bet ($0.08) returned to sunnyray25
sunnyray25 collected $0.14 from pot
sunnyray25: doesn't show hand=20
*** SUMMARY ***
Total pot $0.14 | Rake $0=20
Board [8c 9c 2h]
Seat 1: KoXa8319 (small blind) folded on the Flop
Seat 2: Tadeusz 1947 (big blind) folded before Flop
Seat 3: wolf.ukr folded before Flop (didn't bet)
Seat 4: sem do it folded before Flop (didn't bet)
Seat 5: sunnyray25 collected ($0.14)
Seat 6: the_wickstar folded before Flop (didn't bet)
Seat 7: dymarko folded before Flop (didn't bet)
Seat 8: gastelo43 folded before Flop (didn't bet)
Seat 9: gizmondouk (button) folded before Flop (didn't bet)


*********** # 51 **************
PokerStars Hand #169941434594:  Hold'em No Limit ($0.01/$0.02 USD) - 20=
17/05/05 1:08:56 CUST [2017/05/04 11:08:56 ET]
Table 'Benetnash' 9-max Seat #8 is the button
Seat 1: KoXa8319 ($2.04 in chips)=20
Seat 2: Tadeusz 1947 ($0.76 in chips)=20
Seat 3: wolf.ukr ($2.90 in chips)=20
Seat 4: sem do it ($1.30 in chips)=20
Seat 5: sunnyray25 ($2.06 in chips)=20
Seat 6: the_wickstar ($3.71 in chips)=20
Seat 7: dymarko ($2 in chips)=20
Seat 8: gastelo43 ($0.88 in chips)=20
Seat 9: gizmondouk ($2.51 in chips)=20
gizmondouk: posts small blind $0.01
KoXa8319: posts big blind $0.02
*** HOLE CARDS ***
Dealt to the_wickstar [7s Qh]
Tadeusz 1947: calls $0.02
wolf.ukr: folds=20
sem do it: folds=20
sunnyray25: folds=20
the_wickstar: folds=20
dymarko: folds=20
gastelo43: folds=20
gizmondouk: folds=20
KoXa8319: raises $0.06 to $0.08
Tadeusz 1947: calls $0.06
*** FLOP *** [Kd 7d 9c]
KoXa8319: bets $0.12
Tadeusz 1947: folds=20
Uncalled bet ($0.12) returned to KoXa8319
KoXa8319 collected $0.16 from pot
KoXa8319: doesn't show hand=20
*** SUMMARY ***
Total pot $0.17 | Rake $0.01=20
Board [Kd 7d 9c]
Seat 1: KoXa8319 (big blind) collected ($0.16)
Seat 2: Tadeusz 1947 folded on the Flop
Seat 3: wolf.ukr folded before Flop (didn't bet)
Seat 4: sem do it folded before Flop (didn't bet)
Seat 5: sunnyray25 folded before Flop (didn't bet)
Seat 6: the_wickstar folded before Flop (didn't bet)
Seat 7: dymarko folded before Flop (didn't bet)
Seat 8: gastelo43 (button) folded before Flop (didn't bet)
Seat 9: gizmondouk (small blind) folded before Flop


*********** # 52 **************
PokerStars Hand #169941384986:  Hold'em No Limit ($0.01/$0.02 USD) - 20=
17/05/05 1:07:39 CUST [2017/05/04 11:07:39 ET]
Table 'Benetnash' 9-max Seat #7 is the button
Seat 1: KoXa8319 ($2.04 in chips)=20
Seat 2: Tadeusz 1947 ($0.76 in chips)=20
Seat 3: wolf.ukr ($2.90 in chips)=20
Seat 4: sem do it ($1.30 in chips)=20
Seat 5: sunnyray25 ($2.06 in chips)=20
Seat 6: the_wickstar ($3.71 in chips)=20
Seat 7: dymarko ($2 in chips)=20
Seat 8: gastelo43 ($0.78 in chips)=20
Seat 9: gizmondouk ($2.53 in chips)=20
gastelo43: posts small blind $0.01
gizmondouk: posts big blind $0.02
*** HOLE CARDS ***
Dealt to the_wickstar [6d 3s]
KoXa8319: folds=20
Tadeusz 1947: folds=20
wolf.ukr: folds=20
sem do it: folds=20
sunnyray25: folds=20
the_wickstar: folds=20
dymarko: raises $0.02 to $0.04
gastelo43: calls $0.03
gizmondouk: folds=20
*** FLOP *** [Qd 2h 4c]
gastelo43: checks=20
dymarko: bets $0.05
gastelo43: calls $0.05
*** TURN *** [Qd 2h 4c] [Qc]
gastelo43: checks=20
dymarko: checks=20
*** RIVER *** [Qd 2h 4c Qc] [9d]
gastelo43: bets $0.19
dymarko: folds=20
Uncalled bet ($0.19) returned to gastelo43
gastelo43 collected $0.19 from pot
gastelo43: doesn't show hand=20
*** SUMMARY ***
Total pot $0.20 | Rake $0.01=20
Board [Qd 2h 4c Qc 9d]
Seat 1: KoXa8319 folded before Flop (didn't bet)
Seat 2: Tadeusz 1947 folded before Flop (didn't bet)
Seat 3: wolf.ukr folded before Flop (didn't bet)
Seat 4: sem do it folded before Flop (didn't bet)
Seat 5: sunnyray25 folded before Flop (didn't bet)
Seat 6: the_wickstar folded before Flop (didn't bet)
Seat 7: dymarko (button) folded on the River
Seat 8: gastelo43 (small blind) collected ($0.19)
Seat 9: gizmondouk (big blind) folded before Flop


*********** # 53 **************
PokerStars Hand #169941354138:  Hold'em No Limit ($0.01/$0.02 USD) - 20=
17/05/05 1:06:51 CUST [2017/05/04 11:06:51 ET]
Table 'Benetnash' 9-max Seat #6 is the button
Seat 1: KoXa8319 ($2.12 in chips)=20
Seat 2: Tadeusz 1947 ($0.76 in chips)=20
Seat 3: wolf.ukr ($2.90 in chips)=20
Seat 4: sem do it ($1.20 in chips)=20
Seat 5: sunnyray25 ($2.06 in chips)=20
Seat 6: the_wickstar ($3.71 in chips)=20
Seat 7: dymarko ($2 in chips)=20
Seat 8: gastelo43 ($0.80 in chips)=20
Seat 9: gizmondouk ($2.53 in chips)=20
dymarko: posts small blind $0.01
gastelo43: posts big blind $0.02
*** HOLE CARDS ***
Dealt to the_wickstar [3h 4s]
gizmondouk: folds=20
KoXa8319: raises $0.06 to $0.08
Tadeusz 1947: folds=20
wolf.ukr: folds=20
sem do it: calls $0.08
sunnyray25: folds=20
the_wickstar: folds=20
dymarko: folds=20
gastelo43: folds=20
*** FLOP *** [2h Qc 2c]
KoXa8319: checks=20
sem do it: bets $0.18
KoXa8319: folds=20
Uncalled bet ($0.18) returned to sem do it
sem do it collected $0.18 from pot
*** SUMMARY ***
Total pot $0.19 | Rake $0.01=20
Board [2h Qc 2c]
Seat 1: KoXa8319 folded on the Flop
Seat 2: Tadeusz 1947 folded before Flop (didn't bet)
Seat 3: wolf.ukr folded before Flop (didn't bet)
Seat 4: sem do it collected ($0.18)
Seat 5: sunnyray25 folded before Flop (didn't bet)
Seat 6: the_wickstar (button) folded before Flop (didn't bet)
Seat 7: dymarko (small blind) folded before Flop
Seat 8: gastelo43 (big blind) folded before Flop
Seat 9: gizmondouk folded before Flop (didn't bet)


*********** # 54 **************
PokerStars Hand #169941308638:  Hold'em No Limit ($0.01/$0.02 USD) - 20=
17/05/05 1:05:39 CUST [2017/05/04 11:05:39 ET]
Table 'Benetnash' 9-max Seat #5 is the button
Seat 1: KoXa8319 ($2.12 in chips)=20
Seat 2: Tadeusz 1947 ($0.70 in chips)=20
Seat 3: wolf.ukr ($2.90 in chips)=20
Seat 4: sem do it ($1.20 in chips)=20
Seat 5: sunnyray25 ($2.06 in chips)=20
Seat 6: the_wickstar ($3.75 in chips)=20
Seat 7: dymarko ($2 in chips)=20
Seat 9: gizmondouk ($2.53 in chips)=20
the_wickstar: posts small blind $0.01
dymarko: posts big blind $0.02
gastelo43: sits out=20
*** HOLE CARDS ***
Dealt to the_wickstar [Ad Ts]
gizmondouk: folds=20
KoXa8319: folds=20
Tadeusz 1947: calls $0.02
wolf.ukr: folds=20
sem do it: folds=20
sunnyray25: folds=20
the_wickstar: calls $0.01
dymarko: checks=20
*** FLOP *** [4h 8h Qc]
the_wickstar: checks=20
dymarko: checks=20
Tadeusz 1947: checks=20
*** TURN *** [4h 8h Qc] [3h]
the_wickstar: checks=20
dymarko: checks=20
Tadeusz 1947: bets $0.02
the_wickstar: calls $0.02
dymarko: folds=20
*** RIVER *** [4h 8h Qc 3h] [7c]
the_wickstar: checks=20
Tadeusz 1947: bets $0.02
the_wickstar: folds=20
Uncalled bet ($0.02) returned to Tadeusz 1947
Tadeusz 1947 collected $0.10 from pot
*** SUMMARY ***
Total pot $0.10 | Rake $0=20
Board [4h 8h Qc 3h 7c]
Seat 1: KoXa8319 folded before Flop (didn't bet)
Seat 2: Tadeusz 1947 collected ($0.10)
Seat 3: wolf.ukr folded before Flop (didn't bet)
Seat 4: sem do it folded before Flop (didn't bet)
Seat 5: sunnyray25 (button) folded before Flop (didn't bet)
Seat 6: the_wickstar (small blind) folded on the River
Seat 7: dymarko (big blind) folded on the Turn
Seat 9: gizmondouk folded before Flop (didn't bet)


*********** # 55 **************
PokerStars Hand #169941260856:  Hold'em No Limit ($0.01/$0.02 USD) - 20=
17/05/05 1:04:25 CUST [2017/05/04 11:04:25 ET]
Table 'Benetnash' 9-max Seat #4 is the button
Seat 1: KoXa8319 ($2.12 in chips)=20
Seat 2: Tadeusz 1947 ($0.70 in chips)=20
Seat 3: wolf.ukr ($2.90 in chips)=20
Seat 4: sem do it ($1.03 in chips)=20
Seat 5: sunnyray25 ($2.22 in chips)=20
Seat 6: the_wickstar ($3.77 in chips)=20
Seat 7: dymarko ($2 in chips)=20
Seat 8: HokageVIP ($2 in chips)=20
Seat 9: gizmondouk ($2.53 in chips)=20
sunnyray25: posts small blind $0.01
the_wickstar: posts big blind $0.02
*** HOLE CARDS ***
Dealt to the_wickstar [7c 5s]
dymarko: folds=20
HokageVIP: folds=20
gizmondouk: folds=20
KoXa8319: folds=20
Tadeusz 1947: folds=20
wolf.ukr: folds=20
HokageVIP leaves the table
gastelo43 joins the table at seat #8=20
sem do it: raises $0.04 to $0.06
sunnyray25: raises $0.10 to $0.16
the_wickstar: folds=20
sem do it: calls $0.10
*** FLOP *** [Ac Kc 8c]
sunnyray25: checks=20
sem do it: bets $0.87 and is all-in
sunnyray25: folds=20
Uncalled bet ($0.87) returned to sem do it
sem do it collected $0.33 from pot
*** SUMMARY ***
Total pot $0.34 | Rake $0.01=20
Board [Ac Kc 8c]
Seat 1: KoXa8319 folded before Flop (didn't bet)
Seat 2: Tadeusz 1947 folded before Flop (didn't bet)
Seat 3: wolf.ukr folded before Flop (didn't bet)
Seat 4: sem do it (button) collected ($0.33)
Seat 5: sunnyray25 (small blind) folded on the Flop
Seat 6: the_wickstar (big blind) folded before Flop
Seat 7: dymarko folded before Flop (didn't bet)
Seat 8: HokageVIP folded before Flop (didn't bet)
Seat 9: gizmondouk folded before Flop (didn't bet)


*********** # 56 **************
PokerStars Hand #169941220262:  Hold'em No Limit ($0.01/$0.02 USD) - 20=
17/05/05 1:03:22 CUST [2017/05/04 11:03:22 ET]
Table 'Benetnash' 9-max Seat #3 is the button
Seat 1: KoXa8319 ($2.12 in chips)=20
Seat 2: Tadeusz 1947 ($0.70 in chips)=20
Seat 3: wolf.ukr ($2.90 in chips)=20
Seat 4: sem do it ($1.04 in chips)=20
Seat 5: sunnyray25 ($2.14 in chips)=20
Seat 6: the_wickstar ($3.77 in chips)=20
Seat 7: dymarko ($2 in chips)=20
Seat 8: HokageVIP ($2 in chips)=20
Seat 9: gizmondouk ($2.53 in chips)=20
sem do it: posts small blind $0.01
sunnyray25: posts big blind $0.02
*** HOLE CARDS ***
Dealt to the_wickstar [6s Qd]
the_wickstar: folds=20
dymarko: raises $0.02 to $0.04
HokageVIP: folds=20
gizmondouk: folds=20
KoXa8319: folds=20
Tadeusz 1947: folds=20
wolf.ukr: folds=20
sem do it: folds=20
sunnyray25: calls $0.02
*** FLOP *** [9s 2s 8s]
sunnyray25: checks=20
dymarko: bets $0.04
sunnyray25: calls $0.04
*** TURN *** [9s 2s 8s] [2h]
sunnyray25: checks=20
dymarko: checks=20
*** RIVER *** [9s 2s 8s 2h] [Ts]
sunnyray25: checks=20
dymarko: checks=20
*** SHOW DOWN ***
sunnyray25: shows [7h 6c] (a straight, Six to Ten)
dymarko: mucks hand=20
sunnyray25 collected $0.16 from pot
*** SUMMARY ***
Total pot $0.17 | Rake $0.01=20
Board [9s 2s 8s 2h Ts]
Seat 1: KoXa8319 folded before Flop (didn't bet)
Seat 2: Tadeusz 1947 folded before Flop (didn't bet)
Seat 3: wolf.ukr (button) folded before Flop (didn't bet)
Seat 4: sem do it (small blind) folded before Flop
Seat 5: sunnyray25 (big blind) showed [7h 6c] and won ($0.16) with a st=
raight, Six to Ten
Seat 6: the_wickstar folded before Flop (didn't bet)
Seat 7: dymarko mucked [Jh 9h]
Seat 8: HokageVIP folded before Flop (didn't bet)
Seat 9: gizmondouk folded before Flop (didn't bet)


*********** # 57 **************
PokerStars Hand #169941193785:  Hold'em No Limit ($0.01/$0.02 USD) - 20=
17/05/05 1:02:41 CUST [2017/05/04 11:02:41 ET]
Table 'Idomeneus' 9-max Seat #1 is the button
Seat 1: sunnyray25 ($2.05 in chips)=20
Seat 3: greezex ($4.10 in chips)=20
Seat 4: fomik33 ($2.04 in chips)=20
Seat 5: the_wickstar ($1.47 in chips)=20
greezex: posts small blind $0.01
fomik33: posts big blind $0.02
*** HOLE CARDS ***
Dealt to the_wickstar [3d 6d]
the_wickstar: folds=20
sunnyray25: folds=20
the_wickstar leaves the table
greezex: folds=20
Uncalled bet ($0.01) returned to fomik33
fomik33 collected $0.02 from pot
fomik33: doesn't show hand=20
*** SUMMARY ***
Total pot $0.02 | Rake $0=20
Seat 1: sunnyray25 (button) folded before Flop (didn't bet)
Seat 3: greezex (small blind) folded before Flop
Seat 4: fomik33 (big blind) collected ($0.02)
Seat 5: the_wickstar folded before Flop (didn't bet)


*********** # 58 **************
PokerStars Hand #169941179615:  Hold'em No Limit ($0.01/$0.02 USD) - 20=
17/05/05 1:02:19 CUST [2017/05/04 11:02:19 ET]
Table 'Idomeneus' 9-max Seat #5 is the button
Seat 1: sunnyray25 ($2.06 in chips)=20
Seat 3: greezex ($4.12 in chips)=20
Seat 4: fomik33 ($2.04 in chips)=20
Seat 5: the_wickstar ($1.44 in chips)=20
sunnyray25: posts small blind $0.01
greezex: posts big blind $0.02
*** HOLE CARDS ***
Dealt to the_wickstar [8h 3h]
fomik33: folds=20
the_wickstar: calls $0.02
sunnyray25: folds=20
greezex: checks=20
*** FLOP *** [2c Th 3d]
greezex: checks=20
the_wickstar: bets $0.02
greezex: folds=20
Uncalled bet ($0.02) returned to the_wickstar
the_wickstar collected $0.05 from pot
*** SUMMARY ***
Total pot $0.05 | Rake $0=20
Board [2c Th 3d]
Seat 1: sunnyray25 (small blind) folded before Flop
Seat 3: greezex (big blind) folded on the Flop
Seat 4: fomik33 folded before Flop (didn't bet)
Seat 5: the_wickstar (button) collected ($0.05)


*********** # 59 **************
PokerStars Hand #169941176983:  Hold'em No Limit ($0.01/$0.02 USD) - 20=
17/05/05 1:02:15 CUST [2017/05/04 11:02:15 ET]
Table 'Benetnash' 9-max Seat #2 is the button
Seat 1: KoXa8319 ($2.12 in chips)=20
Seat 2: Tadeusz 1947 ($0.70 in chips)=20
Seat 3: wolf.ukr ($2.92 in chips)=20
Seat 4: sem do it ($1 in chips)=20
Seat 5: sunnyray25 ($2.14 in chips)=20
Seat 6: the_wickstar ($3.77 in chips)=20
Seat 7: dymarko ($2 in chips)=20
Seat 8: HokageVIP ($2 in chips)=20
Seat 9: gizmondouk ($2.53 in chips)=20
wolf.ukr: posts small blind $0.01
sem do it: posts big blind $0.02
*** HOLE CARDS ***
Dealt to the_wickstar [9h 2s]
sunnyray25: folds=20
the_wickstar: folds=20
dymarko: folds=20
HokageVIP: calls $0.02
gizmondouk: folds=20
KoXa8319: folds=20
Tadeusz 1947: folds=20
wolf.ukr: calls $0.01
sem do it: checks=20
*** FLOP *** [Jh 6s 5c]
wolf.ukr: checks=20
sem do it: bets $0.06
HokageVIP: folds=20
wolf.ukr: folds=20
Uncalled bet ($0.06) returned to sem do it
sem do it collected $0.06 from pot
*** SUMMARY ***
Total pot $0.06 | Rake $0=20
Board [Jh 6s 5c]
Seat 1: KoXa8319 folded before Flop (didn't bet)
Seat 2: Tadeusz 1947 (button) folded before Flop (didn't bet)
Seat 3: wolf.ukr (small blind) folded on the Flop
Seat 4: sem do it (big blind) collected ($0.06)
Seat 5: sunnyray25 folded before Flop (didn't bet)
Seat 6: the_wickstar folded before Flop (didn't bet)
Seat 7: dymarko folded before Flop (didn't bet)
Seat 8: HokageVIP folded on the Flop
Seat 9: gizmondouk folded before Flop (didn't bet)


*********** # 60 **************
PokerStars Hand #169941156357:  Hold'em No Limit ($0.01/$0.02 USD) - 20=
17/05/05 1:01:43 CUST [2017/05/04 11:01:43 ET]
Table 'Idomeneus' 9-max Seat #4 is the button
Seat 1: sunnyray25 ($2.08 in chips)=20
Seat 3: greezex ($4.12 in chips)=20
Seat 4: fomik33 ($2 in chips)=20
Seat 5: the_wickstar ($1.46 in chips)=20
the_wickstar: posts small blind $0.01
sunnyray25: posts big blind $0.02
*** HOLE CARDS ***
Dealt to the_wickstar [8h 7d]
greezex: folds=20
fomik33: calls $0.02
the_wickstar: calls $0.01
sunnyray25: checks=20
*** FLOP *** [9c 9s 9d]
the_wickstar: checks=20
sunnyray25: checks=20
fomik33: checks=20
*** TURN *** [9c 9s 9d] [Kc]
the_wickstar: checks=20
sunnyray25: checks=20
fomik33: checks=20
*** RIVER *** [9c 9s 9d Kc] [Jc]
the_wickstar: checks=20
sunnyray25: checks=20
fomik33: checks=20
*** SHOW DOWN ***
the_wickstar: shows [8h 7d] (three of a kind, Nines)
sunnyray25: shows [5h Qs] (three of a kind, Nines - King+Queen kicker)
fomik33: shows [4d 4h] (a full house, Nines full of Fours)
fomik33 collected $0.06 from pot
*** SUMMARY ***
Total pot $0.06 | Rake $0=20
Board [9c 9s 9d Kc Jc]
Seat 1: sunnyray25 (big blind) showed [5h Qs] and lost with three of a =
kind, Nines
Seat 3: greezex folded before Flop (didn't bet)
Seat 4: fomik33 (button) showed [4d 4h] and won ($0.06) with a full hou=
se, Nines full of Fours
Seat 5: the_wickstar (small blind) showed [8h 7d] and lost with three o=
f a kind, Nines


*********** # 61 **************
PokerStars Hand #169941150645:  Hold'em No Limit ($0.01/$0.02 USD) - 20=
17/05/05 1:01:34 CUST [2017/05/04 11:01:34 ET]
Table 'Idomeneus' 9-max Seat #3 is the button
Seat 1: sunnyray25 ($2.08 in chips)=20
Seat 3: greezex ($4.12 in chips)=20
Seat 4: fomik33 ($2 in chips)=20
Seat 5: the_wickstar ($1.45 in chips)=20
fomik33: posts small blind $0.01
the_wickstar: posts big blind $0.02
*** HOLE CARDS ***
Dealt to the_wickstar [Ks 6c]
sunnyray25: folds=20
greezex: folds=20
fomik33: folds=20
Uncalled bet ($0.01) returned to the_wickstar
the_wickstar collected $0.02 from pot
*** SUMMARY ***
Total pot $0.02 | Rake $0=20
Seat 1: sunnyray25 folded before Flop (didn't bet)
Seat 3: greezex (button) folded before Flop (didn't bet)
Seat 4: fomik33 (small blind) folded before Flop
Seat 5: the_wickstar (big blind) collected ($0.02)


*********** # 62 **************
PokerStars Hand #169941137035:  Hold'em No Limit ($0.01/$0.02 USD) - 20=
17/05/05 1:01:11 CUST [2017/05/04 11:01:11 ET]
Table 'Benetnash' 9-max Seat #1 is the button
Seat 1: KoXa8319 ($2.12 in chips)=20
Seat 2: Tadeusz 1947 ($0.71 in chips)=20
Seat 3: wolf.ukr ($2.78 in chips)=20
Seat 5: sunnyray25 ($2.14 in chips)=20
Seat 6: the_wickstar ($3.77 in chips)=20
Seat 7: dymarko ($2 in chips)=20
Seat 8: HokageVIP ($2 in chips)=20
Seat 9: gizmondouk ($2.67 in chips)=20
Tadeusz 1947: posts small blind $0.01
wolf.ukr: posts big blind $0.02
sem do it: sits out=20
*** HOLE CARDS ***
Dealt to the_wickstar [3d Kc]
sunnyray25: folds=20
the_wickstar: folds=20
dymarko: folds=20
HokageVIP: folds=20
gizmondouk: raises $0.04 to $0.06
KoXa8319: folds=20
Tadeusz 1947: folds=20
wolf.ukr: calls $0.04
*** FLOP *** [3h Ts Td]
wolf.ukr: checks=20
gizmondouk: bets $0.08
wolf.ukr: calls $0.08
*** TURN *** [3h Ts Td] [Th]
wolf.ukr: checks=20
gizmondouk: checks=20
*** RIVER *** [3h Ts Td Th] [7s]
wolf.ukr: checks=20
gizmondouk: checks=20
*** SHOW DOWN ***
wolf.ukr: shows [6h 6c] (a full house, Tens full of Sixes)
gizmondouk: mucks hand=20
wolf.ukr collected $0.28 from pot
*** SUMMARY ***
Total pot $0.29 | Rake $0.01=20
Board [3h Ts Td Th 7s]
Seat 1: KoXa8319 (button) folded before Flop (didn't bet)
Seat 2: Tadeusz 1947 (small blind) folded before Flop
Seat 3: wolf.ukr (big blind) showed [6h 6c] and won ($0.28) with a full=
 house, Tens full of Sixes
Seat 5: sunnyray25 folded before Flop (didn't bet)
Seat 6: the_wickstar folded before Flop (didn't bet)
Seat 7: dymarko folded before Flop (didn't bet)
Seat 8: HokageVIP folded before Flop (didn't bet)
Seat 9: gizmondouk mucked [Js As]


*********** # 63 **************
PokerStars Hand #169941122529:  Hold'em No Limit ($0.01/$0.02 USD) - 20=
17/05/05 1:00:47 CUST [2017/05/04 11:00:47 ET]
Table 'Idomeneus' 9-max Seat #1 is the button
Seat 1: sunnyray25 ($2.08 in chips)=20
Seat 3: greezex ($4.13 in chips)=20
Seat 4: fomik33 ($2 in chips)=20
Seat 5: the_wickstar ($1.39 in chips)=20
greezex: posts small blind $0.01
fomik33: posts big blind $0.02
*** HOLE CARDS ***
Dealt to the_wickstar [Js Tc]
the_wickstar: calls $0.02
sunnyray25: folds=20
greezex: folds=20
fomik33: raises $0.03 to $0.05
the_wickstar: calls $0.03
*** FLOP *** [5s 6c 4h]
fomik33: checks=20
the_wickstar: checks=20
*** TURN *** [5s 6c 4h] [5d]
fomik33: checks=20
the_wickstar: bets $0.06
fomik33: folds=20
Uncalled bet ($0.06) returned to the_wickstar
the_wickstar collected $0.11 from pot
*** SUMMARY ***
Total pot $0.11 | Rake $0=20
Board [5s 6c 4h 5d]
Seat 1: sunnyray25 (button) folded before Flop (didn't bet)
Seat 3: greezex (small blind) folded before Flop
Seat 4: fomik33 (big blind) folded on the Turn
Seat 5: the_wickstar collected ($0.11)


*********** # 64 **************
PokerStars Hand #169941114913:  Hold'em No Limit ($0.01/$0.02 USD) - 20=
17/05/05 1:00:34 CUST [2017/05/04 11:00:34 ET]
Table 'Benetnash' 9-max Seat #9 is the button
Seat 1: KoXa8319 ($2.13 in chips)=20
Seat 2: Tadeusz 1947 ($0.73 in chips)=20
Seat 3: wolf.ukr ($2.78 in chips)=20
Seat 5: sunnyray25 ($2.11 in chips)=20
Seat 6: the_wickstar ($3.77 in chips)=20
Seat 7: dymarko ($2 in chips)=20
Seat 8: HokageVIP ($2 in chips)=20
Seat 9: gizmondouk ($2.67 in chips)=20
KoXa8319: posts small blind $0.01
Tadeusz 1947: posts big blind $0.02
sem do it: sits out=20
*** HOLE CARDS ***
Dealt to the_wickstar [7h 2s]
wolf.ukr: folds=20
sunnyray25: raises $0.04 to $0.06
the_wickstar: folds=20
dymarko: folds=20
HokageVIP: folds=20
gizmondouk: folds=20
KoXa8319: folds=20
Tadeusz 1947: folds=20
Uncalled bet ($0.04) returned to sunnyray25
sunnyray25 collected $0.05 from pot
*** SUMMARY ***
Total pot $0.05 | Rake $0=20
Seat 1: KoXa8319 (small blind) folded before Flop
Seat 2: Tadeusz 1947 (big blind) folded before Flop
Seat 3: wolf.ukr folded before Flop (didn't bet)
Seat 5: sunnyray25 collected ($0.05)
Seat 6: the_wickstar folded before Flop (didn't bet)
Seat 7: dymarko folded before Flop (didn't bet)
Seat 8: HokageVIP folded before Flop (didn't bet)
Seat 9: gizmondouk (button) folded before Flop (didn't bet)


*********** # 65 **************
PokerStars Hand #169941103210:  Hold'em No Limit ($0.01/$0.02 USD) - 20=
17/05/05 1:00:13 CUST [2017/05/04 11:00:13 ET]
Table 'Idomeneus' 9-max Seat #5 is the button
Seat 1: sunnyray25 ($1.94 in chips)=20
Seat 3: greezex ($4.15 in chips)=20
Seat 4: fomik33 ($2.12 in chips)=20
Seat 5: the_wickstar ($1.39 in chips)=20
sunnyray25: posts small blind $0.01
greezex: posts big blind $0.02
*** HOLE CARDS ***
Dealt to the_wickstar [2s Ts]
fomik33: raises $0.03 to $0.05
the_wickstar: folds=20
sunnyray25: calls $0.04
greezex: folds=20
*** FLOP *** [3c 7s 5c]
sunnyray25: checks=20
fomik33: checks=20
*** TURN *** [3c 7s 5c] [Qc]
sunnyray25: checks=20
fomik33: bets $0.08
sunnyray25: calls $0.08
*** RIVER *** [3c 7s 5c Qc] [4s]
sunnyray25: checks=20
fomik33: checks=20
*** SHOW DOWN ***
sunnyray25: shows [6d 6s] (a straight, Three to Seven)
fomik33: mucks hand=20
sunnyray25 collected $0.27 from pot
*** SUMMARY ***
Total pot $0.28 | Rake $0.01=20
Board [3c 7s 5c Qc 4s]
Seat 1: sunnyray25 (small blind) showed [6d 6s] and won ($0.27) with a =
straight, Three to Seven
Seat 3: greezex (big blind) folded before Flop
Seat 4: fomik33 mucked [Ks Jc]
Seat 5: the_wickstar (button) folded before Flop (didn't bet)


*********** # 66 **************
PokerStars Hand #169941098217:  Hold'em No Limit ($0.01/$0.02 USD) - 20=
17/05/05 1:00:04 CUST [2017/05/04 11:00:04 ET]
Table 'Benetnash' 9-max Seat #8 is the button
Seat 1: KoXa8319 ($2.12 in chips)=20
Seat 2: Tadeusz 1947 ($0.73 in chips)=20
Seat 3: wolf.ukr ($2.78 in chips)=20
Seat 5: sunnyray25 ($2.11 in chips)=20
Seat 6: the_wickstar ($3.77 in chips)=20
Seat 7: dymarko ($2 in chips)=20
Seat 8: HokageVIP ($2 in chips)=20
Seat 9: gizmondouk ($2.68 in chips)=20
gizmondouk: posts small blind $0.01
KoXa8319: posts big blind $0.02
sem do it: sits out=20
*** HOLE CARDS ***
Dealt to the_wickstar [4c 5h]
Tadeusz 1947: folds=20
wolf.ukr: folds=20
sunnyray25: folds=20
the_wickstar: folds=20
dymarko: folds=20
HokageVIP: folds=20
gizmondouk: folds=20
Uncalled bet ($0.01) returned to KoXa8319
KoXa8319 collected $0.02 from pot
KoXa8319: doesn't show hand=20
*** SUMMARY ***
Total pot $0.02 | Rake $0=20
Seat 1: KoXa8319 (big blind) collected ($0.02)
Seat 2: Tadeusz 1947 folded before Flop (didn't bet)
Seat 3: wolf.ukr folded before Flop (didn't bet)
Seat 5: sunnyray25 folded before Flop (didn't bet)
Seat 6: the_wickstar folded before Flop (didn't bet)
Seat 7: dymarko folded before Flop (didn't bet)
Seat 8: HokageVIP (button) folded before Flop (didn't bet)
Seat 9: gizmondouk (small blind) folded before Flop


*********** # 67 **************
PokerStars Hand #169941095365:  Hold'em No Limit ($0.01/$0.02 USD) - 20=
17/05/05 0:59:59 CUST [2017/05/04 10:59:59 ET]
Table 'Idomeneus' 9-max Seat #4 is the button
Seat 1: sunnyray25 ($1.96 in chips)=20
Seat 3: greezex ($4.15 in chips)=20
Seat 4: fomik33 ($2.09 in chips)=20
Seat 5: the_wickstar ($1.40 in chips)=20
the_wickstar: posts small blind $0.01
sunnyray25: posts big blind $0.02
*** HOLE CARDS ***
Dealt to the_wickstar [7d Qs]
greezex: folds=20
fomik33: raises $0.03 to $0.05
the_wickstar: folds=20
sunnyray25: folds=20
Uncalled bet ($0.03) returned to fomik33
fomik33 collected $0.05 from pot
fomik33: doesn't show hand=20
*** SUMMARY ***
Total pot $0.05 | Rake $0=20
Seat 1: sunnyray25 (big blind) folded before Flop
Seat 3: greezex folded before Flop (didn't bet)
Seat 4: fomik33 (button) collected ($0.05)
Seat 5: the_wickstar (small blind) folded before Flop


*********** # 68 **************
PokerStars Hand #169941082862:  Hold'em No Limit ($0.01/$0.02 USD) - 20=
17/05/05 0:59:37 CUST [2017/05/04 10:59:37 ET]
Table 'Benetnash' 9-max Seat #7 is the button
Seat 1: KoXa8319 ($2.12 in chips)=20
Seat 2: Tadeusz 1947 ($0.73 in chips)=20
Seat 3: wolf.ukr ($2.78 in chips)=20
Seat 5: sunnyray25 ($2.08 in chips)=20
Seat 6: the_wickstar ($3.77 in chips)=20
Seat 7: dymarko ($2 in chips)=20
Seat 8: HokageVIP ($2 in chips)=20
Seat 9: gizmondouk ($2.70 in chips)=20
HokageVIP: posts small blind $0.01
gizmondouk: posts big blind $0.02
sem do it: sits out=20
*** HOLE CARDS ***
Dealt to the_wickstar [4d 9c]
KoXa8319: folds=20
Tadeusz 1947: folds=20
wolf.ukr: folds=20
sunnyray25: raises $0.04 to $0.06
the_wickstar: folds=20
dymarko: folds=20
HokageVIP: folds=20
gizmondouk: folds=20
Uncalled bet ($0.04) returned to sunnyray25
sunnyray25 collected $0.05 from pot
sunnyray25: doesn't show hand=20
*** SUMMARY ***
Total pot $0.05 | Rake $0=20
Seat 1: KoXa8319 folded before Flop (didn't bet)
Seat 2: Tadeusz 1947 folded before Flop (didn't bet)
Seat 3: wolf.ukr folded before Flop (didn't bet)
Seat 5: sunnyray25 collected ($0.05)
Seat 6: the_wickstar folded before Flop (didn't bet)
Seat 7: dymarko (button) folded before Flop (didn't bet)
Seat 8: HokageVIP (small blind) folded before Flop
Seat 9: gizmondouk (big blind) folded before Flop


*********** # 69 **************
PokerStars Hand #169941066717:  Hold'em No Limit ($0.01/$0.02 USD) - 20=
17/05/05 0:59:07 CUST [2017/05/04 10:59:07 ET]
Table 'Idomeneus' 9-max Seat #3 is the button
Seat 1: sunnyray25 ($1.96 in chips)=20
Seat 3: greezex ($4.15 in chips)=20
Seat 4: fomik33 ($2.44 in chips)=20
Seat 5: the_wickstar ($1.07 in chips)=20
fomik33: posts small blind $0.01
the_wickstar: posts big blind $0.02
*** HOLE CARDS ***
Dealt to the_wickstar [As 7s]
sunnyray25: folds=20
greezex: folds=20
fomik33: raises $0.03 to $0.05
the_wickstar: calls $0.03
*** FLOP *** [6h 7h 7c]
fomik33: bets $0.10
the_wickstar: calls $0.10
*** TURN *** [6h 7h 7c] [6d]
fomik33: bets $0.20
the_wickstar: raises $0.20 to $0.40
fomik33: folds=20
Uncalled bet ($0.20) returned to the_wickstar
the_wickstar collected $0.68 from pot
*** SUMMARY ***
Total pot $0.70 | Rake $0.02=20
Board [6h 7h 7c 6d]
Seat 1: sunnyray25 folded before Flop (didn't bet)
Seat 3: greezex (button) folded before Flop (didn't bet)
Seat 4: fomik33 (small blind) folded on the Turn
Seat 5: the_wickstar (big blind) collected ($0.68)


*********** # 70 **************
PokerStars Hand #169941054776:  Hold'em No Limit ($0.01/$0.02 USD) - 20=
17/05/05 0:58:46 CUST [2017/05/04 10:58:46 ET]
Table 'Idomeneus' 9-max Seat #1 is the button
Seat 1: sunnyray25 ($1.93 in chips)=20
Seat 3: greezex ($4.16 in chips)=20
Seat 4: fomik33 ($2.46 in chips)=20
Seat 5: the_wickstar ($1.07 in chips)=20
greezex: posts small blind $0.01
fomik33: posts big blind $0.02
*** HOLE CARDS ***
Dealt to the_wickstar [9h 4h]
the_wickstar: folds=20
sunnyray25: raises $0.04 to $0.06
greezex: folds=20
fomik33: folds=20
Uncalled bet ($0.04) returned to sunnyray25
sunnyray25 collected $0.05 from pot
*** SUMMARY ***
Total pot $0.05 | Rake $0=20
Seat 1: sunnyray25 (button) collected ($0.05)
Seat 3: greezex (small blind) folded before Flop
Seat 4: fomik33 (big blind) folded before Flop
Seat 5: the_wickstar folded before Flop (didn't bet)


*********** # 71 **************
PokerStars Hand #169941045757:  Hold'em No Limit ($0.01/$0.02 USD) - 20=
17/05/05 0:58:30 CUST [2017/05/04 10:58:30 ET]
Table 'Idomeneus' 9-max Seat #5 is the button
Seat 1: sunnyray25 ($1.94 in chips)=20
Seat 3: greezex ($4.13 in chips)=20
Seat 4: fomik33 ($2.46 in chips)=20
Seat 5: the_wickstar ($1.09 in chips)=20
sunnyray25: posts small blind $0.01
greezex: posts big blind $0.02
*** HOLE CARDS ***
Dealt to the_wickstar [As 4c]
fomik33: folds=20
the_wickstar: calls $0.02
sunnyray25: folds=20
greezex: raises $0.08 to $0.10
the_wickstar: folds=20
Uncalled bet ($0.08) returned to greezex
greezex collected $0.05 from pot
greezex: doesn't show hand=20
*** SUMMARY ***
Total pot $0.05 | Rake $0=20
Seat 1: sunnyray25 (small blind) folded before Flop
Seat 3: greezex (big blind) collected ($0.05)
Seat 4: fomik33 folded before Flop (didn't bet)
Seat 5: the_wickstar (button) folded before Flop


*********** # 72 **************
PokerStars Hand #169941043709:  Hold'em No Limit ($0.01/$0.02 USD) - 20=
17/05/05 0:58:26 CUST [2017/05/04 10:58:26 ET]
Table 'Benetnash' 9-max Seat #6 is the button
Seat 1: KoXa8319 ($2.12 in chips)=20
Seat 2: Tadeusz 1947 ($0.73 in chips)=20
Seat 3: wolf.ukr ($2.78 in chips)=20
Seat 5: sunnyray25 ($2 in chips)=20
Seat 6: the_wickstar ($3.77 in chips)=20
Seat 7: dymarko ($2 in chips)=20
Seat 8: HokageVIP ($2 in chips)=20
Seat 9: gizmondouk ($2.70 in chips)=20
dymarko: posts small blind $0.01
HokageVIP: posts big blind $0.02
sem do it: sits out=20
*** HOLE CARDS ***
Dealt to the_wickstar [Jh 3d]
gizmondouk: folds=20
KoXa8319: folds=20
Tadeusz 1947: folds=20
wolf.ukr: folds=20
sunnyray25: raises $0.04 to $0.06
the_wickstar: folds=20
dymarko: calls $0.05
HokageVIP: folds=20
*** FLOP *** [9c Jc 6s]
dymarko: checks=20
sunnyray25: checks=20
*** TURN *** [9c Jc 6s] [Ks]
dymarko: checks=20
sunnyray25: bets $0.08
dymarko: folds=20
Uncalled bet ($0.08) returned to sunnyray25
sunnyray25 collected $0.14 from pot
sunnyray25: doesn't show hand=20
*** SUMMARY ***
Total pot $0.14 | Rake $0=20
Board [9c Jc 6s Ks]
Seat 1: KoXa8319 folded before Flop (didn't bet)
Seat 2: Tadeusz 1947 folded before Flop (didn't bet)
Seat 3: wolf.ukr folded before Flop (didn't bet)
Seat 5: sunnyray25 collected ($0.14)
Seat 6: the_wickstar (button) folded before Flop (didn't bet)
Seat 7: dymarko (small blind) folded on the Turn
Seat 8: HokageVIP (big blind) folded before Flop
Seat 9: gizmondouk folded before Flop (didn't bet)


*********** # 73 **************
PokerStars Hand #169941024677:  Hold'em No Limit ($0.01/$0.02 USD) - 20=
17/05/05 0:57:52 CUST [2017/05/04 10:57:52 ET]
Table 'Idomeneus' 9-max Seat #4 is the button
Seat 1: sunnyray25 ($1.98 in chips)=20
Seat 3: greezex ($4.13 in chips)=20
Seat 4: fomik33 ($2.46 in chips)=20
Seat 5: the_wickstar ($1.05 in chips)=20
the_wickstar: posts small blind $0.01
dymarko: is sitting out=20
dymarko leaves the table
sunnyray25: posts big blind $0.02
*** HOLE CARDS ***
Dealt to the_wickstar [4h 4s]
greezex: folds=20
fomik33: folds=20
the_wickstar: calls $0.01
sunnyray25: checks=20
*** FLOP *** [2h Kh Qc]
the_wickstar: checks=20
sunnyray25: checks=20
*** TURN *** [2h Kh Qc] [9h]
the_wickstar: checks=20
sunnyray25: bets $0.02
the_wickstar: calls $0.02
*** RIVER *** [2h Kh Qc 9h] [Qh]
the_wickstar: checks=20
sunnyray25: checks=20
*** SHOW DOWN ***
the_wickstar: shows [4h 4s] (a flush, King high)
sunnyray25: mucks hand=20
the_wickstar collected $0.08 from pot
*** SUMMARY ***
Total pot $0.08 | Rake $0=20
Board [2h Kh Qc 9h Qh]
Seat 1: sunnyray25 (big blind) mucked [Ts Kd]
Seat 3: greezex folded before Flop (didn't bet)
Seat 4: fomik33 (button) folded before Flop (didn't bet)
Seat 5: the_wickstar (small blind) showed [4h 4s] and won ($0.08) with =
a flush, King high


*********** # 74 **************
PokerStars Hand #169941017382:  Hold'em No Limit ($0.01/$0.02 USD) - 20=
17/05/05 0:57:38 CUST [2017/05/04 10:57:38 ET]
Table 'Benetnash' 9-max Seat #5 is the button
Seat 1: KoXa8319 ($2.12 in chips)=20
Seat 2: Tadeusz 1947 ($0.73 in chips)=20
Seat 3: wolf.ukr ($2.78 in chips)=20
Seat 5: sunnyray25 ($2 in chips)=20
Seat 6: the_wickstar ($3.73 in chips)=20
Seat 7: dymarko ($2 in chips)=20
Seat 8: HokageVIP ($2 in chips)=20
Seat 9: gizmondouk ($2.70 in chips)=20
the_wickstar: posts small blind $0.01
dymarko: posts big blind $0.02
sem do it: sits out=20
*** HOLE CARDS ***
Dealt to the_wickstar [7s 7h]
HokageVIP: calls $0.02
gizmondouk: folds=20
KoXa8319: folds=20
Tadeusz 1947: folds=20
wolf.ukr: folds=20
sunnyray25: folds=20
the_wickstar: calls $0.01
dymarko: checks=20
*** FLOP *** [8s 7d 7c]
the_wickstar: bets $0.02
dymarko: folds=20
HokageVIP: folds=20
Uncalled bet ($0.02) returned to the_wickstar
the_wickstar collected $0.06 from pot
*** SUMMARY ***
Total pot $0.06 | Rake $0=20
Board [8s 7d 7c]
Seat 1: KoXa8319 folded before Flop (didn't bet)
Seat 2: Tadeusz 1947 folded before Flop (didn't bet)
Seat 3: wolf.ukr folded before Flop (didn't bet)
Seat 5: sunnyray25 (button) folded before Flop (didn't bet)
Seat 6: the_wickstar (small blind) collected ($0.06)
Seat 7: dymarko (big blind) folded on the Flop
Seat 8: HokageVIP folded on the Flop
Seat 9: gizmondouk folded before Flop (didn't bet)


*********** # 75 **************
PokerStars Hand #169941013987:  Hold'em No Limit ($0.01/$0.02 USD) - 20=
17/05/05 0:57:32 CUST [2017/05/04 10:57:32 ET]
Table 'Idomeneus' 9-max Seat #3 is the button
Seat 1: sunnyray25 ($1.98 in chips)=20
Seat 3: greezex ($4.10 in chips)=20
Seat 4: fomik33 ($2.47 in chips)=20
Seat 5: the_wickstar ($1.07 in chips)=20
Seat 6: dymarko ($2.07 in chips)=20
fomik33: posts small blind $0.01
the_wickstar: posts big blind $0.02
*** HOLE CARDS ***
Dealt to the_wickstar [7s 8c]
dymarko: folds=20
sunnyray25: folds=20
greezex: raises $0.04 to $0.06
fomik33: folds=20
the_wickstar: folds=20
Uncalled bet ($0.04) returned to greezex
greezex collected $0.05 from pot
greezex: doesn't show hand=20
*** SUMMARY ***
Total pot $0.05 | Rake $0=20
Seat 1: sunnyray25 folded before Flop (didn't bet)
Seat 3: greezex (button) collected ($0.05)
Seat 4: fomik33 (small blind) folded before Flop
Seat 5: the_wickstar (big blind) folded before Flop
Seat 6: dymarko folded before Flop (didn't bet)


*********** # 76 **************
PokerStars Hand #169940999818:  Hold'em No Limit ($0.01/$0.02 USD) - 20=
17/05/05 0:57:07 CUST [2017/05/04 10:57:07 ET]
Table 'Benetnash' 9-max Seat #3 is the button
Seat 1: KoXa8319 ($2.12 in chips)=20
Seat 2: Tadeusz 1947 ($0.73 in chips)=20
Seat 3: wolf.ukr ($2.78 in chips)=20
Seat 5: sunnyray25 ($0.80 in chips)=20
Seat 6: the_wickstar ($3.75 in chips)=20
Seat 7: dymarko ($2 in chips)=20
Seat 8: HokageVIP ($2 in chips)=20
Seat 9: gizmondouk ($2.70 in chips)=20
sem do it will be allowed to play after the button
sunnyray25: posts small blind $0.01
the_wickstar: posts big blind $0.02
*** HOLE CARDS ***
Dealt to the_wickstar [5c 7c]
dymarko: folds=20
HokageVIP: folds=20
gizmondouk: folds=20
KoXa8319: folds=20
Tadeusz 1947: folds=20
wolf.ukr: folds=20
sunnyray25: raises $0.04 to $0.06
the_wickstar: folds=20
Uncalled bet ($0.04) returned to sunnyray25
sunnyray25 collected $0.04 from pot
sunnyray25: doesn't show hand=20
*** SUMMARY ***
Total pot $0.04 | Rake $0=20
Seat 1: KoXa8319 folded before Flop (didn't bet)
Seat 2: Tadeusz 1947 folded before Flop (didn't bet)
Seat 3: wolf.ukr (button) folded before Flop (didn't bet)
Seat 5: sunnyray25 (small blind) collected ($0.04)
Seat 6: the_wickstar (big blind) folded before Flop
Seat 7: dymarko folded before Flop (didn't bet)
Seat 8: HokageVIP folded before Flop (didn't bet)
Seat 9: gizmondouk folded before Flop (didn't bet)


*********** # 77 **************
PokerStars Hand #169940969296:  Hold'em No Limit ($0.01/$0.02 USD) - 20=
17/05/05 0:56:11 CUST [2017/05/04 10:56:11 ET]
Table 'Idomeneus' 9-max Seat #1 is the button
Seat 1: sunnyray25 ($1.98 in chips)=20
Seat 3: greezex ($4.06 in chips)=20
Seat 4: fomik33 ($2.49 in chips)=20
Seat 5: the_wickstar ($1.09 in chips)=20
Seat 6: dymarko ($2.07 in chips)=20
greezex: posts small blind $0.01
fomik33: posts big blind $0.02
*** HOLE CARDS ***
Dealt to the_wickstar [Jc Kd]
the_wickstar: calls $0.02
dymarko: folds=20
sunnyray25: folds=20
greezex: calls $0.01
fomik33: checks=20
*** FLOP *** [As 6c 4h]
greezex: checks=20
fomik33: checks=20
the_wickstar: checks=20
*** TURN *** [As 6c 4h] [3h]
greezex: bets $0.06
fomik33: folds=20
the_wickstar: folds=20
Uncalled bet ($0.06) returned to greezex
greezex collected $0.06 from pot
greezex: doesn't show hand=20
*** SUMMARY ***
Total pot $0.06 | Rake $0=20
Board [As 6c 4h 3h]
Seat 1: sunnyray25 (button) folded before Flop (didn't bet)
Seat 3: greezex (small blind) collected ($0.06)
Seat 4: fomik33 (big blind) folded on the Turn
Seat 5: the_wickstar folded on the Turn
Seat 6: dymarko folded before Flop (didn't bet)


*********** # 78 **************
PokerStars Hand #169940952224:  Hold'em No Limit ($0.01/$0.02 USD) - 20=
17/05/05 0:55:40 CUST [2017/05/04 10:55:40 ET]
Table 'Idomeneus' 9-max Seat #7 is the button
Seat 1: sunnyray25 ($1.99 in chips)=20
Seat 3: greezex ($4.05 in chips)=20
Seat 4: fomik33 ($2.49 in chips)=20
Seat 5: the_wickstar ($1.09 in chips)=20
Seat 6: dymarko ($2.07 in chips)=20
Seat 7: chugun1987 ($0.88 in chips)=20
sunnyray25: posts small blind $0.01
Geyko.K: is sitting out=20
Geyko.K leaves the table
greezex: posts big blind $0.02
*** HOLE CARDS ***
Dealt to the_wickstar [5h 3s]
fomik33: folds=20
the_wickstar: folds=20
dymarko: folds=20
chugun1987: folds=20
chugun1987 leaves the table
sunnyray25: folds=20
Uncalled bet ($0.01) returned to greezex
greezex collected $0.02 from pot
greezex: doesn't show hand=20
*** SUMMARY ***
Total pot $0.02 | Rake $0=20
Seat 1: sunnyray25 (small blind) folded before Flop
Seat 3: greezex (big blind) collected ($0.02)
Seat 4: fomik33 folded before Flop (didn't bet)
Seat 5: the_wickstar folded before Flop (didn't bet)
Seat 6: dymarko folded before Flop (didn't bet)
Seat 7: chugun1987 (button) folded before Flop (didn't bet)


*********** # 79 **************
PokerStars Hand #169940938101:  Hold'em No Limit ($0.01/$0.02 USD) - 20=
17/05/05 0:55:14 CUST [2017/05/04 10:55:14 ET]
Table 'Benetnash' 9-max Seat #2 is the button
Seat 1: KoXa8319 ($2.12 in chips)=20
Seat 2: Tadeusz 1947 ($0.73 in chips)=20
Seat 3: wolf.ukr ($2.79 in chips)=20
Seat 5: sunnyray25 ($1.99 in chips)=20
Seat 6: the_wickstar ($1.86 in chips)=20
Seat 7: dymarko ($2.05 in chips)=20
Seat 8: HokageVIP ($2 in chips)=20
Seat 9: gizmondouk ($2.78 in chips)=20
wolf.ukr: posts small blind $0.01
AliceX6: is sitting out=20
AliceX6 leaves the table
sunnyray25: posts big blind $0.02
*** HOLE CARDS ***
Dealt to the_wickstar [Ah Kd]
the_wickstar: raises $0.06 to $0.08
dymarko: calls $0.08
HokageVIP: folds=20
gizmondouk: calls $0.08
KoXa8319: folds=20
Tadeusz 1947: folds=20
wolf.ukr: folds=20
sunnyray25: raises $0.33 to $0.41
the_wickstar: raises $0.79 to $1.20
dymarko: folds=20
gizmondouk: folds=20
sunnyray25: calls $0.79
*** FLOP *** [8d 9c Tc]
sunnyray25: bets $0.79 and is all-in
the_wickstar: calls $0.66 and is all-in
Uncalled bet ($0.13) returned to sunnyray25
*** TURN *** [8d 9c Tc] [9h]
*** RIVER *** [8d 9c Tc 9h] [2s]
sem do it joins the table at seat #4=20
*** SHOW DOWN ***
sunnyray25: shows [4c 5c] (a pair of Nines)
the_wickstar: shows [Ah Kd] (a pair of Nines - Ace kicker)
the_wickstar collected $3.75 from pot
*** SUMMARY ***
Total pot $3.89 | Rake $0.14=20
Board [8d 9c Tc 9h 2s]
Seat 1: KoXa8319 folded before Flop (didn't bet)
Seat 2: Tadeusz 1947 (button) folded before Flop (didn't bet)
Seat 3: wolf.ukr (small blind) folded before Flop
Seat 5: sunnyray25 (big blind) showed [4c 5c] and lost with a pair of N=
ines
Seat 6: the_wickstar showed [Ah Kd] and won ($3.75) with a pair of Nines
Seat 7: dymarko folded before Flop
Seat 8: HokageVIP folded before Flop (didn't bet)
Seat 9: gizmondouk folded before Flop


*********** # 80 **************
PokerStars Hand #169940929715:  Hold'em No Limit ($0.01/$0.02 USD) - 20=
17/05/05 0:55:01 CUST [2017/05/04 10:55:01 ET]
Table 'Idomeneus' 9-max Seat #6 is the button
Seat 1: sunnyray25 ($1.97 in chips)=20
Seat 2: Geyko.K ($4.22 in chips)=20
Seat 3: greezex ($4.05 in chips)=20
Seat 4: fomik33 ($2.49 in chips)=20
Seat 5: the_wickstar ($1.09 in chips)=20
Seat 6: dymarko ($2.07 in chips)=20
Seat 7: chugun1987 ($0.90 in chips)=20
chugun1987: posts small blind $0.01
JekaPoyniak: is sitting out=20
JekaPoyniak leaves the table
sunnyray25: posts big blind $0.02
*** HOLE CARDS ***
Dealt to the_wickstar [4s 6d]
Geyko.K: folds=20
greezex: folds=20
fomik33: folds=20
the_wickstar: folds=20
dymarko: folds=20
chugun1987: calls $0.01
sunnyray25: raises $0.06 to $0.08
chugun1987: folds=20
Uncalled bet ($0.06) returned to sunnyray25
sunnyray25 collected $0.04 from pot
sunnyray25: doesn't show hand=20
*** SUMMARY ***
Total pot $0.04 | Rake $0=20
Seat 1: sunnyray25 (big blind) collected ($0.04)
Seat 2: Geyko.K folded before Flop (didn't bet)
Seat 3: greezex folded before Flop (didn't bet)
Seat 4: fomik33 folded before Flop (didn't bet)
Seat 5: the_wickstar folded before Flop (didn't bet)
Seat 6: dymarko (button) folded before Flop (didn't bet)
Seat 7: chugun1987 (small blind) folded before Flop


*********** # 81 **************
PokerStars Hand #169940894924:  Hold'em No Limit ($0.01/$0.02 USD) - 20=
17/05/05 0:54:07 CUST [2017/05/04 10:54:07 ET]
Table 'Benetnash' 9-max Seat #1 is the button
Seat 1: KoXa8319 ($2.12 in chips)=20
Seat 2: Tadeusz 1947 ($0.74 in chips)=20
Seat 3: wolf.ukr ($2.62 in chips)=20
Seat 4: AliceX6 ($2.19 in chips)=20
Seat 5: sunnyray25 ($1.99 in chips)=20
Seat 6: the_wickstar ($1.86 in chips)=20
Seat 7: dymarko ($2.05 in chips)=20
Seat 8: HokageVIP ($2 in chips)=20
Seat 9: gizmondouk ($2.78 in chips)=20
Tadeusz 1947: posts small blind $0.01
wolf.ukr: posts big blind $0.02
*** HOLE CARDS ***
Dealt to the_wickstar [Kd 4s]
AliceX6: raises $0.04 to $0.06
sunnyray25: folds=20
the_wickstar: folds=20
dymarko: folds=20
HokageVIP: folds=20
gizmondouk: folds=20
KoXa8319: folds=20
Tadeusz 1947: folds=20
wolf.ukr: raises $0.11 to $0.17
AliceX6: calls $0.11
*** FLOP *** [3s Jd 8h]
wolf.ukr: bets $0.26
AliceX6: folds=20
Uncalled bet ($0.26) returned to wolf.ukr
wolf.ukr collected $0.34 from pot
*** SUMMARY ***
Total pot $0.35 | Rake $0.01=20
Board [3s Jd 8h]
Seat 1: KoXa8319 (button) folded before Flop (didn't bet)
Seat 2: Tadeusz 1947 (small blind) folded before Flop
Seat 3: wolf.ukr (big blind) collected ($0.34)
Seat 4: AliceX6 folded on the Flop
Seat 5: sunnyray25 folded before Flop (didn't bet)
Seat 6: the_wickstar folded before Flop (didn't bet)
Seat 7: dymarko folded before Flop (didn't bet)
Seat 8: HokageVIP folded before Flop (didn't bet)
Seat 9: gizmondouk folded before Flop (didn't bet)


*********** # 82 **************
PokerStars Hand #169940893544:  Hold'em No Limit ($0.01/$0.02 USD) - 20=
17/05/05 0:54:04 CUST [2017/05/04 10:54:04 ET]
Table 'Idomeneus' 9-max Seat #5 is the button
Seat 1: sunnyray25 ($1.97 in chips)=20
Seat 2: Geyko.K ($4.22 in chips)=20
Seat 3: greezex ($4.05 in chips)=20
Seat 4: fomik33 ($2.49 in chips)=20
Seat 5: the_wickstar ($1.09 in chips)=20
Seat 6: dymarko ($2.15 in chips)=20
Seat 7: chugun1987 ($0.83 in chips)=20
Seat 9: JekaPoyniak ($2 in chips)=20
dymarko: posts small blind $0.01
chugun1987: posts big blind $0.02
*** HOLE CARDS ***
Dealt to the_wickstar [4s Js]
JekaPoyniak: folds=20
sunnyray25: folds=20
Geyko.K: folds=20
greezex: folds=20
fomik33: folds=20
the_wickstar: folds=20
dymarko: raises $0.02 to $0.04
chugun1987: calls $0.02
*** FLOP *** [2d 6d 4c]
dymarko: bets $0.04
chugun1987: calls $0.04
*** TURN *** [2d 6d 4c] [Td]
dymarko: checks=20
chugun1987: checks=20
*** RIVER *** [2d 6d 4c Td] [8s]
dymarko: checks=20
chugun1987: checks=20
*** SHOW DOWN ***
dymarko: shows [Kd 9h] (high card King)
chugun1987: shows [8c 3c] (a pair of Eights)
chugun1987 collected $0.15 from pot
*** SUMMARY ***
Total pot $0.16 | Rake $0.01=20
Board [2d 6d 4c Td 8s]
Seat 1: sunnyray25 folded before Flop (didn't bet)
Seat 2: Geyko.K folded before Flop (didn't bet)
Seat 3: greezex folded before Flop (didn't bet)
Seat 4: fomik33 folded before Flop (didn't bet)
Seat 5: the_wickstar (button) folded before Flop (didn't bet)
Seat 6: dymarko (small blind) showed [Kd 9h] and lost with high card Ki=
ng
Seat 7: chugun1987 (big blind) showed [8c 3c] and won ($0.15) with a pa=
ir of Eights
Seat 9: JekaPoyniak folded before Flop (didn't bet)


*********** # 83 **************
PokerStars Hand #169940874275:  Hold'em No Limit ($0.01/$0.02 USD) - 20=
17/05/05 0:53:34 CUST [2017/05/04 10:53:34 ET]
Table 'Benetnash' 9-max Seat #9 is the button
Seat 1: KoXa8319 ($2.13 in chips)=20
Seat 2: Tadeusz 1947 ($0.76 in chips)=20
Seat 3: wolf.ukr ($2.62 in chips)=20
Seat 4: AliceX6 ($2.19 in chips)=20
Seat 5: sunnyray25 ($1.96 in chips)=20
Seat 6: the_wickstar ($1.86 in chips)=20
Seat 7: dymarko ($2.05 in chips)=20
Seat 8: HokageVIP ($2 in chips)=20
Seat 9: gizmondouk ($2.78 in chips)=20
KoXa8319: posts small blind $0.01
Tadeusz 1947: posts big blind $0.02
*** HOLE CARDS ***
Dealt to the_wickstar [7c Js]
wolf.ukr: folds=20
AliceX6: folds=20
sunnyray25: raises $0.04 to $0.06
the_wickstar: folds=20
dymarko: folds=20
HokageVIP: folds=20
gizmondouk: folds=20
KoXa8319: folds=20
Tadeusz 1947: folds=20
Uncalled bet ($0.04) returned to sunnyray25
sunnyray25 collected $0.05 from pot
sunnyray25: doesn't show hand=20
*** SUMMARY ***
Total pot $0.05 | Rake $0=20
Seat 1: KoXa8319 (small blind) folded before Flop
Seat 2: Tadeusz 1947 (big blind) folded before Flop
Seat 3: wolf.ukr folded before Flop (didn't bet)
Seat 4: AliceX6 folded before Flop (didn't bet)
Seat 5: sunnyray25 collected ($0.05)
Seat 6: the_wickstar folded before Flop (didn't bet)
Seat 7: dymarko folded before Flop (didn't bet)
Seat 8: HokageVIP folded before Flop (didn't bet)
Seat 9: gizmondouk (button) folded before Flop (didn't bet)


*********** # 84 **************
PokerStars Hand #169940872979:  Hold'em No Limit ($0.01/$0.02 USD) - 20=
17/05/05 0:53:32 CUST [2017/05/04 10:53:32 ET]
Table 'Idomeneus' 9-max Seat #4 is the button
Seat 1: sunnyray25 ($1.97 in chips)=20
Seat 2: Geyko.K ($4.22 in chips)=20
Seat 3: greezex ($4.05 in chips)=20
Seat 4: fomik33 ($2.49 in chips)=20
Seat 5: the_wickstar ($1.10 in chips)=20
Seat 6: dymarko ($2.14 in chips)=20
Seat 7: chugun1987 ($0.83 in chips)=20
Seat 9: JekaPoyniak ($2 in chips)=20
the_wickstar: posts small blind $0.01
dymarko: posts big blind $0.02
*** HOLE CARDS ***
Dealt to the_wickstar [8c 3s]
chugun1987: folds=20
JekaPoyniak: folds=20
sunnyray25: folds=20
Geyko.K: folds=20
greezex: folds=20
fomik33: folds=20
the_wickstar: folds=20
Uncalled bet ($0.01) returned to dymarko
dymarko collected $0.02 from pot
dymarko: doesn't show hand=20
*** SUMMARY ***
Total pot $0.02 | Rake $0=20
Seat 1: sunnyray25 folded before Flop (didn't bet)
Seat 2: Geyko.K folded before Flop (didn't bet)
Seat 3: greezex folded before Flop (didn't bet)
Seat 4: fomik33 (button) folded before Flop (didn't bet)
Seat 5: the_wickstar (small blind) folded before Flop
Seat 6: dymarko (big blind) collected ($0.02)
Seat 7: chugun1987 folded before Flop (didn't bet)
Seat 9: JekaPoyniak folded before Flop (didn't bet)


*********** # 85 **************
PokerStars Hand #169940851558:  Hold'em No Limit ($0.01/$0.02 USD) - 20=
17/05/05 0:52:59 CUST [2017/05/04 10:52:59 ET]
Table 'Idomeneus' 9-max Seat #3 is the button
Seat 1: sunnyray25 ($1.97 in chips)=20
Seat 2: Geyko.K ($4.22 in chips)=20
Seat 3: greezex ($4.05 in chips)=20
Seat 4: fomik33 ($2.50 in chips)=20
Seat 5: the_wickstar ($1.12 in chips)=20
Seat 6: dymarko ($2.11 in chips)=20
Seat 7: chugun1987 ($0.83 in chips)=20
Seat 9: JekaPoyniak ($2 in chips)=20
fomik33: posts small blind $0.01
the_wickstar: posts big blind $0.02
*** HOLE CARDS ***
Dealt to the_wickstar [Jd 4d]
dymarko: raises $0.04 to $0.06
chugun1987: folds=20
JekaPoyniak: folds=20
sunnyray25: folds=20
Geyko.K: folds=20
greezex: folds=20
fomik33: folds=20
the_wickstar: folds=20
Uncalled bet ($0.04) returned to dymarko
dymarko collected $0.05 from pot
dymarko: doesn't show hand=20
*** SUMMARY ***
Total pot $0.05 | Rake $0=20
Seat 1: sunnyray25 folded before Flop (didn't bet)
Seat 2: Geyko.K folded before Flop (didn't bet)
Seat 3: greezex (button) folded before Flop (didn't bet)
Seat 4: fomik33 (small blind) folded before Flop
Seat 5: the_wickstar (big blind) folded before Flop
Seat 6: dymarko collected ($0.05)
Seat 7: chugun1987 folded before Flop (didn't bet)
Seat 9: JekaPoyniak folded before Flop (didn't bet)


*********** # 86 **************
PokerStars Hand #169940839016:  Hold'em No Limit ($0.01/$0.02 USD) - 20=
17/05/05 0:52:39 CUST [2017/05/04 10:52:39 ET]
Table 'Benetnash' 9-max Seat #8 is the button
Seat 1: KoXa8319 ($2.17 in chips)=20
Seat 2: Tadeusz 1947 ($0.76 in chips)=20
Seat 3: wolf.ukr ($2.62 in chips)=20
Seat 4: AliceX6 ($2.19 in chips)=20
Seat 5: sunnyray25 ($1.96 in chips)=20
Seat 6: the_wickstar ($1.86 in chips)=20
Seat 7: dymarko ($2 in chips)=20
Seat 8: HokageVIP ($2 in chips)=20
Seat 9: gizmondouk ($2.79 in chips)=20
gizmondouk: posts small blind $0.01
KoXa8319: posts big blind $0.02
*** HOLE CARDS ***
Dealt to the_wickstar [4h 7s]
Tadeusz 1947: folds=20
wolf.ukr: folds=20
AliceX6: folds=20
sunnyray25: folds=20
the_wickstar: folds=20
dymarko: raises $0.02 to $0.04
HokageVIP: folds=20
gizmondouk: folds=20
KoXa8319: calls $0.02
*** FLOP *** [4d 8d 2h]
KoXa8319: checks=20
dymarko: bets $0.06
KoXa8319: folds=20
Uncalled bet ($0.06) returned to dymarko
dymarko collected $0.09 from pot
dymarko: doesn't show hand=20
*** SUMMARY ***
Total pot $0.09 | Rake $0=20
Board [4d 8d 2h]
Seat 1: KoXa8319 (big blind) folded on the Flop
Seat 2: Tadeusz 1947 folded before Flop (didn't bet)
Seat 3: wolf.ukr folded before Flop (didn't bet)
Seat 4: AliceX6 folded before Flop (didn't bet)
Seat 5: sunnyray25 folded before Flop (didn't bet)
Seat 6: the_wickstar folded before Flop (didn't bet)
Seat 7: dymarko collected ($0.09)
Seat 8: HokageVIP (button) folded before Flop (didn't bet)
Seat 9: gizmondouk (small blind) folded before Flop


*********** # 87 **************
PokerStars Hand #169940821387:  Hold'em No Limit ($0.01/$0.02 USD) - 20=
17/05/05 0:52:12 CUST [2017/05/04 10:52:12 ET]
Table 'Benetnash' 9-max Seat #7 is the button
Seat 1: KoXa8319 ($2.17 in chips)=20
Seat 2: Tadeusz 1947 ($0.76 in chips)=20
Seat 3: wolf.ukr ($2.62 in chips)=20
Seat 4: AliceX6 ($2.19 in chips)=20
Seat 5: sunnyray25 ($1.93 in chips)=20
Seat 6: the_wickstar ($1.86 in chips)=20
Seat 7: dymarko ($2 in chips)=20
Seat 8: HokageVIP ($2 in chips)=20
Seat 9: gizmondouk ($2.81 in chips)=20
HokageVIP: posts small blind $0.01
gizmondouk: posts big blind $0.02
*** HOLE CARDS ***
Dealt to the_wickstar [Ac 3d]
KoXa8319: folds=20
Tadeusz 1947: folds=20
wolf.ukr: folds=20
AliceX6: folds=20
sunnyray25: raises $0.04 to $0.06
the_wickstar: folds=20
dymarko: folds=20
HokageVIP: folds=20
gizmondouk: folds=20
Uncalled bet ($0.04) returned to sunnyray25
sunnyray25 collected $0.05 from pot
sunnyray25: doesn't show hand=20
*** SUMMARY ***
Total pot $0.05 | Rake $0=20
Seat 1: KoXa8319 folded before Flop (didn't bet)
Seat 2: Tadeusz 1947 folded before Flop (didn't bet)
Seat 3: wolf.ukr folded before Flop (didn't bet)
Seat 4: AliceX6 folded before Flop (didn't bet)
Seat 5: sunnyray25 collected ($0.05)
Seat 6: the_wickstar folded before Flop (didn't bet)
Seat 7: dymarko (button) folded before Flop (didn't bet)
Seat 8: HokageVIP (small blind) folded before Flop
Seat 9: gizmondouk (big blind) folded before Flop


*********** # 88 **************
PokerStars Hand #169940808035:  Hold'em No Limit ($0.01/$0.02 USD) - 20=
17/05/05 0:51:51 CUST [2017/05/04 10:51:51 ET]
Table 'Idomeneus' 9-max Seat #2 is the button
Seat 1: sunnyray25 ($1.97 in chips)=20
Seat 2: Geyko.K ($5.38 in chips)=20
Seat 3: greezex ($2.95 in chips)=20
Seat 4: fomik33 ($2.52 in chips)=20
Seat 5: the_wickstar ($1.12 in chips)=20
Seat 6: dymarko ($2.11 in chips)=20
Seat 7: chugun1987 ($0.83 in chips)=20
Seat 9: JekaPoyniak ($2 in chips)=20
greezex: posts small blind $0.01
fomik33: posts big blind $0.02
*** HOLE CARDS ***
Dealt to the_wickstar [8d 7s]
the_wickstar: folds=20
dymarko: folds=20
chugun1987: folds=20
MalyshkinAle leaves the table
JekaPoyniak: folds=20
sunnyray25: folds=20
Geyko.K: raises $0.02 to $0.04
greezex: raises $0.20 to $0.24
fomik33: folds=20
Geyko.K: calls $0.20
*** FLOP *** [3s 7h Jc]
greezex: bets $0.32
Geyko.K: calls $0.32
*** TURN *** [3s 7h Jc] [Jh]
greezex: checks=20
Geyko.K: bets $0.60
greezex: calls $0.60
*** RIVER *** [3s 7h Jc Jh] [9h]
greezex: checks=20
Geyko.K: checks=20
*** SHOW DOWN ***
greezex: shows [Ts Tc] (two pair, Jacks and Tens)
Geyko.K: mucks hand=20
greezex collected $2.26 from pot
*** SUMMARY ***
Total pot $2.34 | Rake $0.08=20
Board [3s 7h Jc Jh 9h]
Seat 1: sunnyray25 folded before Flop (didn't bet)
Seat 2: Geyko.K (button) mucked [9d Qd]
Seat 3: greezex (small blind) showed [Ts Tc] and won ($2.26) with two p=
air, Jacks and Tens
Seat 4: fomik33 (big blind) folded before Flop
Seat 5: the_wickstar folded before Flop (didn't bet)
Seat 6: dymarko folded before Flop (didn't bet)
Seat 7: chugun1987 folded before Flop (didn't bet)
Seat 9: JekaPoyniak folded before Flop (didn't bet)


*********** # 89 **************
PokerStars Hand #169940777368:  Hold'em No Limit ($0.01/$0.02 USD) - 20=
17/05/05 0:51:04 CUST [2017/05/04 10:51:04 ET]
Table 'Idomeneus' 9-max Seat #1 is the button
Seat 1: sunnyray25 ($1.97 in chips)=20
Seat 2: Geyko.K ($5.39 in chips)=20
Seat 3: greezex ($2.97 in chips)=20
Seat 4: fomik33 ($2.52 in chips)=20
Seat 5: the_wickstar ($1.12 in chips)=20
Seat 6: dymarko ($2.11 in chips)=20
Seat 7: chugun1987 ($0.80 in chips)=20
Seat 9: JekaPoyniak ($2 in chips)=20
Geyko.K: posts small blind $0.01
greezex: posts big blind $0.02
*** HOLE CARDS ***
Dealt to the_wickstar [7s 6c]
fomik33: folds=20
the_wickstar has timed out
the_wickstar: folds=20
dymarko: folds=20
chugun1987: raises $0.02 to $0.04
JekaPoyniak: folds=20
sunnyray25: folds=20
Geyko.K: folds=20
greezex: folds=20
Uncalled bet ($0.02) returned to chugun1987
chugun1987 collected $0.05 from pot
chugun1987: doesn't show hand=20
*** SUMMARY ***
Total pot $0.05 | Rake $0=20
Seat 1: sunnyray25 (button) folded before Flop (didn't bet)
Seat 2: Geyko.K (small blind) folded before Flop
Seat 3: greezex (big blind) folded before Flop
Seat 4: fomik33 folded before Flop (didn't bet)
Seat 5: the_wickstar folded before Flop (didn't bet)
Seat 6: dymarko folded before Flop (didn't bet)
Seat 7: chugun1987 collected ($0.05)
Seat 9: JekaPoyniak folded before Flop (didn't bet)


*********** # 90 **************
PokerStars Hand #169940771172:  Hold'em No Limit ($0.01/$0.02 USD) - 20=
17/05/05 0:50:54 CUST [2017/05/04 10:50:54 ET]
Table 'Benetnash' 9-max Seat #6 is the button
Seat 1: KoXa8319 ($2.17 in chips)=20
Seat 2: Tadeusz 1947 ($0.78 in chips)=20
Seat 3: wolf.ukr ($2.62 in chips)=20
Seat 4: AliceX6 ($2.19 in chips)=20
Seat 5: sunnyray25 ($1.93 in chips)=20
Seat 6: the_wickstar ($1.80 in chips)=20
Seat 7: dymarko ($2.02 in chips)=20
Seat 8: HokageVIP ($2 in chips)=20
Seat 9: gizmondouk ($2.81 in chips)=20
dymarko: posts small blind $0.01
HokageVIP: posts big blind $0.02
*** HOLE CARDS ***
Dealt to the_wickstar [As 3h]
gizmondouk: folds=20
KoXa8319: folds=20
Tadeusz 1947: calls $0.02
wolf.ukr: folds=20
AliceX6: folds=20
sunnyray25: folds=20
the_wickstar: calls $0.02
dymarko: calls $0.01
HokageVIP: checks=20
*** FLOP *** [7c 9c Ac]
dymarko: checks=20
HokageVIP: checks=20
Tadeusz 1947: checks=20
the_wickstar: bets $0.04
dymarko: folds=20
HokageVIP: folds=20
Tadeusz 1947: folds=20
Uncalled bet ($0.04) returned to the_wickstar
the_wickstar collected $0.08 from pot
*** SUMMARY ***
Total pot $0.08 | Rake $0=20
Board [7c 9c Ac]
Seat 1: KoXa8319 folded before Flop (didn't bet)
Seat 2: Tadeusz 1947 folded on the Flop
Seat 3: wolf.ukr folded before Flop (didn't bet)
Seat 4: AliceX6 folded before Flop (didn't bet)
Seat 5: sunnyray25 folded before Flop (didn't bet)
Seat 6: the_wickstar (button) collected ($0.08)
Seat 7: dymarko (small blind) folded on the Flop
Seat 8: HokageVIP (big blind) folded on the Flop
Seat 9: gizmondouk folded before Flop (didn't bet)


*********** # 91 **************
PokerStars Hand #169940743642:  Hold'em No Limit ($0.01/$0.02 USD) - 20=
17/05/05 0:50:12 CUST [2017/05/04 10:50:12 ET]
Table 'Idomeneus' 9-max Seat #9 is the button
Seat 1: sunnyray25 ($1.98 in chips)=20
Seat 2: Geyko.K ($5.41 in chips)=20
Seat 3: greezex ($2.97 in chips)=20
Seat 4: fomik33 ($2.52 in chips)=20
Seat 5: the_wickstar ($1.09 in chips)=20
Seat 6: dymarko ($2.11 in chips)=20
Seat 7: chugun1987 ($0.80 in chips)=20
Seat 9: JekaPoyniak ($2 in chips)=20
sunnyray25: posts small blind $0.01
Geyko.K: posts big blind $0.02
*** HOLE CARDS ***
Dealt to the_wickstar [As 9h]
greezex: folds=20
fomik33: folds=20
the_wickstar: calls $0.02
dymarko: folds=20
chugun1987: folds=20
JekaPoyniak: folds=20
sunnyray25: folds=20
Geyko.K: checks=20
*** FLOP *** [Qs Ad 7s]
Geyko.K: checks=20
the_wickstar: bets $0.03
Geyko.K: folds=20
Uncalled bet ($0.03) returned to the_wickstar
the_wickstar collected $0.05 from pot
*** SUMMARY ***
Total pot $0.05 | Rake $0=20
Board [Qs Ad 7s]
Seat 1: sunnyray25 (small blind) folded before Flop
Seat 2: Geyko.K (big blind) folded on the Flop
Seat 3: greezex folded before Flop (didn't bet)
Seat 4: fomik33 folded before Flop (didn't bet)
Seat 5: the_wickstar collected ($0.05)
Seat 6: dymarko folded before Flop (didn't bet)
Seat 7: chugun1987 folded before Flop (didn't bet)
Seat 9: JekaPoyniak (button) folded before Flop (didn't bet)


*********** # 92 **************
PokerStars Hand #169940717299:  Hold'em No Limit ($0.01/$0.02 USD) - 20=
17/05/05 0:49:31 CUST [2017/05/04 10:49:31 ET]
Table 'Benetnash' 9-max Seat #5 is the button
Seat 1: KoXa8319 ($2.17 in chips)=20
Seat 2: Tadeusz 1947 ($0.78 in chips)=20
Seat 3: wolf.ukr ($2.62 in chips)=20
Seat 4: AliceX6 ($2.19 in chips)=20
Seat 5: sunnyray25 ($1.93 in chips)=20
Seat 6: the_wickstar ($1.80 in chips)=20
Seat 7: dymarko ($2.04 in chips)=20
Seat 8: HokageVIP ($2 in chips)=20
Seat 9: gizmondouk ($2.82 in chips)=20
the_wickstar: posts small blind $0.01
dymarko: posts big blind $0.02
*** HOLE CARDS ***
Dealt to the_wickstar [Qd Ah]
HokageVIP: folds=20
gizmondouk: raises $0.04 to $0.06
KoXa8319: folds=20
Tadeusz 1947: folds=20
wolf.ukr: folds=20
AliceX6: folds=20
sunnyray25: folds=20
the_wickstar: calls $0.05
dymarko: folds=20
*** FLOP *** [7h As 2s]
the_wickstar: checks=20
gizmondouk: bets $0.08
the_wickstar: raises $0.08 to $0.16
gizmondouk: raises $0.14 to $0.30
the_wickstar: calls $0.14
*** TURN *** [7h As 2s] [7s]
the_wickstar: checks=20
gizmondouk: checks=20
*** RIVER *** [7h As 2s 7s] [9d]
the_wickstar: checks=20
gizmondouk: checks=20
*** SHOW DOWN ***
the_wickstar: shows [Qd Ah] (two pair, Aces and Sevens)
gizmondouk: shows [Qh Ac] (two pair, Aces and Sevens)
the_wickstar collected $0.36 from pot
gizmondouk collected $0.35 from pot
*** SUMMARY ***
Total pot $0.74 | Rake $0.03=20
Board [7h As 2s 7s 9d]
Seat 1: KoXa8319 folded before Flop (didn't bet)
Seat 2: Tadeusz 1947 folded before Flop (didn't bet)
Seat 3: wolf.ukr folded before Flop (didn't bet)
Seat 4: AliceX6 folded before Flop (didn't bet)
Seat 5: sunnyray25 (button) folded before Flop (didn't bet)
Seat 6: the_wickstar (small blind) showed [Qd Ah] and won ($0.36) with =
two pair, Aces and Sevens
Seat 7: dymarko (big blind) folded before Flop
Seat 8: HokageVIP folded before Flop (didn't bet)
Seat 9: gizmondouk showed [Qh Ac] and won ($0.35) with two pair, Aces a=
nd Sevens


*********** # 93 **************
PokerStars Hand #169940710666:  Hold'em No Limit ($0.01/$0.02 USD) - 20=
17/05/05 0:49:21 CUST [2017/05/04 10:49:21 ET]
Table 'Idomeneus' 9-max Seat #7 is the button
Seat 1: sunnyray25 ($2 in chips)=20
Seat 2: Geyko.K ($5.41 in chips)=20
Seat 3: greezex ($2.97 in chips)=20
Seat 4: fomik33 ($2.57 in chips)=20
Seat 5: the_wickstar ($1.01 in chips)=20
Seat 6: dymarko ($2.11 in chips)=20
Seat 7: chugun1987 ($0.80 in chips)=20
Seat 9: JekaPoyniak ($2.01 in chips)=20
JekaPoyniak: posts small blind $0.01
sunnyray25: posts big blind $0.02
*** HOLE CARDS ***
Dealt to the_wickstar [Tc Ah]
Geyko.K: folds=20
greezex: folds=20
fomik33: raises $0.03 to $0.05
the_wickstar: calls $0.05
dymarko: folds=20
chugun1987: folds=20
JekaPoyniak: folds=20
sunnyray25: folds=20
*** FLOP *** [5c 3s Th]
fomik33: checks=20
the_wickstar: bets $0.06
fomik33: folds=20
Uncalled bet ($0.06) returned to the_wickstar
the_wickstar collected $0.13 from pot
*** SUMMARY ***
Total pot $0.13 | Rake $0=20
Board [5c 3s Th]
Seat 1: sunnyray25 (big blind) folded before Flop
Seat 2: Geyko.K folded before Flop (didn't bet)
Seat 3: greezex folded before Flop (didn't bet)
Seat 4: fomik33 folded on the Flop
Seat 5: the_wickstar collected ($0.13)
Seat 6: dymarko folded before Flop (didn't bet)
Seat 7: chugun1987 (button) folded before Flop (didn't bet)
Seat 9: JekaPoyniak (small blind) folded before Flop


*********** # 94 **************
PokerStars Hand #169940692916:  Hold'em No Limit ($0.01/$0.02 USD) - 20=
17/05/05 0:48:53 CUST [2017/05/04 10:48:53 ET]
Table 'Idomeneus' 9-max Seat #6 is the button
Seat 2: Geyko.K ($5.41 in chips)=20
Seat 3: greezex ($2.97 in chips)=20
Seat 4: fomik33 ($2.57 in chips)=20
Seat 5: the_wickstar ($1.01 in chips)=20
Seat 6: dymarko ($2.11 in chips)=20
Seat 7: chugun1987 ($0.78 in chips)=20
Seat 9: JekaPoyniak ($2.03 in chips)=20
chugun1987: posts small blind $0.01
MalyshkinAle: is sitting out=20
JekaPoyniak: posts big blind $0.02
sunnyray25: sits out=20
*** HOLE CARDS ***
Dealt to the_wickstar [3h 5c]
Geyko.K: folds=20
greezex: folds=20
fomik33: folds=20
the_wickstar: folds=20
dymarko: folds=20
chugun1987: raises $0.02 to $0.04
JekaPoyniak: folds=20
Uncalled bet ($0.02) returned to chugun1987
chugun1987 collected $0.04 from pot
chugun1987: doesn't show hand=20
*** SUMMARY ***
Total pot $0.04 | Rake $0=20
Seat 2: Geyko.K folded before Flop (didn't bet)
Seat 3: greezex folded before Flop (didn't bet)
Seat 4: fomik33 folded before Flop (didn't bet)
Seat 5: the_wickstar folded before Flop (didn't bet)
Seat 6: dymarko (button) folded before Flop (didn't bet)
Seat 7: chugun1987 (small blind) collected ($0.04)
Seat 9: JekaPoyniak (big blind) folded before Flop


*********** # 95 **************
PokerStars Hand #169940678129:  Hold'em No Limit ($0.01/$0.02 USD) - 20=
17/05/05 0:48:31 CUST [2017/05/04 10:48:31 ET]
Table 'Idomeneus' 9-max Seat #5 is the button
Seat 2: Geyko.K ($5.41 in chips)=20
Seat 3: greezex ($2.97 in chips)=20
Seat 4: fomik33 ($2.57 in chips)=20
Seat 5: the_wickstar ($1.01 in chips)=20
Seat 6: dymarko ($2.09 in chips)=20
Seat 7: chugun1987 ($0.80 in chips)=20
Seat 8: MalyshkinAle ($2.61 in chips)=20
Seat 9: JekaPoyniak ($2.03 in chips)=20
dymarko: posts small blind $0.01
chugun1987: posts big blind $0.02
sunnyray25: sits out=20
*** HOLE CARDS ***
Dealt to the_wickstar [3s As]
MalyshkinAle: folds=20
JekaPoyniak: folds=20
Geyko.K: folds=20
greezex: folds=20
fomik33: folds=20
the_wickstar: folds=20
dymarko: raises $0.02 to $0.04
chugun1987: folds=20
Uncalled bet ($0.02) returned to dymarko
dymarko collected $0.04 from pot
dymarko: doesn't show hand=20
*** SUMMARY ***
Total pot $0.04 | Rake $0=20
Seat 2: Geyko.K folded before Flop (didn't bet)
Seat 3: greezex folded before Flop (didn't bet)
Seat 4: fomik33 folded before Flop (didn't bet)
Seat 5: the_wickstar (button) folded before Flop (didn't bet)
Seat 6: dymarko (small blind) collected ($0.04)
Seat 7: chugun1987 (big blind) folded before Flop
Seat 8: MalyshkinAle folded before Flop (didn't bet)
Seat 9: JekaPoyniak folded before Flop (didn't bet)


*********** # 96 **************
PokerStars Hand #169940671853:  Hold'em No Limit ($0.01/$0.02 USD) - 20=
17/05/05 0:48:21 CUST [2017/05/04 10:48:21 ET]
Table 'Benetnash' 9-max Seat #4 is the button
Seat 1: KoXa8319 ($2.17 in chips)=20
Seat 2: Tadeusz 1947 ($0.80 in chips)=20
Seat 3: wolf.ukr ($2.64 in chips)=20
Seat 4: AliceX6 ($2 in chips)=20
Seat 5: sunnyray25 ($2.07 in chips)=20
Seat 6: the_wickstar ($1.82 in chips)=20
Seat 7: dymarko ($2.04 in chips)=20
Seat 8: HokageVIP ($2 in chips)=20
Seat 9: gizmondouk ($2.82 in chips)=20
sunnyray25: posts small blind $0.01
the_wickstar: posts big blind $0.02
Tadeusz 1947: posts big blind $0.02
*** HOLE CARDS ***
Dealt to the_wickstar [2s Jc]
dymarko: folds=20
HokageVIP: folds=20
gizmondouk: folds=20
KoXa8319: folds=20
Tadeusz 1947: checks=20
wolf.ukr: calls $0.02
AliceX6: raises $0.12 to $0.14
sunnyray25: calls $0.13
the_wickstar: folds=20
Tadeusz 1947: folds=20
wolf.ukr: folds=20
*** FLOP *** [3h 4c 3d]
sunnyray25: checks=20
AliceX6: bets $0.18
sunnyray25: folds=20
Uncalled bet ($0.18) returned to AliceX6
AliceX6 collected $0.33 from pot
AliceX6: doesn't show hand=20
*** SUMMARY ***
Total pot $0.34 | Rake $0.01=20
Board [3h 4c 3d]
Seat 1: KoXa8319 folded before Flop (didn't bet)
Seat 2: Tadeusz 1947 folded before Flop
Seat 3: wolf.ukr folded before Flop
Seat 4: AliceX6 (button) collected ($0.33)
Seat 5: sunnyray25 (small blind) folded on the Flop
Seat 6: the_wickstar (big blind) folded before Flop
Seat 7: dymarko folded before Flop (didn't bet)
Seat 8: HokageVIP folded before Flop (didn't bet)
Seat 9: gizmondouk folded before Flop (didn't bet)


*********** # 97 **************
PokerStars Hand #169940642026:  Hold'em No Limit ($0.01/$0.02 USD) - 20=
17/05/05 0:47:34 CUST [2017/05/04 10:47:34 ET]
Table 'Idomeneus' 9-max Seat #4 is the button
Seat 2: Geyko.K ($5.41 in chips)=20
Seat 3: greezex ($2.97 in chips)=20
Seat 4: fomik33 ($2.57 in chips)=20
Seat 5: the_wickstar ($1.03 in chips)=20
Seat 6: dymarko ($2.07 in chips)=20
Seat 7: chugun1987 ($0.80 in chips)=20
Seat 8: MalyshkinAle ($2.61 in chips)=20
Seat 9: JekaPoyniak ($2.03 in chips)=20
the_wickstar: posts small blind $0.01
dymarko: posts big blind $0.02
sunnyray25: sits out=20
*** HOLE CARDS ***
Dealt to the_wickstar [Ad 2c]
chugun1987: folds=20
MalyshkinAle: folds=20
JekaPoyniak: folds=20
Geyko.K: folds=20
greezex: folds=20
fomik33: folds=20
the_wickstar: calls $0.01
dymarko: checks=20
*** FLOP *** [4d Jc 5s]
the_wickstar: checks=20
dymarko: bets $0.02
the_wickstar: folds=20
Uncalled bet ($0.02) returned to dymarko
dymarko collected $0.04 from pot
dymarko: doesn't show hand=20
*** SUMMARY ***
Total pot $0.04 | Rake $0=20
Board [4d Jc 5s]
Seat 2: Geyko.K folded before Flop (didn't bet)
Seat 3: greezex folded before Flop (didn't bet)
Seat 4: fomik33 (button) folded before Flop (didn't bet)
Seat 5: the_wickstar (small blind) folded on the Flop
Seat 6: dymarko (big blind) collected ($0.04)
Seat 7: chugun1987 folded before Flop (didn't bet)
Seat 8: MalyshkinAle folded before Flop (didn't bet)
Seat 9: JekaPoyniak folded before Flop (didn't bet)


*********** # 98 **************
PokerStars Hand #169940641116:  Hold'em No Limit ($0.01/$0.02 USD) - 20=
17/05/05 0:47:33 CUST [2017/05/04 10:47:33 ET]
Table 'Benetnash' 9-max Seat #3 is the button
Seat 1: KoXa8319 ($2.17 in chips)=20
Seat 3: wolf.ukr ($2.64 in chips)=20
Seat 4: AliceX6 ($2.01 in chips)=20
Seat 5: sunnyray25 ($2 in chips)=20
Seat 6: the_wickstar ($1.82 in chips)=20
Seat 7: dymarko ($2.04 in chips)=20
Seat 8: HokageVIP ($2 in chips)=20
Seat 9: gizmondouk ($2.88 in chips)=20
AliceX6: posts small blind $0.01
sunnyray25: posts big blind $0.02
Tadeusz 1947: sits out=20
*** HOLE CARDS ***
Dealt to the_wickstar [4d Jc]
the_wickstar: folds=20
dymarko: folds=20
HokageVIP: folds=20
gizmondouk: raises $0.04 to $0.06
KoXa8319: folds=20
wolf.ukr: folds=20
AliceX6: folds=20
sunnyray25: raises $0.10 to $0.16
gizmondouk: folds=20
Uncalled bet ($0.10) returned to sunnyray25
sunnyray25 collected $0.13 from pot
sunnyray25: doesn't show hand=20
*** SUMMARY ***
Total pot $0.13 | Rake $0=20
Seat 1: KoXa8319 folded before Flop (didn't bet)
Seat 3: wolf.ukr (button) folded before Flop (didn't bet)
Seat 4: AliceX6 (small blind) folded before Flop
Seat 5: sunnyray25 (big blind) collected ($0.13)
Seat 6: the_wickstar folded before Flop (didn't bet)
Seat 7: dymarko folded before Flop (didn't bet)
Seat 8: HokageVIP folded before Flop (didn't bet)
Seat 9: gizmondouk folded before Flop


*********** # 99 **************
PokerStars Hand #169940626934:  Hold'em No Limit ($0.01/$0.02 USD) - 20=
17/05/05 0:47:11 CUST [2017/05/04 10:47:11 ET]
Table 'Idomeneus' 9-max Seat #3 is the button
Seat 2: Geyko.K ($5.41 in chips)=20
Seat 3: greezex ($2.97 in chips)=20
Seat 4: fomik33 ($2.58 in chips)=20
Seat 5: the_wickstar ($1.05 in chips)=20
Seat 6: dymarko ($2.07 in chips)=20
Seat 7: chugun1987 ($0.80 in chips)=20
Seat 8: MalyshkinAle ($2.61 in chips)=20
Seat 9: JekaPoyniak ($2 in chips)=20
fomik33: posts small blind $0.01
the_wickstar: posts big blind $0.02
sunnyray25: sits out=20
*** HOLE CARDS ***
Dealt to the_wickstar [9d 8c]
dymarko: folds=20
chugun1987: folds=20
MalyshkinAle: folds=20
JekaPoyniak: raises $0.06 to $0.08
Geyko.K: folds=20
greezex: folds=20
fomik33: folds=20
the_wickstar: folds=20
Uncalled bet ($0.06) returned to JekaPoyniak
JekaPoyniak collected $0.05 from pot
*** SUMMARY ***
Total pot $0.05 | Rake $0=20
Seat 2: Geyko.K folded before Flop (didn't bet)
Seat 3: greezex (button) folded before Flop (didn't bet)
Seat 4: fomik33 (small blind) folded before Flop
Seat 5: the_wickstar (big blind) folded before Flop
Seat 6: dymarko folded before Flop (didn't bet)
Seat 7: chugun1987 folded before Flop (didn't bet)
Seat 8: MalyshkinAle folded before Flop (didn't bet)
Seat 9: JekaPoyniak collected ($0.05)


*********** # 100 **************
PokerStars Hand #169940618401:  Hold'em No Limit ($0.01/$0.02 USD) - 20=
17/05/05 0:46:57 CUST [2017/05/04 10:46:57 ET]
Table 'Benetnash' 9-max Seat #1 is the button
Seat 1: KoXa8319 ($2.14 in chips)=20
Seat 3: wolf.ukr ($2.65 in chips)=20
Seat 4: AliceX6 ($2.03 in chips)=20
Seat 6: the_wickstar ($1.82 in chips)=20
Seat 7: dymarko ($2.04 in chips)=20
Seat 8: HokageVIP ($2 in chips)=20
Seat 9: gizmondouk ($2.88 in chips)=20
wolf.ukr: posts small blind $0.01
AliceX6: posts big blind $0.02
sunnyray25: sits out=20
*** HOLE CARDS ***
Dealt to the_wickstar [6h 9s]
the_wickstar: folds=20
dymarko: folds=20
HokageVIP: folds=20
gizmondouk: folds=20
KoXa8319: raises $0.04 to $0.06
Tadeusz 1947 joins the table at seat #2=20
wolf.ukr: folds=20
AliceX6: folds=20
Uncalled bet ($0.04) returned to KoXa8319
KoXa8319 collected $0.05 from pot
KoXa8319: doesn't show hand=20
*** SUMMARY ***
Total pot $0.05 | Rake $0=20
Seat 1: KoXa8319 (button) collected ($0.05)
Seat 3: wolf.ukr (small blind) folded before Flop
Seat 4: AliceX6 (big blind) folded before Flop
Seat 6: the_wickstar folded before Flop (didn't bet)
Seat 7: dymarko folded before Flop (didn't bet)
Seat 8: HokageVIP folded before Flop (didn't bet)
Seat 9: gizmondouk folded before Flop (didn't bet)


*********** # 101 **************
PokerStars Hand #169940608854:  Hold'em No Limit ($0.01/$0.02 USD) - 20=
17/05/05 0:46:43 CUST [2017/05/04 10:46:43 ET]
Table 'Benetnash' 9-max Seat #9 is the button
Seat 1: KoXa8319 ($2.15 in chips)=20
Seat 3: wolf.ukr ($2.67 in chips)=20
Seat 4: AliceX6 ($2.03 in chips)=20
Seat 6: the_wickstar ($1.82 in chips)=20
Seat 7: dymarko ($2.01 in chips)=20
Seat 8: HokageVIP ($2 in chips)=20
Seat 9: gizmondouk ($2.88 in chips)=20
KoXa8319: posts small blind $0.01
Ainur M: is sitting out=20
wolf.ukr: posts big blind $0.02
*** HOLE CARDS ***
Dealt to the_wickstar [6c 2h]
sunnyray25 joins the table at seat #5=20
AliceX6: folds=20
Ainur M leaves the table
the_wickstar: folds=20
dymarko: raises $0.02 to $0.04
HokageVIP: folds=20
gizmondouk: folds=20
KoXa8319: folds=20
wolf.ukr: folds=20
Uncalled bet ($0.02) returned to dymarko
dymarko collected $0.05 from pot
dymarko: doesn't show hand=20
*** SUMMARY ***
Total pot $0.05 | Rake $0=20
Seat 1: KoXa8319 (small blind) folded before Flop
Seat 3: wolf.ukr (big blind) folded before Flop
Seat 4: AliceX6 folded before Flop (didn't bet)
Seat 6: the_wickstar folded before Flop (didn't bet)
Seat 7: dymarko collected ($0.05)
Seat 8: HokageVIP folded before Flop (didn't bet)
Seat 9: gizmondouk (button) folded before Flop (didn't bet)


*********** # 102 **************
PokerStars Hand #169940586855:  Hold'em No Limit ($0.01/$0.02 USD) - 20=
17/05/05 0:46:08 CUST [2017/05/04 10:46:08 ET]
Table 'Idomeneus' 9-max Seat #2 is the button
Seat 2: Geyko.K ($5.27 in chips)=20
Seat 3: greezex ($2.98 in chips)=20
Seat 4: fomik33 ($2.60 in chips)=20
Seat 5: the_wickstar ($1.05 in chips)=20
Seat 6: dymarko ($2.07 in chips)=20
Seat 7: chugun1987 ($0.19 in chips)=20
Seat 8: MalyshkinAle ($2.73 in chips)=20
Seat 9: JekaPoyniak ($2 in chips)=20
greezex: posts small blind $0.01
fomik33: posts big blind $0.02
*** HOLE CARDS ***
Dealt to the_wickstar [6h 7s]
the_wickstar: folds=20
dymarko: folds=20
chugun1987: folds=20
MalyshkinAle: raises $0.04 to $0.06
JekaPoyniak: folds=20
Geyko.K: calls $0.06
greezex: folds=20
fomik33: folds=20
*** FLOP *** [9s Kc 5c]
MalyshkinAle: checks=20
Geyko.K: bets $0.06
sunnyray25 joins the table at seat #1=20
MalyshkinAle: calls $0.06
*** TURN *** [9s Kc 5c] [7d]
MalyshkinAle: checks=20
Geyko.K: bets $0.10
MalyshkinAle: folds=20
Uncalled bet ($0.10) returned to Geyko.K
Geyko.K collected $0.26 from pot
Geyko.K: doesn't show hand=20
*** SUMMARY ***
Total pot $0.27 | Rake $0.01=20
Board [9s Kc 5c 7d]
Seat 2: Geyko.K (button) collected ($0.26)
Seat 3: greezex (small blind) folded before Flop
Seat 4: fomik33 (big blind) folded before Flop
Seat 5: the_wickstar folded before Flop (didn't bet)
Seat 6: dymarko folded before Flop (didn't bet)
Seat 7: chugun1987 folded before Flop (didn't bet)
Seat 8: MalyshkinAle folded on the Turn
Seat 9: JekaPoyniak folded before Flop (didn't bet)


*********** # 103 **************
PokerStars Hand #169940582531:  Hold'em No Limit ($0.01/$0.02 USD) - 20=
17/05/05 0:46:02 CUST [2017/05/04 10:46:02 ET]
Table 'Benetnash' 9-max Seat #8 is the button
Seat 1: KoXa8319 ($2.17 in chips)=20
Seat 2: Ainur M ($3.26 in chips)=20
Seat 3: wolf.ukr ($2.67 in chips)=20
Seat 4: AliceX6 ($2 in chips)=20
Seat 6: the_wickstar ($1.82 in chips)=20
Seat 7: dymarko ($2.01 in chips)=20
Seat 8: HokageVIP ($2 in chips)=20
Seat 9: gizmondouk ($2.89 in chips)=20
gizmondouk: posts small blind $0.01
KoXa8319: posts big blind $0.02
*** HOLE CARDS ***
Dealt to the_wickstar [2d 4h]
Ainur M: folds=20
wolf.ukr: folds=20
AliceX6: raises $0.04 to $0.06
the_wickstar: folds=20
dymarko: folds=20
HokageVIP: folds=20
gizmondouk: folds=20
KoXa8319: folds=20
Uncalled bet ($0.04) returned to AliceX6
AliceX6 collected $0.05 from pot
AliceX6: doesn't show hand=20
*** SUMMARY ***
Total pot $0.05 | Rake $0=20
Seat 1: KoXa8319 (big blind) folded before Flop
Seat 2: Ainur M folded before Flop (didn't bet)
Seat 3: wolf.ukr folded before Flop (didn't bet)
Seat 4: AliceX6 collected ($0.05)
Seat 6: the_wickstar folded before Flop (didn't bet)
Seat 7: dymarko folded before Flop (didn't bet)
Seat 8: HokageVIP (button) folded before Flop (didn't bet)
Seat 9: gizmondouk (small blind) folded before Flop


*********** # 104 **************
PokerStars Hand #169940555973:  Hold'em No Limit ($0.01/$0.02 USD) - 20=
17/05/05 0:45:20 CUST [2017/05/04 10:45:20 ET]
Table 'Benetnash' 9-max Seat #7 is the button
Seat 1: KoXa8319 ($2.14 in chips)=20
Seat 2: Ainur M ($3.26 in chips)=20
Seat 3: wolf.ukr ($2.67 in chips)=20
Seat 4: AliceX6 ($2 in chips)=20
Seat 6: the_wickstar ($1.82 in chips)=20
Seat 7: dymarko ($2.01 in chips)=20
Seat 8: HokageVIP ($2 in chips)=20
Seat 9: gizmondouk ($2.91 in chips)=20
HokageVIP: posts small blind $0.01
gizmondouk: posts big blind $0.02
*** HOLE CARDS ***
Dealt to the_wickstar [9d Tc]
KoXa8319: raises $0.06 to $0.08
Ainur M: folds=20
wolf.ukr: folds=20
AliceX6: folds=20
the_wickstar: folds=20
dymarko: folds=20
HokageVIP: folds=20
gizmondouk: folds=20
Uncalled bet ($0.06) returned to KoXa8319
KoXa8319 collected $0.05 from pot
KoXa8319: doesn't show hand=20
*** SUMMARY ***
Total pot $0.05 | Rake $0=20
Seat 1: KoXa8319 collected ($0.05)
Seat 2: Ainur M folded before Flop (didn't bet)
Seat 3: wolf.ukr folded before Flop (didn't bet)
Seat 4: AliceX6 folded before Flop (didn't bet)
Seat 6: the_wickstar folded before Flop (didn't bet)
Seat 7: dymarko (button) folded before Flop (didn't bet)
Seat 8: HokageVIP (small blind) folded before Flop
Seat 9: gizmondouk (big blind) folded before Flop


*********** # 105 **************
PokerStars Hand #169940536382:  Hold'em No Limit ($0.01/$0.02 USD) - 20=
17/05/05 0:44:50 CUST [2017/05/04 10:44:50 ET]
Table 'Idomeneus' 9-max Seat #9 is the button
Seat 2: Geyko.K ($5.28 in chips)=20
Seat 3: greezex ($3 in chips)=20
Seat 4: fomik33 ($2 in chips)=20
Seat 5: the_wickstar ($1.05 in chips)=20
Seat 6: dymarko ($2.07 in chips)=20
Seat 7: chugun1987 ($0.80 in chips)=20
Seat 8: MalyshkinAle ($2.73 in chips)=20
Seat 9: JekaPoyniak ($2 in chips)=20
Geyko.K: posts small blind $0.01
greezex: posts big blind $0.02
chugun1987: posts big blind $0.02
*** HOLE CARDS ***
Dealt to the_wickstar [3s 6d]
fomik33: raises $0.03 to $0.05
the_wickstar: folds=20
dymarko: folds=20
chugun1987: calls $0.03
MalyshkinAle: folds=20
JekaPoyniak: folds=20
Geyko.K: folds=20
greezex: folds=20
*** FLOP *** [6h 2c 6c]
fomik33: bets $0.15
chugun1987: calls $0.15
*** TURN *** [6h 2c 6c] [7h]
fomik33: bets $0.41
chugun1987: calls $0.41
*** RIVER *** [6h 2c 6c 7h] [Ts]
fomik33: bets $0.19
chugun1987: folds=20
Uncalled bet ($0.19) returned to fomik33
fomik33 collected $1.21 from pot
fomik33: doesn't show hand=20
*** SUMMARY ***
Total pot $1.25 | Rake $0.04=20
Board [6h 2c 6c 7h Ts]
Seat 2: Geyko.K (small blind) folded before Flop
Seat 3: greezex (big blind) folded before Flop
Seat 4: fomik33 collected ($1.21)
Seat 5: the_wickstar folded before Flop (didn't bet)
Seat 6: dymarko folded before Flop (didn't bet)
Seat 7: chugun1987 folded on the River
Seat 8: MalyshkinAle folded before Flop (didn't bet)
Seat 9: JekaPoyniak (button) folded before Flop (didn't bet)


*********** # 106 **************
PokerStars Hand #169940514566:  Hold'em No Limit ($0.01/$0.02 USD) - 20=
17/05/05 0:44:16 CUST [2017/05/04 10:44:16 ET]
Table 'Benetnash' 9-max Seat #6 is the button
Seat 1: KoXa8319 ($2.14 in chips)=20
Seat 2: Ainur M ($3.26 in chips)=20
Seat 3: wolf.ukr ($2.64 in chips)=20
Seat 4: AliceX6 ($2 in chips)=20
Seat 6: the_wickstar ($1.82 in chips)=20
Seat 7: dymarko ($2.02 in chips)=20
Seat 8: HokageVIP ($2 in chips)=20
Seat 9: gizmondouk ($2.91 in chips)=20
dymarko: posts small blind $0.01
HokageVIP: posts big blind $0.02
*** HOLE CARDS ***
Dealt to the_wickstar [7c 9h]
gizmondouk: folds=20
KoXa8319: folds=20
Ainur M: folds=20
wolf.ukr: raises $0.04 to $0.06
AliceX6: folds=20
the_wickstar: folds=20
dymarko: folds=20
HokageVIP: folds=20
Uncalled bet ($0.04) returned to wolf.ukr
wolf.ukr collected $0.05 from pot
*** SUMMARY ***
Total pot $0.05 | Rake $0=20
Seat 1: KoXa8319 folded before Flop (didn't bet)
Seat 2: Ainur M folded before Flop (didn't bet)
Seat 3: wolf.ukr collected ($0.05)
Seat 4: AliceX6 folded before Flop (didn't bet)
Seat 6: the_wickstar (button) folded before Flop (didn't bet)
Seat 7: dymarko (small blind) folded before Flop
Seat 8: HokageVIP (big blind) folded before Flop
Seat 9: gizmondouk folded before Flop (didn't bet)


*********** # 107 **************
PokerStars Hand #169940498309:  Hold'em No Limit ($0.01/$0.02 USD) - 20=
17/05/05 0:43:51 CUST [2017/05/04 10:43:51 ET]
Table 'Idomeneus' 9-max Seat #8 is the button
Seat 2: Geyko.K ($5.30 in chips)=20
Seat 3: greezex ($3 in chips)=20
Seat 4: fomik33 ($2 in chips)=20
Seat 5: the_wickstar ($1.05 in chips)=20
Seat 6: dymarko ($2 in chips)=20
Seat 8: MalyshkinAle ($2.77 in chips)=20
Seat 9: JekaPoyniak ($2 in chips)=20
JekaPoyniak: posts small blind $0.01
apodive: is sitting out=20
apodive leaves the table
Geyko.K: posts big blind $0.02
*** HOLE CARDS ***
Dealt to the_wickstar [Ah 5c]
greezex: folds=20
fomik33: folds=20
the_wickstar: folds=20
dymarko: raises $0.02 to $0.04
MalyshkinAle: calls $0.04
JekaPoyniak: folds=20
chugun1987 joins the table at seat #7=20
Geyko.K: folds=20
*** FLOP *** [9h Js Ad]
dymarko: bets $0.06
MalyshkinAle: folds=20
Uncalled bet ($0.06) returned to dymarko
dymarko collected $0.11 from pot
dymarko: doesn't show hand=20
*** SUMMARY ***
Total pot $0.11 | Rake $0=20
Board [9h Js Ad]
Seat 2: Geyko.K (big blind) folded before Flop
Seat 3: greezex folded before Flop (didn't bet)
Seat 4: fomik33 folded before Flop (didn't bet)
Seat 5: the_wickstar folded before Flop (didn't bet)
Seat 6: dymarko collected ($0.11)
Seat 8: MalyshkinAle (button) folded on the Flop
Seat 9: JekaPoyniak (small blind) folded before Flop


*********** # 108 **************
PokerStars Hand #169940495932:  Hold'em No Limit ($0.01/$0.02 USD) - 20=
17/05/05 0:43:47 CUST [2017/05/04 10:43:47 ET]
Table 'Benetnash' 9-max Seat #4 is the button
Seat 1: KoXa8319 ($2.14 in chips)=20
Seat 2: Ainur M ($3.26 in chips)=20
Seat 3: wolf.ukr ($2.64 in chips)=20
Seat 4: AliceX6 ($2 in chips)=20
Seat 6: the_wickstar ($1.83 in chips)=20
Seat 7: dymarko ($2.01 in chips)=20
Seat 8: HokageVIP ($2 in chips)=20
Seat 9: gizmondouk ($2.91 in chips)=20
the_wickstar: posts small blind $0.01
dymarko: posts big blind $0.02
*** HOLE CARDS ***
Dealt to the_wickstar [9s Td]
HokageVIP: folds=20
gizmondouk: folds=20
KoXa8319: folds=20
Ainur M: folds=20
wolf.ukr: folds=20
AliceX6: folds=20
the_wickstar: folds=20
Uncalled bet ($0.01) returned to dymarko
dymarko collected $0.02 from pot
dymarko: doesn't show hand=20
*** SUMMARY ***
Total pot $0.02 | Rake $0=20
Seat 1: KoXa8319 folded before Flop (didn't bet)
Seat 2: Ainur M folded before Flop (didn't bet)
Seat 3: wolf.ukr folded before Flop (didn't bet)
Seat 4: AliceX6 (button) folded before Flop (didn't bet)
Seat 6: the_wickstar (small blind) folded before Flop
Seat 7: dymarko (big blind) collected ($0.02)
Seat 8: HokageVIP folded before Flop (didn't bet)
Seat 9: gizmondouk folded before Flop (didn't bet)


*********** # 109 **************
PokerStars Hand #169940461226:  Hold'em No Limit ($0.01/$0.02 USD) - 20=
17/05/05 0:42:54 CUST [2017/05/04 10:42:54 ET]
Table 'Benetnash' 9-max Seat #3 is the button
Seat 1: KoXa8319 ($2.20 in chips)=20
Seat 2: Ainur M ($1.65 in chips)=20
Seat 3: wolf.ukr ($2.64 in chips)=20
Seat 4: AliceX6 ($2.13 in chips)=20
Seat 6: the_wickstar ($1.85 in chips)=20
Seat 7: dymarko ($2.01 in chips)=20
Seat 8: HokageVIP ($2 in chips)=20
Seat 9: gizmondouk ($2.91 in chips)=20
AliceX6: posts small blind $0.01
Krol165: is sitting out=20
the_wickstar: posts big blind $0.02
*** HOLE CARDS ***
Dealt to the_wickstar [4d 2s]
dymarko: folds=20
Krol165 leaves the table
HokageVIP: folds=20
gizmondouk: folds=20
KoXa8319: raises $0.04 to $0.06
gn4444 joins the table at seat #5=20
Ainur M: raises $0.15 to $0.21
gn4444 leaves the table
wolf.ukr: folds=20
AliceX6: raises $0.35 to $0.56
the_wickstar: folds=20
KoXa8319: folds=20
Sit N'Go 88 joins the table at seat #5=20
Ainur M: raises $1.09 to $1.65 and is all-in
Sit N'Go 88 leaves the table
AliceX6: calls $1.09
*** FLOP *** [9d 8h Ac]
*** TURN *** [9d 8h Ac] [8d]
*** RIVER *** [9d 8h Ac 8d] [9c]
*** SHOW DOWN ***
AliceX6: shows [As Kc] (two pair, Aces and Nines)
Ainur M: shows [Ad Ah] (a full house, Aces full of Nines)
Ainur M collected $3.26 from pot
*** SUMMARY ***
Total pot $3.38 | Rake $0.12=20
Board [9d 8h Ac 8d 9c]
Seat 1: KoXa8319 folded before Flop
Seat 2: Ainur M showed [Ad Ah] and won ($3.26) with a full house, Aces =
full of Nines
Seat 3: wolf.ukr (button) folded before Flop (didn't bet)
Seat 4: AliceX6 (small blind) showed [As Kc] and lost with two pair, Ac=
es and Nines
Seat 6: the_wickstar (big blind) folded before Flop
Seat 7: dymarko folded before Flop (didn't bet)
Seat 8: HokageVIP folded before Flop (didn't bet)
Seat 9: gizmondouk folded before Flop (didn't bet)


*********** # 110 **************
PokerStars Hand #169940459285:  Hold'em No Limit ($0.01/$0.02 USD) - 20=
17/05/05 0:42:51 CUST [2017/05/04 10:42:51 ET]
Table 'Idomeneus' 9-max Seat #6 is the button
Seat 1: apodive ($2 in chips)=20
Seat 2: Geyko.K ($5.30 in chips)=20
Seat 3: greezex ($3 in chips)=20
Seat 4: fomik33 ($2 in chips)=20
Seat 5: the_wickstar ($1.10 in chips)=20
Seat 6: dymarko ($2 in chips)=20
Seat 8: MalyshkinAle ($2.70 in chips)=20
Seat 9: JekaPoyniak ($2.02 in chips)=20
MalyshkinAle: posts small blind $0.01
JekaPoyniak: posts big blind $0.02
*** HOLE CARDS ***
Dealt to the_wickstar [9d 9c]
apodive: folds=20
Geyko.K: folds=20
greezex: folds=20
fomik33: folds=20
the_wickstar: calls $0.02
dymarko: folds=20
MalyshkinAle: calls $0.01
JekaPoyniak: checks=20
*** FLOP *** [Ks Td 8d]
MalyshkinAle: bets $0.03
JekaPoyniak: folds=20
the_wickstar: calls $0.03
*** TURN *** [Ks Td 8d] [5c]
MalyshkinAle: bets $0.06
the_wickstar: folds=20
Uncalled bet ($0.06) returned to MalyshkinAle
MalyshkinAle collected $0.12 from pot
MalyshkinAle: doesn't show hand=20
*** SUMMARY ***
Total pot $0.12 | Rake $0=20
Board [Ks Td 8d 5c]
Seat 1: apodive folded before Flop (didn't bet)
Seat 2: Geyko.K folded before Flop (didn't bet)
Seat 3: greezex folded before Flop (didn't bet)
Seat 4: fomik33 folded before Flop (didn't bet)
Seat 5: the_wickstar folded on the Turn
Seat 6: dymarko (button) folded before Flop (didn't bet)
Seat 8: MalyshkinAle (small blind) collected ($0.12)
Seat 9: JekaPoyniak (big blind) folded on the Flop


*********** # 111 **************
PokerStars Hand #169940447145:  Hold'em No Limit ($0.01/$0.02 USD) - 20=
17/05/05 0:42:32 CUST [2017/05/04 10:42:32 ET]
Table 'Benetnash' 9-max Seat #2 is the button
Seat 1: KoXa8319 ($2.20 in chips)=20
Seat 2: Ainur M ($1.65 in chips)=20
Seat 3: wolf.ukr ($2.65 in chips)=20
Seat 4: AliceX6 ($2.12 in chips)=20
Seat 5: Krol165 ($1.56 in chips)=20
Seat 6: the_wickstar ($1.85 in chips)=20
Seat 7: dymarko ($2.01 in chips)=20
Seat 8: HokageVIP ($2 in chips)=20
Seat 9: gizmondouk ($2.91 in chips)=20
wolf.ukr: posts small blind $0.01
AliceX6: posts big blind $0.02
*** HOLE CARDS ***
Dealt to the_wickstar [Kd 9h]
Krol165: folds=20
the_wickstar: folds=20
dymarko: folds=20
HokageVIP: folds=20
gizmondouk: folds=20
KoXa8319: folds=20
Ainur M: folds=20
wolf.ukr: folds=20
Uncalled bet ($0.01) returned to AliceX6
AliceX6 collected $0.02 from pot
AliceX6: doesn't show hand=20
*** SUMMARY ***
Total pot $0.02 | Rake $0=20
Seat 1: KoXa8319 folded before Flop (didn't bet)
Seat 2: Ainur M (button) folded before Flop (didn't bet)
Seat 3: wolf.ukr (small blind) folded before Flop
Seat 4: AliceX6 (big blind) collected ($0.02)
Seat 5: Krol165 folded before Flop (didn't bet)
Seat 6: the_wickstar folded before Flop (didn't bet)
Seat 7: dymarko folded before Flop (didn't bet)
Seat 8: HokageVIP folded before Flop (didn't bet)
Seat 9: gizmondouk folded before Flop (didn't bet)


*********** # 112 **************
PokerStars Hand #169940439603:  Hold'em No Limit ($0.01/$0.02 USD) - 20=
17/05/05 0:42:20 CUST [2017/05/04 10:42:20 ET]
Table 'Idomeneus' 9-max Seat #5 is the button
Seat 1: apodive ($2 in chips)=20
Seat 2: Geyko.K ($5.30 in chips)=20
Seat 3: greezex ($3 in chips)=20
Seat 4: fomik33 ($2 in chips)=20
Seat 5: the_wickstar ($1.07 in chips)=20
Seat 6: dymarko ($2.01 in chips)=20
Seat 8: MalyshkinAle ($2.72 in chips)=20
Seat 9: JekaPoyniak ($2.02 in chips)=20
dymarko: posts small blind $0.01
toxizo was removed from the table for failing to post
MalyshkinAle: posts big blind $0.02
*** HOLE CARDS ***
Dealt to the_wickstar [7d Kd]
JekaPoyniak: folds=20
apodive: folds=20
Geyko.K: folds=20
greezex: folds=20
fomik33: folds=20
gn4444 joins the table at seat #7=20
gn4444 leaves the table
the_wickstar: calls $0.02
dymarko: folds=20
MalyshkinAle: checks=20
*** FLOP *** [Kc 7s Jd]
MalyshkinAle: checks=20
the_wickstar: bets $0.02
MalyshkinAle: folds=20
Uncalled bet ($0.02) returned to the_wickstar
the_wickstar collected $0.05 from pot
*** SUMMARY ***
Total pot $0.05 | Rake $0=20
Board [Kc 7s Jd]
Seat 1: apodive folded before Flop (didn't bet)
Seat 2: Geyko.K folded before Flop (didn't bet)
Seat 3: greezex folded before Flop (didn't bet)
Seat 4: fomik33 folded before Flop (didn't bet)
Seat 5: the_wickstar (button) collected ($0.05)
Seat 6: dymarko (small blind) folded before Flop
Seat 8: MalyshkinAle (big blind) folded on the Flop
Seat 9: JekaPoyniak folded before Flop (didn't bet)


*********** # 113 **************
PokerStars Hand #169940417361:  Hold'em No Limit ($0.01/$0.02 USD) - 20=
17/05/05 0:41:46 CUST [2017/05/04 10:41:46 ET]
Table 'Idomeneus' 9-max Seat #4 is the button
Seat 1: apodive ($2 in chips)=20
Seat 2: Geyko.K ($5.30 in chips)=20
Seat 3: greezex ($3 in chips)=20
Seat 4: fomik33 ($2 in chips)=20
Seat 5: the_wickstar ($1.08 in chips)=20
Seat 6: dymarko ($2 in chips)=20
Seat 8: MalyshkinAle ($2.72 in chips)=20
Seat 9: JekaPoyniak ($2.02 in chips)=20
the_wickstar: posts small blind $0.01
dymarko: posts big blind $0.02
*** HOLE CARDS ***
Dealt to the_wickstar [7h 6d]
MalyshkinAle: folds=20
JekaPoyniak: folds=20
apodive: folds=20
Geyko.K: folds=20
greezex: folds=20
fomik33: folds=20
the_wickstar: folds=20
Uncalled bet ($0.01) returned to dymarko
dymarko collected $0.02 from pot
dymarko: doesn't show hand=20
*** SUMMARY ***
Total pot $0.02 | Rake $0=20
Seat 1: apodive folded before Flop (didn't bet)
Seat 2: Geyko.K folded before Flop (didn't bet)
Seat 3: greezex folded before Flop (didn't bet)
Seat 4: fomik33 (button) folded before Flop (didn't bet)
Seat 5: the_wickstar (small blind) folded before Flop
Seat 6: dymarko (big blind) collected ($0.02)
Seat 8: MalyshkinAle folded before Flop (didn't bet)
Seat 9: JekaPoyniak folded before Flop (didn't bet)


*********** # 114 **************
PokerStars Hand #169940398186:  Hold'em No Limit ($0.01/$0.02 USD) - 20=
17/05/05 0:41:16 CUST [2017/05/04 10:41:16 ET]
Table 'Idomeneus' 9-max Seat #3 is the button
Seat 1: apodive ($2 in chips)=20
Seat 2: Geyko.K ($5.34 in chips)=20
Seat 3: greezex ($2.93 in chips)=20
Seat 4: fomik33 ($2.01 in chips)=20
Seat 5: the_wickstar ($1.10 in chips)=20
Seat 6: dymarko ($2 in chips)=20
Seat 8: MalyshkinAle ($2.72 in chips)=20
Seat 9: JekaPoyniak ($2.02 in chips)=20
fomik33: posts small blind $0.01
the_wickstar: posts big blind $0.02
*** HOLE CARDS ***
Dealt to the_wickstar [2s Jc]
dymarko: folds=20
MalyshkinAle: folds=20
JekaPoyniak: folds=20
apodive: folds=20
Geyko.K: raises $0.02 to $0.04
greezex: raises $0.16 to $0.20
fomik33: folds=20
the_wickstar: folds=20
Geyko.K: folds=20
Uncalled bet ($0.16) returned to greezex
greezex collected $0.11 from pot
greezex: doesn't show hand=20
*** SUMMARY ***
Total pot $0.11 | Rake $0=20
Seat 1: apodive folded before Flop (didn't bet)
Seat 2: Geyko.K folded before Flop
Seat 3: greezex (button) collected ($0.11)
Seat 4: fomik33 (small blind) folded before Flop
Seat 5: the_wickstar (big blind) folded before Flop
Seat 6: dymarko folded before Flop (didn't bet)
Seat 8: MalyshkinAle folded before Flop (didn't bet)
Seat 9: JekaPoyniak folded before Flop (didn't bet)


*********** # 115 **************
PokerStars Hand #169940374558:  Hold'em No Limit ($0.01/$0.02 USD) - 20=
17/05/05 0:40:40 CUST [2017/05/04 10:40:40 ET]
Table 'Benetnash' 9-max Seat #1 is the button
Seat 1: KoXa8319 ($2.20 in chips)=20
Seat 2: Ainur M ($1.66 in chips)=20
Seat 3: wolf.ukr ($2.67 in chips)=20
Seat 4: AliceX6 ($2.12 in chips)=20
Seat 5: Krol165 ($1.56 in chips)=20
Seat 6: the_wickstar ($1.80 in chips)=20
Seat 7: dymarko ($2.03 in chips)=20
Seat 8: HokageVIP ($2 in chips)=20
Seat 9: gizmondouk ($2.91 in chips)=20
Ainur M: posts small blind $0.01
wolf.ukr: posts big blind $0.02
*** HOLE CARDS ***
Dealt to the_wickstar [6d Ah]
AliceX6: folds=20
Krol165: folds=20
the_wickstar: calls $0.02
dymarko: calls $0.02
HokageVIP: folds=20
gizmondouk: folds=20
KoXa8319: folds=20
Ainur M: folds=20
wolf.ukr: checks=20
*** FLOP *** [6h 4h 9d]
wolf.ukr: checks=20
the_wickstar: checks=20
dymarko: checks=20
*** TURN *** [6h 4h 9d] [5h]
wolf.ukr: checks=20
the_wickstar: checks=20
dymarko: checks=20
*** RIVER *** [6h 4h 9d 5h] [2h]
wolf.ukr: checks=20
the_wickstar: bets $0.02
dymarko: folds=20
wolf.ukr: folds=20
Uncalled bet ($0.02) returned to the_wickstar
the_wickstar collected $0.07 from pot
*** SUMMARY ***
Total pot $0.07 | Rake $0=20
Board [6h 4h 9d 5h 2h]
Seat 1: KoXa8319 (button) folded before Flop (didn't bet)
Seat 2: Ainur M (small blind) folded before Flop
Seat 3: wolf.ukr (big blind) folded on the River
Seat 4: AliceX6 folded before Flop (didn't bet)
Seat 5: Krol165 folded before Flop (didn't bet)
Seat 6: the_wickstar collected ($0.07)
Seat 7: dymarko folded on the River
Seat 8: HokageVIP folded before Flop (didn't bet)
Seat 9: gizmondouk folded before Flop (didn't bet)


*********** # 116 **************
PokerStars Hand #169940354011:  Hold'em No Limit ($0.01/$0.02 USD) - 20=
17/05/05 0:40:08 CUST [2017/05/04 10:40:08 ET]
Table 'Benetnash' 9-max Seat #9 is the button
Seat 1: KoXa8319 ($2.18 in chips)=20
Seat 2: Ainur M ($1.68 in chips)=20
Seat 3: wolf.ukr ($2.67 in chips)=20
Seat 4: AliceX6 ($2.12 in chips)=20
Seat 5: Krol165 ($1.56 in chips)=20
Seat 6: the_wickstar ($1.80 in chips)=20
Seat 7: dymarko ($2.03 in chips)=20
Seat 8: HokageVIP ($2 in chips)=20
Seat 9: gizmondouk ($2.91 in chips)=20
KoXa8319: posts small blind $0.01
Ainur M: posts big blind $0.02
*** HOLE CARDS ***
Dealt to the_wickstar [2d 4h]
wolf.ukr: folds=20
AliceX6: folds=20
Krol165: folds=20
the_wickstar: folds=20
dymarko: folds=20
HokageVIP: folds=20
gizmondouk: folds=20
KoXa8319: raises $0.06 to $0.08
Ainur M: folds=20
Uncalled bet ($0.06) returned to KoXa8319
KoXa8319 collected $0.04 from pot
KoXa8319: doesn't show hand=20
*** SUMMARY ***
Total pot $0.04 | Rake $0=20
Seat 1: KoXa8319 (small blind) collected ($0.04)
Seat 2: Ainur M (big blind) folded before Flop
Seat 3: wolf.ukr folded before Flop (didn't bet)
Seat 4: AliceX6 folded before Flop (didn't bet)
Seat 5: Krol165 folded before Flop (didn't bet)
Seat 6: the_wickstar folded before Flop (didn't bet)
Seat 7: dymarko folded before Flop (didn't bet)
Seat 8: HokageVIP folded before Flop (didn't bet)
Seat 9: gizmondouk (button) folded before Flop (didn't bet)


*********** # 117 **************
PokerStars Hand #169940320022:  Hold'em No Limit ($0.01/$0.02 USD) - 20=
17/05/05 0:39:14 CUST [2017/05/04 10:39:14 ET]
Table 'Idomeneus' 9-max Seat #1 is the button
Seat 1: apodive ($2 in chips)=20
Seat 2: Geyko.K ($5.29 in chips)=20
Seat 3: greezex ($2.07 in chips)=20
Seat 4: fomik33 ($2.03 in chips)=20
Seat 5: the_wickstar ($0.96 in chips)=20
Seat 6: dymarko ($2 in chips)=20
Seat 8: MalyshkinAle ($2.72 in chips)=20
Seat 9: JekaPoyniak ($2.02 in chips)=20
Geyko.K: posts small blind $0.01
greezex: posts big blind $0.02
*** HOLE CARDS ***
Dealt to the_wickstar [9s 9c]
fomik33: folds=20
the_wickstar: calls $0.02
dymarko: folds=20
MalyshkinAle: folds=20
JekaPoyniak: folds=20
apodive: folds=20
Geyko.K: folds=20
greezex: checks=20
*** FLOP *** [5c 6d 3c]
greezex: bets $0.05
the_wickstar: calls $0.05
*** TURN *** [5c 6d 3c] [Td]
greezex: bets $0.14
the_wickstar: calls $0.14
*** RIVER *** [5c 6d 3c Td] [Qh]
greezex: bets $1.86 and is all-in
the_wickstar: calls $0.75 and is all-in
Uncalled bet ($1.11) returned to greezex
*** SHOW DOWN ***
greezex: shows [4h 2s] (a straight, Deuce to Six)
the_wickstar: shows [9s 9c] (a pair of Nines)
greezex collected $1.86 from pot
*** SUMMARY ***
Total pot $1.93 | Rake $0.07=20
Board [5c 6d 3c Td Qh]
Seat 1: apodive (button) folded before Flop (didn't bet)
Seat 2: Geyko.K (small blind) folded before Flop
Seat 3: greezex (big blind) showed [4h 2s] and won ($1.86) with a strai=
ght, Deuce to Six
Seat 4: fomik33 folded before Flop (didn't bet)
Seat 5: the_wickstar showed [9s 9c] and lost with a pair of Nines
Seat 6: dymarko folded before Flop (didn't bet)
Seat 8: MalyshkinAle folded before Flop (didn't bet)
Seat 9: JekaPoyniak folded before Flop (didn't bet)


*********** # 118 **************
PokerStars Hand #169940302305:  Hold'em No Limit ($0.01/$0.02 USD) - 20=
17/05/05 0:38:47 CUST [2017/05/04 10:38:47 ET]
Table 'Benetnash' 9-max Seat #8 is the button
Seat 1: KoXa8319 ($2.24 in chips)=20
Seat 2: Ainur M ($1.68 in chips)=20
Seat 3: wolf.ukr ($2.67 in chips)=20
Seat 4: AliceX6 ($2 in chips)=20
Seat 5: Krol165 ($1.56 in chips)=20
Seat 6: the_wickstar ($1.80 in chips)=20
Seat 7: dymarko ($2.03 in chips)=20
Seat 8: HokageVIP ($2 in chips)=20
Seat 9: gizmondouk ($2.92 in chips)=20
gizmondouk: posts small blind $0.01
KoXa8319: posts big blind $0.02
*** HOLE CARDS ***
Dealt to the_wickstar [Tc 2d]
Ainur M: folds=20
wolf.ukr: folds=20
AliceX6: raises $0.04 to $0.06
Krol165: folds=20
the_wickstar: folds=20
dymarko: folds=20
HokageVIP: calls $0.06
gizmondouk: folds=20
KoXa8319: calls $0.04
*** FLOP *** [5c 3h 3c]
KoXa8319: checks=20
AliceX6: checks=20
HokageVIP: checks=20
*** TURN *** [5c 3h 3c] [9c]
KoXa8319: checks=20
AliceX6: checks=20
HokageVIP: checks=20
*** RIVER *** [5c 3h 3c 9c] [Kc]
KoXa8319: checks=20
AliceX6: bets $0.09
HokageVIP: folds=20
KoXa8319: folds=20
Uncalled bet ($0.09) returned to AliceX6
AliceX6 collected $0.18 from pot
AliceX6: doesn't show hand=20
*** SUMMARY ***
Total pot $0.19 | Rake $0.01=20
Board [5c 3h 3c 9c Kc]
Seat 1: KoXa8319 (big blind) folded on the River
Seat 2: Ainur M folded before Flop (didn't bet)
Seat 3: wolf.ukr folded before Flop (didn't bet)
Seat 4: AliceX6 collected ($0.18)
Seat 5: Krol165 folded before Flop (didn't bet)
Seat 6: the_wickstar folded before Flop (didn't bet)
Seat 7: dymarko folded before Flop (didn't bet)
Seat 8: HokageVIP (button) folded on the River
Seat 9: gizmondouk (small blind) folded before Flop


*********** # 119 **************
PokerStars Hand #169940285306:  Hold'em No Limit ($0.01/$0.02 USD) - 20=
17/05/05 0:38:20 CUST [2017/05/04 10:38:20 ET]
Table 'Idomeneus' 9-max Seat #9 is the button
Seat 1: apodive ($2 in chips)=20
Seat 2: Geyko.K ($5.28 in chips)=20
Seat 3: greezex ($2.07 in chips)=20
Seat 4: fomik33 ($2.03 in chips)=20
Seat 5: the_wickstar ($0.96 in chips)=20
Seat 6: dymarko ($2 in chips)=20
Seat 8: MalyshkinAle ($2.72 in chips)=20
Seat 9: JekaPoyniak ($2.02 in chips)=20
apodive: posts small blind $0.01
Geyko.K: posts big blind $0.02
*** HOLE CARDS ***
Dealt to the_wickstar [6s 9s]
greezex: folds=20
fomik33: folds=20
the_wickstar: folds=20
dymarko: folds=20
MalyshkinAle: folds=20
JekaPoyniak: folds=20
apodive: folds=20
Uncalled bet ($0.01) returned to Geyko.K
Geyko.K collected $0.02 from pot
Geyko.K: doesn't show hand=20
*** SUMMARY ***
Total pot $0.02 | Rake $0=20
Seat 1: apodive (small blind) folded before Flop
Seat 2: Geyko.K (big blind) collected ($0.02)
Seat 3: greezex folded before Flop (didn't bet)
Seat 4: fomik33 folded before Flop (didn't bet)
Seat 5: the_wickstar folded before Flop (didn't bet)
Seat 6: dymarko folded before Flop (didn't bet)
Seat 8: MalyshkinAle folded before Flop (didn't bet)
Seat 9: JekaPoyniak (button) folded before Flop (didn't bet)


*********** # 120 **************
PokerStars Hand #169940275111:  Hold'em No Limit ($0.01/$0.02 USD) - 20=
17/05/05 0:38:04 CUST [2017/05/04 10:38:04 ET]
Table 'Benetnash' 9-max Seat #7 is the button
Seat 1: KoXa8319 ($2.24 in chips)=20
Seat 2: Ainur M ($1.68 in chips)=20
Seat 3: wolf.ukr ($2.67 in chips)=20
Seat 4: AliceX6 ($2 in chips)=20
Seat 5: Krol165 ($1.56 in chips)=20
Seat 6: the_wickstar ($1.80 in chips)=20
Seat 7: dymarko ($2 in chips)=20
Seat 8: HokageVIP ($2 in chips)=20
Seat 9: gizmondouk ($2.94 in chips)=20
HokageVIP: posts small blind $0.01
gizmondouk: posts big blind $0.02
*** HOLE CARDS ***
Dealt to the_wickstar [3d 8s]
KoXa8319: folds=20
Ainur M: folds=20
wolf.ukr: folds=20
AliceX6: folds=20
Krol165: folds=20
the_wickstar: folds=20
dymarko: raises $0.04 to $0.06
HokageVIP: folds=20
gizmondouk: folds=20
Uncalled bet ($0.04) returned to dymarko
dymarko collected $0.05 from pot
dymarko: doesn't show hand=20
*** SUMMARY ***
Total pot $0.05 | Rake $0=20
Seat 1: KoXa8319 folded before Flop (didn't bet)
Seat 2: Ainur M folded before Flop (didn't bet)
Seat 3: wolf.ukr folded before Flop (didn't bet)
Seat 4: AliceX6 folded before Flop (didn't bet)
Seat 5: Krol165 folded before Flop (didn't bet)
Seat 6: the_wickstar folded before Flop (didn't bet)
Seat 7: dymarko (button) collected ($0.05)
Seat 8: HokageVIP (small blind) folded before Flop
Seat 9: gizmondouk (big blind) folded before Flop


*********** # 121 **************
PokerStars Hand #169940271375:  Hold'em No Limit ($0.01/$0.02 USD) - 20=
17/05/05 0:37:58 CUST [2017/05/04 10:37:58 ET]
Table 'Idomeneus' 9-max Seat #8 is the button
Seat 1: apodive ($2.02 in chips)=20
Seat 2: Geyko.K ($5.28 in chips)=20
Seat 3: greezex ($2.07 in chips)=20
Seat 4: fomik33 ($2.03 in chips)=20
Seat 5: the_wickstar ($0.96 in chips)=20
Seat 6: dymarko ($2 in chips)=20
Seat 8: MalyshkinAle ($2.72 in chips)=20
Seat 9: JekaPoyniak ($2 in chips)=20
JekaPoyniak: posts small blind $0.01
apodive: posts big blind $0.02
*** HOLE CARDS ***
Dealt to the_wickstar [Qs 6c]
Geyko.K: folds=20
greezex: folds=20
fomik33: folds=20
the_wickstar: folds=20
dymarko: folds=20
MalyshkinAle: folds=20
JekaPoyniak: raises $0.03 to $0.05
apodive: folds=20
Uncalled bet ($0.03) returned to JekaPoyniak
JekaPoyniak collected $0.04 from pot
*** SUMMARY ***
Total pot $0.04 | Rake $0=20
Seat 1: apodive (big blind) folded before Flop
Seat 2: Geyko.K folded before Flop (didn't bet)
Seat 3: greezex folded before Flop (didn't bet)
Seat 4: fomik33 folded before Flop (didn't bet)
Seat 5: the_wickstar folded before Flop (didn't bet)
Seat 6: dymarko folded before Flop (didn't bet)
Seat 8: MalyshkinAle (button) folded before Flop (didn't bet)
Seat 9: JekaPoyniak (small blind) collected ($0.04)


*********** # 122 **************
PokerStars Hand #169940229257:  Hold'em No Limit ($0.01/$0.02 USD) - 20=
17/05/05 0:36:53 CUST [2017/05/04 10:36:53 ET]
Table 'Benetnash' 9-max Seat #6 is the button
Seat 1: KoXa8319 ($2.03 in chips)=20
Seat 2: Ainur M ($1.68 in chips)=20
Seat 3: wolf.ukr ($2.67 in chips)=20
Seat 4: AliceX6 ($2 in chips)=20
Seat 5: Krol165 ($1.56 in chips)=20
Seat 6: the_wickstar ($1.80 in chips)=20
Seat 7: dymarko ($2 in chips)=20
Seat 8: HokageVIP ($2 in chips)=20
Seat 9: gizmondouk ($3.13 in chips)=20
dymarko: posts small blind $0.01
HokageVIP: posts big blind $0.02
*** HOLE CARDS ***
Dealt to the_wickstar [4d 7d]
gizmondouk: raises $0.04 to $0.06
KoXa8319: raises $0.13 to $0.19
Ainur M: folds=20
wolf.ukr: folds=20
AliceX6: folds=20
Krol165: folds=20
the_wickstar: folds=20
dymarko: folds=20
Krol165 said, ";)u r a long way from the 0.50/1$ tables dymarko"
HokageVIP: folds=20
gizmondouk: calls $0.13
*** FLOP *** [3s 2s Js]
gizmondouk: checks=20
KoXa8319: checks=20
*** TURN *** [3s 2s Js] [4s]
gizmondouk: checks=20
KoXa8319: checks=20
*** RIVER *** [3s 2s Js 4s] [Ah]
gizmondouk: checks=20
KoXa8319: checks=20
*** SHOW DOWN ***
gizmondouk: shows [9h 9d] (a pair of Nines)
KoXa8319: shows [Ac Kh] (a pair of Aces)
KoXa8319 collected $0.40 from pot
*** SUMMARY ***
Total pot $0.41 | Rake $0.01=20
Board [3s 2s Js 4s Ah]
Seat 1: KoXa8319 showed [Ac Kh] and won ($0.40) with a pair of Aces
Seat 2: Ainur M folded before Flop (didn't bet)
Seat 3: wolf.ukr folded before Flop (didn't bet)
Seat 4: AliceX6 folded before Flop (didn't bet)
Seat 5: Krol165 folded before Flop (didn't bet)
Seat 6: the_wickstar (button) folded before Flop (didn't bet)
Seat 7: dymarko (small blind) folded before Flop
Seat 8: HokageVIP (big blind) folded before Flop
Seat 9: gizmondouk showed [9h 9d] and lost with a pair of Nines


*********** # 123 **************
PokerStars Hand #169940220819:  Hold'em No Limit ($0.01/$0.02 USD) - 20=
17/05/05 0:36:40 CUST [2017/05/04 10:36:40 ET]
Table 'Idomeneus' 9-max Seat #6 is the button
Seat 1: apodive ($2.02 in chips)=20
Seat 2: Geyko.K ($5.28 in chips)=20
Seat 3: greezex ($2.07 in chips)=20
Seat 4: fomik33 ($2 in chips)=20
Seat 5: the_wickstar ($0.96 in chips)=20
Seat 6: dymarko ($2 in chips)=20
Seat 8: MalyshkinAle ($2.73 in chips)=20
Seat 9: JekaPoyniak ($2 in chips)=20
MalyshkinAle: posts small blind $0.01
JekaPoyniak: posts big blind $0.02
*** HOLE CARDS ***
Dealt to the_wickstar [5s Qd]
apodive: folds=20
Geyko.K: folds=20
greezex: folds=20
fomik33: calls $0.02
the_wickstar: folds=20
dymarko: folds=20
MalyshkinAle: folds=20
JekaPoyniak: checks=20
*** FLOP *** [3s Kc 9s]
JekaPoyniak: checks=20
fomik33: bets $0.05
JekaPoyniak: folds=20
Uncalled bet ($0.05) returned to fomik33
fomik33 collected $0.05 from pot
fomik33: doesn't show hand=20
*** SUMMARY ***
Total pot $0.05 | Rake $0=20
Board [3s Kc 9s]
Seat 1: apodive folded before Flop (didn't bet)
Seat 2: Geyko.K folded before Flop (didn't bet)
Seat 3: greezex folded before Flop (didn't bet)
Seat 4: fomik33 collected ($0.05)
Seat 5: the_wickstar folded before Flop (didn't bet)
Seat 6: dymarko (button) folded before Flop (didn't bet)
Seat 8: MalyshkinAle (small blind) folded before Flop
Seat 9: JekaPoyniak (big blind) folded on the Flop


*********** # 124 **************
PokerStars Hand #169940209019:  Hold'em No Limit ($0.01/$0.02 USD) - 20=
17/05/05 0:36:22 CUST [2017/05/04 10:36:22 ET]
Table 'Benetnash' 9-max Seat #5 is the button
Seat 1: KoXa8319 ($2 in chips)=20
Seat 2: Ainur M ($1.68 in chips)=20
Seat 3: wolf.ukr ($2.67 in chips)=20
Seat 4: AliceX6 ($2 in chips)=20
Seat 5: Krol165 ($1.56 in chips)=20
Seat 6: the_wickstar ($1.81 in chips)=20
Seat 7: dymarko ($2 in chips)=20
Seat 8: HokageVIP ($2 in chips)=20
Seat 9: gizmondouk ($3.13 in chips)=20
the_wickstar: posts small blind $0.01
dymarko: posts big blind $0.02
*** HOLE CARDS ***
Dealt to the_wickstar [3d 5h]
HokageVIP: folds=20
gizmondouk: folds=20
KoXa8319: raises $0.06 to $0.08
Ainur M: folds=20
wolf.ukr: folds=20
AliceX6: folds=20
Krol165: folds=20
the_wickstar: folds=20
dymarko: folds=20
Uncalled bet ($0.06) returned to KoXa8319
KoXa8319 collected $0.05 from pot
KoXa8319: doesn't show hand=20
*** SUMMARY ***
Total pot $0.05 | Rake $0=20
Seat 1: KoXa8319 collected ($0.05)
Seat 2: Ainur M folded before Flop (didn't bet)
Seat 3: wolf.ukr folded before Flop (didn't bet)
Seat 4: AliceX6 folded before Flop (didn't bet)
Seat 5: Krol165 (button) folded before Flop (didn't bet)
Seat 6: the_wickstar (small blind) folded before Flop
Seat 7: dymarko (big blind) folded before Flop
Seat 8: HokageVIP folded before Flop (didn't bet)
Seat 9: gizmondouk folded before Flop (didn't bet)


*********** # 125 **************
PokerStars Hand #169940176929:  Hold'em No Limit ($0.01/$0.02 USD) - 20=
17/05/05 0:35:31 CUST [2017/05/04 10:35:31 ET]
Table 'Idomeneus' 9-max Seat #5 is the button
Seat 1: apodive ($2.02 in chips)=20
Seat 2: Geyko.K ($5.30 in chips)=20
Seat 3: greezex ($2.07 in chips)=20
Seat 4: fomik33 ($2 in chips)=20
Seat 5: the_wickstar ($0.96 in chips)=20
Seat 6: dymarko ($2 in chips)=20
Seat 8: MalyshkinAle ($2.70 in chips)=20
Seat 9: JekaPoyniak ($2 in chips)=20
dymarko: posts small blind $0.01
MalyshkinAle: posts big blind $0.02
*** HOLE CARDS ***
Dealt to the_wickstar [9s 6s]
JekaPoyniak: folds=20
apodive: folds=20
Geyko.K: calls $0.02
greezex: folds=20
fomik33 has timed out
fomik33: folds=20
the_wickstar: folds=20
dymarko: folds=20
MalyshkinAle: raises $0.06 to $0.08
Geyko.K: folds=20
Uncalled bet ($0.06) returned to MalyshkinAle
MalyshkinAle collected $0.05 from pot
MalyshkinAle: doesn't show hand=20
*** SUMMARY ***
Total pot $0.05 | Rake $0=20
Seat 1: apodive folded before Flop (didn't bet)
Seat 2: Geyko.K folded before Flop
Seat 3: greezex folded before Flop (didn't bet)
Seat 4: fomik33 folded before Flop (didn't bet)
Seat 5: the_wickstar (button) folded before Flop (didn't bet)
Seat 6: dymarko (small blind) folded before Flop
Seat 8: MalyshkinAle (big blind) collected ($0.05)
Seat 9: JekaPoyniak folded before Flop (didn't bet)


*********** # 126 **************
PokerStars Hand #169940173858:  Hold'em No Limit ($0.01/$0.02 USD) - 20=
17/05/05 0:35:27 CUST [2017/05/04 10:35:27 ET]
Table 'Benetnash' 9-max Seat #4 is the button
Seat 1: KoXa8319 ($2 in chips)=20
Seat 2: Ainur M ($1.68 in chips)=20
Seat 3: wolf.ukr ($2.67 in chips)=20
Seat 4: AliceX6 ($2 in chips)=20
Seat 5: Krol165 ($1.46 in chips)=20
Seat 6: the_wickstar ($1.83 in chips)=20
Seat 7: dymarko ($2.09 in chips)=20
Seat 8: HokageVIP ($2 in chips)=20
Seat 9: gizmondouk ($3.13 in chips)=20
Krol165: posts small blind $0.01
the_wickstar: posts big blind $0.02
*** HOLE CARDS ***
Dealt to the_wickstar [7d 5s]
dymarko: raises $0.02 to $0.04
HokageVIP: folds=20
gizmondouk: folds=20
KoXa8319: folds=20
Ainur M: folds=20
wolf.ukr: folds=20
AliceX6: folds=20
Krol165: calls $0.03
the_wickstar: folds=20
*** FLOP *** [4c Kd 4s]
Krol165: checks=20
dymarko: bets $0.05
Krol165: raises $0.09 to $0.14
dymarko: folds=20
Uncalled bet ($0.09) returned to Krol165
Krol165 collected $0.19 from pot
Krol165: doesn't show hand=20
*** SUMMARY ***
Total pot $0.20 | Rake $0.01=20
Board [4c Kd 4s]
Seat 1: KoXa8319 folded before Flop (didn't bet)
Seat 2: Ainur M folded before Flop (didn't bet)
Seat 3: wolf.ukr folded before Flop (didn't bet)
Seat 4: AliceX6 (button) folded before Flop (didn't bet)
Seat 5: Krol165 (small blind) collected ($0.19)
Seat 6: the_wickstar (big blind) folded before Flop
Seat 7: dymarko folded on the Flop
Seat 8: HokageVIP folded before Flop (didn't bet)
Seat 9: gizmondouk folded before Flop (didn't bet)


*********** # 127 **************
PokerStars Hand #169940154416:  Hold'em No Limit ($0.01/$0.02 USD) - 20=
17/05/05 0:34:56 CUST [2017/05/04 10:34:56 ET]
Table 'Benetnash' 9-max Seat #3 is the button
Seat 1: KoXa8319 ($2 in chips)=20
Seat 2: Ainur M ($1.68 in chips)=20
Seat 3: wolf.ukr ($2.67 in chips)=20
Seat 4: AliceX6 ($2.01 in chips)=20
Seat 5: Krol165 ($1.45 in chips)=20
Seat 6: the_wickstar ($1.83 in chips)=20
Seat 7: dymarko ($2.09 in chips)=20
Seat 8: HokageVIP ($2 in chips)=20
Seat 9: gizmondouk ($3.13 in chips)=20
AliceX6: posts small blind $0.01
Krol165: posts big blind $0.02
*** HOLE CARDS ***
Dealt to the_wickstar [8h 6d]
the_wickstar: folds=20
dymarko: folds=20
HokageVIP: folds=20
gizmondouk: folds=20
KoXa8319: folds=20
Ainur M: folds=20
wolf.ukr: folds=20
AliceX6: folds=20
Uncalled bet ($0.01) returned to Krol165
Krol165 collected $0.02 from pot
Krol165: doesn't show hand=20
*** SUMMARY ***
Total pot $0.02 | Rake $0=20
Seat 1: KoXa8319 folded before Flop (didn't bet)
Seat 2: Ainur M folded before Flop (didn't bet)
Seat 3: wolf.ukr (button) folded before Flop (didn't bet)
Seat 4: AliceX6 (small blind) folded before Flop
Seat 5: Krol165 (big blind) collected ($0.02)
Seat 6: the_wickstar folded before Flop (didn't bet)
Seat 7: dymarko folded before Flop (didn't bet)
Seat 8: HokageVIP folded before Flop (didn't bet)
Seat 9: gizmondouk folded before Flop (didn't bet)


*********** # 128 **************
PokerStars Hand #169940151402:  Hold'em No Limit ($0.01/$0.02 USD) - 20=
17/05/05 0:34:51 CUST [2017/05/04 10:34:51 ET]
Table 'Idomeneus' 9-max Seat #4 is the button
Seat 1: apodive ($2.02 in chips)=20
Seat 2: Geyko.K ($5.30 in chips)=20
Seat 3: greezex ($2.07 in chips)=20
Seat 4: fomik33 ($2 in chips)=20
Seat 5: the_wickstar ($0.97 in chips)=20
Seat 6: dymarko ($2 in chips)=20
Seat 8: MalyshkinAle ($2.67 in chips)=20
Seat 9: JekaPoyniak ($2 in chips)=20
the_wickstar: posts small blind $0.01
dymarko: posts big blind $0.02
*** HOLE CARDS ***
Dealt to the_wickstar [Ks 5d]
MalyshkinAle: raises $0.04 to $0.06
JekaPoyniak: folds=20
apodive: folds=20
Geyko.K: folds=20
greezex: folds=20
fomik33: folds=20
the_wickstar: folds=20
dymarko: folds=20
Uncalled bet ($0.04) returned to MalyshkinAle
MalyshkinAle collected $0.05 from pot
MalyshkinAle: doesn't show hand=20
*** SUMMARY ***
Total pot $0.05 | Rake $0=20
Seat 1: apodive folded before Flop (didn't bet)
Seat 2: Geyko.K folded before Flop (didn't bet)
Seat 3: greezex folded before Flop (didn't bet)
Seat 4: fomik33 (button) folded before Flop (didn't bet)
Seat 5: the_wickstar (small blind) folded before Flop
Seat 6: dymarko (big blind) folded before Flop
Seat 8: MalyshkinAle collected ($0.05)
Seat 9: JekaPoyniak folded before Flop (didn't bet)


*********** # 129 **************
PokerStars Hand #169940134005:  Hold'em No Limit ($0.01/$0.02 USD) - 20=
17/05/05 0:34:24 CUST [2017/05/04 10:34:24 ET]
Table 'Benetnash' 9-max Seat #2 is the button
Seat 1: KoXa8319 ($2 in chips)=20
Seat 2: Ainur M ($1.68 in chips)=20
Seat 3: wolf.ukr ($2.68 in chips)=20
Seat 4: AliceX6 ($2.03 in chips)=20
Seat 5: Krol165 ($1.45 in chips)=20
Seat 6: the_wickstar ($1.83 in chips)=20
Seat 7: dymarko ($2.06 in chips)=20
Seat 8: HokageVIP ($2 in chips)=20
Seat 9: gizmondouk ($3.13 in chips)=20
wolf.ukr: posts small blind $0.01
AliceX6: posts big blind $0.02
*** HOLE CARDS ***
Dealt to the_wickstar [2d 9d]
Krol165: folds=20
the_wickstar: folds=20
dymarko: raises $0.02 to $0.04
HokageVIP: folds=20
gizmondouk: folds=20
KoXa8319: folds=20
Ainur M: folds=20
wolf.ukr: folds=20
AliceX6: folds=20
Uncalled bet ($0.02) returned to dymarko
dymarko collected $0.05 from pot
dymarko: doesn't show hand=20
*** SUMMARY ***
Total pot $0.05 | Rake $0=20
Seat 1: KoXa8319 folded before Flop (didn't bet)
Seat 2: Ainur M (button) folded before Flop (didn't bet)
Seat 3: wolf.ukr (small blind) folded before Flop
Seat 4: AliceX6 (big blind) folded before Flop
Seat 5: Krol165 folded before Flop (didn't bet)
Seat 6: the_wickstar folded before Flop (didn't bet)
Seat 7: dymarko collected ($0.05)
Seat 8: HokageVIP folded before Flop (didn't bet)
Seat 9: gizmondouk folded before Flop (didn't bet)


*********** # 130 **************
PokerStars Hand #169940122920:  Hold'em No Limit ($0.01/$0.02 USD) - 20=
17/05/05 0:34:07 CUST [2017/05/04 10:34:07 ET]
Table 'Idomeneus' 9-max Seat #3 is the button
Seat 1: apodive ($2.02 in chips)=20
Seat 2: Geyko.K ($5.30 in chips)=20
Seat 3: greezex ($2 in chips)=20
Seat 4: fomik33 ($2 in chips)=20
Seat 5: the_wickstar ($1.03 in chips)=20
Seat 6: dymarko ($2 in chips)=20
Seat 8: MalyshkinAle ($2.67 in chips)=20
Seat 9: JekaPoyniak ($2 in chips)=20
fomik33: posts small blind $0.01
the_wickstar: posts big blind $0.02
*** HOLE CARDS ***
Dealt to the_wickstar [4h 4d]
dymarko: folds=20
MalyshkinAle: folds=20
JekaPoyniak: folds=20
apodive: folds=20
Geyko.K: folds=20
greezex: raises $0.04 to $0.06
fomik33: folds=20
the_wickstar: calls $0.04
*** FLOP *** [8s 7s 3c]
the_wickstar: checks=20
greezex: bets $0.10
the_wickstar: folds=20
Uncalled bet ($0.10) returned to greezex
greezex collected $0.13 from pot
greezex: doesn't show hand=20
*** SUMMARY ***
Total pot $0.13 | Rake $0=20
Board [8s 7s 3c]
Seat 1: apodive folded before Flop (didn't bet)
Seat 2: Geyko.K folded before Flop (didn't bet)
Seat 3: greezex (button) collected ($0.13)
Seat 4: fomik33 (small blind) folded before Flop
Seat 5: the_wickstar (big blind) folded on the Flop
Seat 6: dymarko folded before Flop (didn't bet)
Seat 8: MalyshkinAle folded before Flop (didn't bet)
Seat 9: JekaPoyniak folded before Flop (didn't bet)


*********** # 131 **************
PokerStars Hand #169940109085:  Hold'em No Limit ($0.01/$0.02 USD) - 20=
17/05/05 0:33:45 CUST [2017/05/04 10:33:45 ET]
Table 'Benetnash' 9-max Seat #1 is the button
Seat 1: KoXa8319 ($2 in chips)=20
Seat 2: Ainur M ($1.69 in chips)=20
Seat 3: wolf.ukr ($2.70 in chips)=20
Seat 4: AliceX6 ($2.03 in chips)=20
Seat 5: Krol165 ($1.45 in chips)=20
Seat 6: the_wickstar ($1.80 in chips)=20
Seat 7: dymarko ($2.06 in chips)=20
Seat 8: HokageVIP ($2 in chips)=20
Seat 9: gizmondouk ($3.13 in chips)=20
Ainur M: posts small blind $0.01
wolf.ukr: posts big blind $0.02
*** HOLE CARDS ***
Dealt to the_wickstar [8d 8s]
AliceX6: folds=20
Krol165: folds=20
the_wickstar: raises $0.02 to $0.04
dymarko: folds=20
HokageVIP: folds=20
gizmondouk: folds=20
KoXa8319: folds=20
Ainur M: folds=20
wolf.ukr: folds=20
Uncalled bet ($0.02) returned to the_wickstar
the_wickstar collected $0.05 from pot
*** SUMMARY ***
Total pot $0.05 | Rake $0=20
Seat 1: KoXa8319 (button) folded before Flop (didn't bet)
Seat 2: Ainur M (small blind) folded before Flop
Seat 3: wolf.ukr (big blind) folded before Flop
Seat 4: AliceX6 folded before Flop (didn't bet)
Seat 5: Krol165 folded before Flop (didn't bet)
Seat 6: the_wickstar collected ($0.05)
Seat 7: dymarko folded before Flop (didn't bet)
Seat 8: HokageVIP folded before Flop (didn't bet)
Seat 9: gizmondouk folded before Flop (didn't bet)


*********** # 132 **************
PokerStars Hand #169940081871:  Hold'em No Limit ($0.01/$0.02 USD) - 20=
17/05/05 0:33:02 CUST [2017/05/04 10:33:02 ET]
Table 'Benetnash' 9-max Seat #9 is the button
Seat 1: KoXa8319 ($2 in chips)=20
Seat 2: Ainur M ($1.71 in chips)=20
Seat 3: wolf.ukr ($2.70 in chips)=20
Seat 4: AliceX6 ($2.03 in chips)=20
Seat 5: Krol165 ($1.45 in chips)=20
Seat 6: the_wickstar ($1.80 in chips)=20
Seat 7: dymarko ($2.03 in chips)=20
Seat 8: HokageVIP ($2 in chips)=20
Seat 9: gizmondouk ($3.13 in chips)=20
KoXa8319: posts small blind $0.01
Ainur M: posts big blind $0.02
*** HOLE CARDS ***
Dealt to the_wickstar [5h 3c]
wolf.ukr: folds=20
AliceX6: folds=20
Krol165: folds=20
the_wickstar: folds=20
dymarko: raises $0.02 to $0.04
HokageVIP: folds=20
gizmondouk: folds=20
KoXa8319: folds=20
Ainur M: folds=20
Uncalled bet ($0.02) returned to dymarko
dymarko collected $0.05 from pot
dymarko: doesn't show hand=20
*** SUMMARY ***
Total pot $0.05 | Rake $0=20
Seat 1: KoXa8319 (small blind) folded before Flop
Seat 2: Ainur M (big blind) folded before Flop
Seat 3: wolf.ukr folded before Flop (didn't bet)
Seat 4: AliceX6 folded before Flop (didn't bet)
Seat 5: Krol165 folded before Flop (didn't bet)
Seat 6: the_wickstar folded before Flop (didn't bet)
Seat 7: dymarko collected ($0.05)
Seat 8: HokageVIP folded before Flop (didn't bet)
Seat 9: gizmondouk (button) folded before Flop (didn't bet)


*********** # 133 **************
PokerStars Hand #169940079124:  Hold'em No Limit ($0.01/$0.02 USD) - 20=
17/05/05 0:32:58 CUST [2017/05/04 10:32:58 ET]
Table 'Idomeneus' 9-max Seat #2 is the button
Seat 1: apodive ($2.02 in chips)=20
Seat 2: Geyko.K ($5.30 in chips)=20
Seat 3: greezex ($2 in chips)=20
Seat 4: fomik33 ($2 in chips)=20
Seat 5: the_wickstar ($1.03 in chips)=20
Seat 6: dymarko ($2 in chips)=20
Seat 8: MalyshkinAle ($2.51 in chips)=20
Seat 9: JekaPoyniak ($2 in chips)=20
greezex: posts small blind $0.01
fomik33: posts big blind $0.02
*** HOLE CARDS ***
Dealt to the_wickstar [5c 9h]
the_wickstar: folds=20
dymarko: folds=20
MalyshkinAle: raises $0.04 to $0.06
JekaPoyniak: folds=20
apodive: folds=20
Geyko.K: folds=20
greezex: folds=20
fomik33: calls $0.04
*** FLOP *** [Qs 6c Ah]
fomik33: checks=20
MalyshkinAle: bets $0.10
fomik33: calls $0.10
*** TURN *** [Qs 6c Ah] [Ts]
fomik33: checks=20
MalyshkinAle: bets $0.16
fomik33: folds=20
Uncalled bet ($0.16) returned to MalyshkinAle
MalyshkinAle collected $0.32 from pot
MalyshkinAle: doesn't show hand=20
*** SUMMARY ***
Total pot $0.33 | Rake $0.01=20
Board [Qs 6c Ah Ts]
Seat 1: apodive folded before Flop (didn't bet)
Seat 2: Geyko.K (button) folded before Flop (didn't bet)
Seat 3: greezex (small blind) folded before Flop
Seat 4: fomik33 (big blind) folded on the Turn
Seat 5: the_wickstar folded before Flop (didn't bet)
Seat 6: dymarko folded before Flop (didn't bet)
Seat 8: MalyshkinAle collected ($0.32)
Seat 9: JekaPoyniak folded before Flop (didn't bet)


*********** # 134 **************
PokerStars Hand #169940056684:  Hold'em No Limit ($0.01/$0.02 USD) - 20=
17/05/05 0:32:23 CUST [2017/05/04 10:32:23 ET]
Table 'Benetnash' 9-max Seat #8 is the button
Seat 1: KoXa8319 ($2 in chips)=20
Seat 2: Ainur M ($1.71 in chips)=20
Seat 3: wolf.ukr ($2.70 in chips)=20
Seat 4: AliceX6 ($2.03 in chips)=20
Seat 5: Krol165 ($1.45 in chips)=20
Seat 6: the_wickstar ($1.80 in chips)=20
Seat 7: dymarko ($2.03 in chips)=20
Seat 8: HokageVIP ($2 in chips)=20
Seat 9: gizmondouk ($3.11 in chips)=20
gizmondouk: posts small blind $0.01
KoXa8319: posts big blind $0.02
*** HOLE CARDS ***
Dealt to the_wickstar [3s Ks]
Ainur M: folds=20
wolf.ukr: folds=20
AliceX6: folds=20
Krol165: folds=20
the_wickstar: folds=20
dymarko: folds=20
HokageVIP: folds=20
gizmondouk: raises $0.04 to $0.06
KoXa8319: folds=20
Uncalled bet ($0.04) returned to gizmondouk
gizmondouk collected $0.04 from pot
gizmondouk: doesn't show hand=20
*** SUMMARY ***
Total pot $0.04 | Rake $0=20
Seat 1: KoXa8319 (big blind) folded before Flop
Seat 2: Ainur M folded before Flop (didn't bet)
Seat 3: wolf.ukr folded before Flop (didn't bet)
Seat 4: AliceX6 folded before Flop (didn't bet)
Seat 5: Krol165 folded before Flop (didn't bet)
Seat 6: the_wickstar folded before Flop (didn't bet)
Seat 7: dymarko folded before Flop (didn't bet)
Seat 8: HokageVIP (button) folded before Flop (didn't bet)
Seat 9: gizmondouk (small blind) collected ($0.04)


*********** # 135 **************
PokerStars Hand #169940038712:  Hold'em No Limit ($0.01/$0.02 USD) - 20=
17/05/05 0:31:55 CUST [2017/05/04 10:31:55 ET]
Table 'Benetnash' 9-max Seat #7 is the button
Seat 2: Ainur M ($1.71 in chips)=20
Seat 3: wolf.ukr ($2.70 in chips)=20
Seat 4: AliceX6 ($2.03 in chips)=20
Seat 5: Krol165 ($1.45 in chips)=20
Seat 6: the_wickstar ($1.80 in chips)=20
Seat 7: dymarko ($2 in chips)=20
Seat 8: HokageVIP ($2 in chips)=20
Seat 9: gizmondouk ($3.13 in chips)=20
HokageVIP: posts small blind $0.01
gizmondouk: posts big blind $0.02
KoXa8319: sits out=20
*** HOLE CARDS ***
Dealt to the_wickstar [4h 5c]
Ainur M: folds=20
wolf.ukr: folds=20
AliceX6: folds=20
Krol165: folds=20
the_wickstar: folds=20
dymarko: raises $0.02 to $0.04
HokageVIP: folds=20
gizmondouk: folds=20
Uncalled bet ($0.02) returned to dymarko
dymarko collected $0.05 from pot
dymarko: doesn't show hand=20
*** SUMMARY ***
Total pot $0.05 | Rake $0=20
Seat 2: Ainur M folded before Flop (didn't bet)
Seat 3: wolf.ukr folded before Flop (didn't bet)
Seat 4: AliceX6 folded before Flop (didn't bet)
Seat 5: Krol165 folded before Flop (didn't bet)
Seat 6: the_wickstar folded before Flop (didn't bet)
Seat 7: dymarko (button) collected ($0.05)
Seat 8: HokageVIP (small blind) folded before Flop
Seat 9: gizmondouk (big blind) folded before Flop


*********** # 136 **************
PokerStars Hand #169940026577:  Hold'em No Limit ($0.01/$0.02 USD) - 20=
17/05/05 0:31:36 CUST [2017/05/04 10:31:36 ET]
Table 'Idomeneus' 9-max Seat #1 is the button
Seat 1: apodive ($2.02 in chips)=20
Seat 2: Geyko.K ($2.94 in chips)=20
Seat 3: greezex ($2.45 in chips)=20
Seat 4: fomik33 ($2 in chips)=20
Seat 5: the_wickstar ($1.03 in chips)=20
Seat 6: dymarko ($2 in chips)=20
Seat 8: MalyshkinAle ($2.51 in chips)=20
Seat 9: JekaPoyniak ($2 in chips)=20
Geyko.K: posts small blind $0.01
greezex: posts big blind $0.02
*** HOLE CARDS ***
Dealt to the_wickstar [Ts 2h]
fomik33: folds=20
the_wickstar: folds=20
dymarko: folds=20
MalyshkinAle: folds=20
JekaPoyniak: raises $0.06 to $0.08
apodive: folds=20
Geyko.K: calls $0.07
greezex: raises $0.24 to $0.32
JekaPoyniak: folds=20
Geyko.K: raises $0.24 to $0.56
greezex: calls $0.24
*** FLOP *** [Jd 4d Tc]
Geyko.K: bets $0.44
greezex: raises $1.45 to $1.89 and is all-in
Geyko.K: calls $1.45
*** TURN *** [Jd 4d Tc] [7s]
*** RIVER *** [Jd 4d Tc 7s] [9s]
*** SHOW DOWN ***
Geyko.K: shows [Ad Ac] (a pair of Aces)
greezex: shows [Kd 5h] (high card King)
Geyko.K collected $4.81 from pot
*** SUMMARY ***
Total pot $4.98 | Rake $0.17=20
Board [Jd 4d Tc 7s 9s]
Seat 1: apodive (button) folded before Flop (didn't bet)
Seat 2: Geyko.K (small blind) showed [Ad Ac] and won ($4.81) with a pai=
r of Aces
Seat 3: greezex (big blind) showed [Kd 5h] and lost with high card King
Seat 4: fomik33 folded before Flop (didn't bet)
Seat 5: the_wickstar folded before Flop (didn't bet)
Seat 6: dymarko folded before Flop (didn't bet)
Seat 8: MalyshkinAle folded before Flop (didn't bet)
Seat 9: JekaPoyniak folded before Flop


*********** # 137 **************
PokerStars Hand #169940022015:  Hold'em No Limit ($0.01/$0.02 USD) - 20=
17/05/05 0:31:29 CUST [2017/05/04 10:31:29 ET]
Table 'Benetnash' 9-max Seat #6 is the button
Seat 2: Ainur M ($1.71 in chips)=20
Seat 3: wolf.ukr ($2.70 in chips)=20
Seat 4: AliceX6 ($2 in chips)=20
Seat 5: Krol165 ($1.45 in chips)=20
Seat 6: the_wickstar ($1.80 in chips)=20
Seat 7: dymarko ($2 in chips)=20
Seat 8: HokageVIP ($2 in chips)=20
Seat 9: gizmondouk ($3.13 in chips)=20
dymarko: posts small blind $0.01
HokageVIP: posts big blind $0.02
KoXa8319: sits out=20
*** HOLE CARDS ***
Dealt to the_wickstar [3d 8d]
gizmondouk: folds=20
Ainur M: folds=20
wolf.ukr: folds=20
AliceX6: raises $0.04 to $0.06
Krol165: folds=20
the_wickstar: folds=20
dymarko: folds=20
HokageVIP: folds=20
Uncalled bet ($0.04) returned to AliceX6
AliceX6 collected $0.05 from pot
AliceX6: doesn't show hand=20
*** SUMMARY ***
Total pot $0.05 | Rake $0=20
Seat 2: Ainur M folded before Flop (didn't bet)
Seat 3: wolf.ukr folded before Flop (didn't bet)
Seat 4: AliceX6 collected ($0.05)
Seat 5: Krol165 folded before Flop (didn't bet)
Seat 6: the_wickstar (button) folded before Flop (didn't bet)
Seat 7: dymarko (small blind) folded before Flop
Seat 8: HokageVIP (big blind) folded before Flop
Seat 9: gizmondouk folded before Flop (didn't bet)


*********** # 138 **************
PokerStars Hand #169939998780:  Hold'em No Limit ($0.01/$0.02 USD) - 20=
17/05/05 0:30:53 CUST [2017/05/04 10:30:53 ET]
Table 'Idomeneus' 9-max Seat #9 is the button
Seat 1: apodive ($2 in chips)=20
Seat 2: Geyko.K ($2.96 in chips)=20
Seat 3: greezex ($2.45 in chips)=20
Seat 4: fomik33 ($2 in chips)=20
Seat 5: the_wickstar ($1.03 in chips)=20
Seat 6: dymarko ($2 in chips)=20
Seat 8: MalyshkinAle ($2.51 in chips)=20
Seat 9: JekaPoyniak ($2 in chips)=20
apodive: posts small blind $0.01
Geyko.K: posts big blind $0.02
*** HOLE CARDS ***
Dealt to the_wickstar [2d 6h]
greezex: folds=20
fomik33: folds=20
the_wickstar: folds=20
dymarko: folds=20
MalyshkinAle: folds=20
JekaPoyniak: folds=20
apodive: raises $0.03 to $0.05
Geyko.K: folds=20
Uncalled bet ($0.03) returned to apodive
apodive collected $0.04 from pot
apodive: doesn't show hand=20
*** SUMMARY ***
Total pot $0.04 | Rake $0=20
Seat 1: apodive (small blind) collected ($0.04)
Seat 2: Geyko.K (big blind) folded before Flop
Seat 3: greezex folded before Flop (didn't bet)
Seat 4: fomik33 folded before Flop (didn't bet)
Seat 5: the_wickstar folded before Flop (didn't bet)
Seat 6: dymarko folded before Flop (didn't bet)
Seat 8: MalyshkinAle folded before Flop (didn't bet)
Seat 9: JekaPoyniak (button) folded before Flop (didn't bet)


*********** # 139 **************
PokerStars Hand #169939990554:  Hold'em No Limit ($0.01/$0.02 USD) - 20=
17/05/05 0:30:40 CUST [2017/05/04 10:30:40 ET]
Table 'Benetnash' 9-max Seat #5 is the button
Seat 2: Ainur M ($1.14 in chips)=20
Seat 3: wolf.ukr ($2.70 in chips)=20
Seat 4: AliceX6 ($2.26 in chips)=20
Seat 5: Krol165 ($1.45 in chips)=20
Seat 6: the_wickstar ($1.81 in chips)=20
Seat 7: dymarko ($2 in chips)=20
Seat 8: HokageVIP ($2.05 in chips)=20
Seat 9: gizmondouk ($3.13 in chips)=20
the_wickstar: posts small blind $0.01
dymarko: posts big blind $0.02
KoXa8319: sits out=20
*** HOLE CARDS ***
Dealt to the_wickstar [9s 6s]
HokageVIP: raises $0.04 to $0.06
gizmondouk: folds=20
Ainur M: calls $0.06
wolf.ukr: folds=20
AliceX6: raises $0.16 to $0.22
Krol165: folds=20
the_wickstar: folds=20
dymarko: folds=20
HokageVIP: folds=20
Ainur M: calls $0.16
*** FLOP *** [2c Ad Ah]
Ainur M: checks=20
AliceX6: bets $0.30
Ainur M: raises $0.62 to $0.92 and is all-in
AliceX6: folds=20
Uncalled bet ($0.62) returned to Ainur M
Ainur M collected $1.09 from pot
Ainur M: doesn't show hand=20
*** SUMMARY ***
Total pot $1.13 | Rake $0.04=20
Board [2c Ad Ah]
Seat 2: Ainur M collected ($1.09)
Seat 3: wolf.ukr folded before Flop (didn't bet)
Seat 4: AliceX6 folded on the Flop
Seat 5: Krol165 (button) folded before Flop (didn't bet)
Seat 6: the_wickstar (small blind) folded before Flop
Seat 7: dymarko (big blind) folded before Flop
Seat 8: HokageVIP folded before Flop
Seat 9: gizmondouk folded before Flop (didn't bet)


*********** # 140 **************
PokerStars Hand #169939981483:  Hold'em No Limit ($0.01/$0.02 USD) - 20=
17/05/05 0:30:26 CUST [2017/05/04 10:30:26 ET]
Table 'Idomeneus' 9-max Seat #8 is the button
Seat 1: apodive ($2 in chips)=20
Seat 2: Geyko.K ($2.96 in chips)=20
Seat 3: greezex ($2.42 in chips)=20
Seat 4: fomik33 ($2 in chips)=20
Seat 5: the_wickstar ($1.03 in chips)=20
Seat 6: dymarko ($2 in chips)=20
Seat 8: MalyshkinAle ($2.51 in chips)=20
Seat 9: JekaPoyniak ($2.01 in chips)=20
JekaPoyniak: posts small blind $0.01
apodive: posts big blind $0.02
*** HOLE CARDS ***
Dealt to the_wickstar [Jc 2s]
Geyko.K: folds=20
greezex: raises $0.06 to $0.08
fomik33: folds=20
the_wickstar: folds=20
dymarko: folds=20
MalyshkinAle: folds=20
JekaPoyniak: folds=20
apodive: folds=20
Uncalled bet ($0.06) returned to greezex
greezex collected $0.05 from pot
greezex: doesn't show hand=20
*** SUMMARY ***
Total pot $0.05 | Rake $0=20
Seat 1: apodive (big blind) folded before Flop
Seat 2: Geyko.K folded before Flop (didn't bet)
Seat 3: greezex collected ($0.05)
Seat 4: fomik33 folded before Flop (didn't bet)
Seat 5: the_wickstar folded before Flop (didn't bet)
Seat 6: dymarko folded before Flop (didn't bet)
Seat 8: MalyshkinAle (button) folded before Flop (didn't bet)
Seat 9: JekaPoyniak (small blind) folded before Flop


*********** # 141 **************
PokerStars Hand #169939977808:  Hold'em No Limit ($0.01/$0.02 USD) - 20=
17/05/05 0:30:21 CUST [2017/05/04 10:30:21 ET]
Table 'Benetnash' 9-max Seat #4 is the button
Seat 2: Ainur M ($1.14 in chips)=20
Seat 3: wolf.ukr ($2.67 in chips)=20
Seat 4: AliceX6 ($2.26 in chips)=20
Seat 5: Krol165 ($1.46 in chips)=20
Seat 6: the_wickstar ($1.83 in chips)=20
Seat 8: HokageVIP ($2.05 in chips)=20
Seat 9: gizmondouk ($3.13 in chips)=20
Krol165: posts small blind $0.01
the_wickstar: posts big blind $0.02
dymarko: sits out=20
KoXa8319: sits out=20
*** HOLE CARDS ***
Dealt to the_wickstar [Qs 7c]
HokageVIP: folds=20
gizmondouk: folds=20
Ainur M: folds=20
wolf.ukr: raises $0.04 to $0.06
AliceX6: folds=20
Krol165: folds=20
the_wickstar: folds=20
Uncalled bet ($0.04) returned to wolf.ukr
wolf.ukr collected $0.05 from pot
*** SUMMARY ***
Total pot $0.05 | Rake $0=20
Seat 2: Ainur M folded before Flop (didn't bet)
Seat 3: wolf.ukr collected ($0.05)
Seat 4: AliceX6 (button) folded before Flop (didn't bet)
Seat 5: Krol165 (small blind) folded before Flop
Seat 6: the_wickstar (big blind) folded before Flop
Seat 8: HokageVIP folded before Flop (didn't bet)
Seat 9: gizmondouk folded before Flop (didn't bet)


*********** # 142 **************
PokerStars Hand #169939960380:  Hold'em No Limit ($0.01/$0.02 USD) - 20=
17/05/05 0:29:53 CUST [2017/05/04 10:29:53 ET]
Table 'Idomeneus' 9-max Seat #6 is the button
Seat 2: Geyko.K ($2.96 in chips)=20
Seat 3: greezex ($2.42 in chips)=20
Seat 4: fomik33 ($2 in chips)=20
Seat 5: the_wickstar ($1 in chips)=20
Seat 6: dymarko ($2 in chips)=20
Seat 8: MalyshkinAle ($2.52 in chips)=20
Seat 9: JekaPoyniak ($2.03 in chips)=20
MalyshkinAle: posts small blind $0.01
JekaPoyniak: posts big blind $0.02
apodive: sits out=20
*** HOLE CARDS ***
Dealt to the_wickstar [As Qs]
Geyko.K: folds=20
greezex: folds=20
fomik33: folds=20
the_wickstar: raises $0.04 to $0.06
dymarko: folds=20
MalyshkinAle: folds=20
JekaPoyniak: folds=20
Uncalled bet ($0.04) returned to the_wickstar
the_wickstar collected $0.05 from pot
*** SUMMARY ***
Total pot $0.05 | Rake $0=20
Seat 2: Geyko.K folded before Flop (didn't bet)
Seat 3: greezex folded before Flop (didn't bet)
Seat 4: fomik33 folded before Flop (didn't bet)
Seat 5: the_wickstar collected ($0.05)
Seat 6: dymarko (button) folded before Flop (didn't bet)
Seat 8: MalyshkinAle (small blind) folded before Flop
Seat 9: JekaPoyniak (big blind) folded before Flop


*********** # 143 **************
PokerStars Hand #169939943535:  Hold'em No Limit ($0.01/$0.02 USD) - 20=
17/05/05 0:29:27 CUST [2017/05/04 10:29:27 ET]
Table 'Benetnash' 9-max Seat #3 is the button
Seat 2: Ainur M ($1.14 in chips)=20
Seat 3: wolf.ukr ($2.67 in chips)=20
Seat 4: AliceX6 ($2 in chips)=20
Seat 5: Krol165 ($1.74 in chips)=20
Seat 6: the_wickstar ($1.83 in chips)=20
Seat 8: HokageVIP ($2.05 in chips)=20
Seat 9: gizmondouk ($3.13 in chips)=20
AliceX6: posts small blind $0.01
Krol165: posts big blind $0.02
dymarko: sits out=20
KoXa8319: sits out=20
*** HOLE CARDS ***
Dealt to the_wickstar [8c 5h]
the_wickstar: folds=20
HokageVIP: folds=20
gizmondouk: folds=20
Ainur M: folds=20
wolf.ukr: folds=20
AliceX6: raises $0.04 to $0.06
Krol165: calls $0.04
*** FLOP *** [8h Kd 7h]
AliceX6: bets $0.08
Krol165: calls $0.08
*** TURN *** [8h Kd 7h] [6h]
AliceX6: bets $0.14
Krol165: calls $0.14
*** RIVER *** [8h Kd 7h 6h] [Qc]
AliceX6: checks=20
Krol165: checks=20
*** SHOW DOWN ***
AliceX6: shows [Ac Ah] (a pair of Aces)
Krol165: mucks hand=20
AliceX6 collected $0.54 from pot
*** SUMMARY ***
Total pot $0.56 | Rake $0.02=20
Board [8h Kd 7h 6h Qc]
Seat 2: Ainur M folded before Flop (didn't bet)
Seat 3: wolf.ukr (button) folded before Flop (didn't bet)
Seat 4: AliceX6 (small blind) showed [Ac Ah] and won ($0.54) with a pai=
r of Aces
Seat 5: Krol165 (big blind) mucked [Ad Th]
Seat 6: the_wickstar folded before Flop (didn't bet)
Seat 8: HokageVIP folded before Flop (didn't bet)
Seat 9: gizmondouk folded before Flop (didn't bet)


*********** # 144 **************
PokerStars Hand #169939938507:  Hold'em No Limit ($0.01/$0.02 USD) - 20=
17/05/05 0:29:20 CUST [2017/05/04 10:29:20 ET]
Table 'Idomeneus' 9-max Seat #5 is the button
Seat 2: Geyko.K ($2.96 in chips)=20
Seat 3: greezex ($2.42 in chips)=20
Seat 4: fomik33 ($2 in chips)=20
Seat 5: the_wickstar ($0.97 in chips)=20
Seat 6: dymarko ($2.01 in chips)=20
Seat 8: MalyshkinAle ($2.54 in chips)=20
Seat 9: JekaPoyniak ($2.03 in chips)=20
dymarko: posts small blind $0.01
MalyshkinAle: posts big blind $0.02
apodive: sits out=20
*** HOLE CARDS ***
Dealt to the_wickstar [Ac 5c]
JekaPoyniak: folds=20
Geyko.K: folds=20
greezex: folds=20
fomik33: folds=20
the_wickstar: calls $0.02
dymarko: folds=20
MalyshkinAle: checks=20
*** FLOP *** [2h Ks Qs]
MalyshkinAle: checks=20
the_wickstar: bets $0.03
MalyshkinAle: folds=20
Uncalled bet ($0.03) returned to the_wickstar
the_wickstar collected $0.05 from pot
*** SUMMARY ***
Total pot $0.05 | Rake $0=20
Board [2h Ks Qs]
Seat 2: Geyko.K folded before Flop (didn't bet)
Seat 3: greezex folded before Flop (didn't bet)
Seat 4: fomik33 folded before Flop (didn't bet)
Seat 5: the_wickstar (button) collected ($0.05)
Seat 6: dymarko (small blind) folded before Flop
Seat 8: MalyshkinAle (big blind) folded on the Flop
Seat 9: JekaPoyniak folded before Flop (didn't bet)


*********** # 145 **************
PokerStars Hand #169939921052:  Hold'em No Limit ($0.01/$0.02 USD) - 20=
17/05/05 0:28:52 CUST [2017/05/04 10:28:52 ET]
Table 'Benetnash' 9-max Seat #2 is the button
Seat 2: Ainur M ($1.14 in chips)=20
Seat 3: wolf.ukr ($2.68 in chips)=20
Seat 4: AliceX6 ($2 in chips)=20
Seat 5: Krol165 ($1.74 in chips)=20
Seat 6: the_wickstar ($1.85 in chips)=20
Seat 8: HokageVIP ($2.05 in chips)=20
Seat 9: gizmondouk ($3.08 in chips)=20
wolf.ukr: posts small blind $0.01
AliceX6: posts big blind $0.02
dymarko: sits out=20
KoXa8319: sits out=20
*** HOLE CARDS ***
Dealt to the_wickstar [2h As]
Krol165: folds=20
the_wickstar: calls $0.02
HokageVIP: folds=20
gizmondouk: raises $0.06 to $0.08
Ainur M: folds=20
wolf.ukr: folds=20
AliceX6: folds=20
the_wickstar: folds=20
Uncalled bet ($0.06) returned to gizmondouk
gizmondouk collected $0.07 from pot
gizmondouk: doesn't show hand=20
*** SUMMARY ***
Total pot $0.07 | Rake $0=20
Seat 2: Ainur M (button) folded before Flop (didn't bet)
Seat 3: wolf.ukr (small blind) folded before Flop
Seat 4: AliceX6 (big blind) folded before Flop
Seat 5: Krol165 folded before Flop (didn't bet)
Seat 6: the_wickstar folded before Flop
Seat 8: HokageVIP folded before Flop (didn't bet)
Seat 9: gizmondouk collected ($0.07)


*********** # 146 **************
PokerStars Hand #169939906840:  Hold'em No Limit ($0.01/$0.02 USD) - 20=
17/05/05 0:28:30 CUST [2017/05/04 10:28:30 ET]
Table 'Benetnash' 9-max Seat #9 is the button
Seat 2: Ainur M ($1.15 in chips)=20
Seat 3: wolf.ukr ($2.67 in chips)=20
Seat 4: AliceX6 ($2 in chips)=20
Seat 5: Krol165 ($1.74 in chips)=20
Seat 6: the_wickstar ($1.85 in chips)=20
Seat 8: HokageVIP ($2.05 in chips)=20
Seat 9: gizmondouk ($3.08 in chips)=20
KoXa8319 will be allowed to play after the button
Ainur M: posts small blind $0.01
wolf.ukr: posts big blind $0.02
dymarko: sits out=20
*** HOLE CARDS ***
Dealt to the_wickstar [7d 8s]
AliceX6: folds=20
Krol165: folds=20
the_wickstar: folds=20
HokageVIP: folds=20
gizmondouk: folds=20
Ainur M: folds=20
Uncalled bet ($0.01) returned to wolf.ukr
wolf.ukr collected $0.02 from pot
*** SUMMARY ***
Total pot $0.02 | Rake $0=20
Seat 2: Ainur M (small blind) folded before Flop
Seat 3: wolf.ukr (big blind) collected ($0.02)
Seat 4: AliceX6 folded before Flop (didn't bet)
Seat 5: Krol165 folded before Flop (didn't bet)
Seat 6: the_wickstar folded before Flop (didn't bet)
Seat 8: HokageVIP folded before Flop (didn't bet)
Seat 9: gizmondouk (button) folded before Flop (didn't bet)


*********** # 147 **************
PokerStars Hand #169939901761:  Hold'em No Limit ($0.01/$0.02 USD) - 20=
17/05/05 0:28:22 CUST [2017/05/04 10:28:22 ET]
Table 'Idomeneus' 9-max Seat #4 is the button
Seat 2: Geyko.K ($2.96 in chips)=20
Seat 3: greezex ($2.42 in chips)=20
Seat 4: fomik33 ($2 in chips)=20
Seat 5: the_wickstar ($0.98 in chips)=20
Seat 6: dymarko ($2 in chips)=20
Seat 8: MalyshkinAle ($2.54 in chips)=20
Seat 9: JekaPoyniak ($2.03 in chips)=20
the_wickstar: posts small blind $0.01
dymarko: posts big blind $0.02
apodive: sits out=20
*** HOLE CARDS ***
Dealt to the_wickstar [3c 9d]
MalyshkinAle: folds=20
JekaPoyniak: folds=20
Geyko.K: folds=20
greezex: folds=20
fomik33: folds=20
the_wickstar: folds=20
Uncalled bet ($0.01) returned to dymarko
dymarko collected $0.02 from pot
dymarko: doesn't show hand=20
*** SUMMARY ***
Total pot $0.02 | Rake $0=20
Seat 2: Geyko.K folded before Flop (didn't bet)
Seat 3: greezex folded before Flop (didn't bet)
Seat 4: fomik33 (button) folded before Flop (didn't bet)
Seat 5: the_wickstar (small blind) folded before Flop
Seat 6: dymarko (big blind) collected ($0.02)
Seat 8: MalyshkinAle folded before Flop (didn't bet)
Seat 9: JekaPoyniak folded before Flop (didn't bet)


*********** # 148 **************
PokerStars Hand #169939893328:  Hold'em No Limit ($0.01/$0.02 USD) - 20=
17/05/05 0:28:09 CUST [2017/05/04 10:28:09 ET]
Table 'Benetnash' 9-max Seat #8 is the button
Seat 2: Ainur M ($1.17 in chips)=20
Seat 3: wolf.ukr ($2.67 in chips)=20
Seat 4: AliceX6 ($2 in chips)=20
Seat 5: Krol165 ($1.74 in chips)=20
Seat 6: the_wickstar ($1.82 in chips)=20
Seat 8: HokageVIP ($2.05 in chips)=20
Seat 9: gizmondouk ($3.09 in chips)=20
gizmondouk: posts small blind $0.01
Ainur M: posts big blind $0.02
dymarko: sits out=20
*** HOLE CARDS ***
Dealt to the_wickstar [7s Qh]
wolf.ukr: folds=20
AliceX6: folds=20
Krol165: folds=20
the_wickstar: raises $0.02 to $0.04
HokageVIP: folds=20
gizmondouk: folds=20
Ainur M: folds=20
Uncalled bet ($0.02) returned to the_wickstar
the_wickstar collected $0.05 from pot
*** SUMMARY ***
Total pot $0.05 | Rake $0=20
Seat 2: Ainur M (big blind) folded before Flop
Seat 3: wolf.ukr folded before Flop (didn't bet)
Seat 4: AliceX6 folded before Flop (didn't bet)
Seat 5: Krol165 folded before Flop (didn't bet)
Seat 6: the_wickstar collected ($0.05)
Seat 8: HokageVIP (button) folded before Flop (didn't bet)
Seat 9: gizmondouk (small blind) folded before Flop


*********** # 149 **************
PokerStars Hand #169939878355:  Hold'em No Limit ($0.01/$0.02 USD) - 20=
17/05/05 0:27:46 CUST [2017/05/04 10:27:46 ET]
Table 'Idomeneus' 9-max Seat #3 is the button
Seat 2: Geyko.K ($2.96 in chips)=20
Seat 3: greezex ($2.42 in chips)=20
Seat 4: fomik33 ($2 in chips)=20
Seat 5: the_wickstar ($1 in chips)=20
Seat 8: MalyshkinAle ($2.51 in chips)=20
Seat 9: JekaPoyniak ($2.03 in chips)=20
fomik33: posts small blind $0.01
the_wickstar: posts big blind $0.02
dymarko: sits out=20
apodive: sits out=20
*** HOLE CARDS ***
Dealt to the_wickstar [7h 6s]
MalyshkinAle: raises $0.04 to $0.06
JekaPoyniak: folds=20
Geyko.K: folds=20
greezex: folds=20
fomik33: folds=20
the_wickstar: folds=20
Uncalled bet ($0.04) returned to MalyshkinAle
MalyshkinAle collected $0.05 from pot
MalyshkinAle: doesn't show hand=20
*** SUMMARY ***
Total pot $0.05 | Rake $0=20
Seat 2: Geyko.K folded before Flop (didn't bet)
Seat 3: greezex (button) folded before Flop (didn't bet)
Seat 4: fomik33 (small blind) folded before Flop
Seat 5: the_wickstar (big blind) folded before Flop
Seat 8: MalyshkinAle collected ($0.05)
Seat 9: JekaPoyniak folded before Flop (didn't bet)


*********** # 150 **************
PokerStars Hand #169939864441:  Hold'em No Limit ($0.01/$0.02 USD) - 20=
17/05/05 0:27:24 CUST [2017/05/04 10:27:24 ET]
Table 'Benetnash' 9-max Seat #6 is the button
Seat 2: Ainur M ($1.17 in chips)=20
Seat 3: wolf.ukr ($2.67 in chips)=20
Seat 4: AliceX6 ($2 in chips)=20
Seat 5: Krol165 ($1.74 in chips)=20
Seat 6: the_wickstar ($1.82 in chips)=20
Seat 8: HokageVIP ($2.06 in chips)=20
Seat 9: gizmondouk ($3.08 in chips)=20
HokageVIP: posts small blind $0.01
gizmondouk: posts big blind $0.02
*** HOLE CARDS ***
Dealt to the_wickstar [7h 9s]
Ainur M: folds=20
wolf.ukr: folds=20
dymarko joins the table at seat #7=20
AliceX6: folds=20
Krol165: folds=20
the_wickstar: folds=20
HokageVIP: folds=20
Uncalled bet ($0.01) returned to gizmondouk
gizmondouk collected $0.02 from pot
gizmondouk: doesn't show hand=20
*** SUMMARY ***
Total pot $0.02 | Rake $0=20
Seat 2: Ainur M folded before Flop (didn't bet)
Seat 3: wolf.ukr folded before Flop (didn't bet)
Seat 4: AliceX6 folded before Flop (didn't bet)
Seat 5: Krol165 folded before Flop (didn't bet)
Seat 6: the_wickstar (button) folded before Flop (didn't bet)
Seat 8: HokageVIP (small blind) folded before Flop
Seat 9: gizmondouk (big blind) collected ($0.02)


*********** # 151 **************
PokerStars Hand #169939856727:  Hold'em No Limit ($0.01/$0.02 USD) - 20=
17/05/05 0:27:12 CUST [2017/05/04 10:27:12 ET]
Table 'Idomeneus' 9-max Seat #2 is the button
Seat 2: Geyko.K ($2.96 in chips)=20
Seat 3: greezex ($2.43 in chips)=20
Seat 4: fomik33 ($2 in chips)=20
Seat 5: the_wickstar ($1 in chips)=20
Seat 6: baymi ($1.27 in chips)=20
Seat 8: MalyshkinAle ($2.51 in chips)=20
Seat 9: JekaPoyniak ($2 in chips)=20
greezex: posts small blind $0.01
fomik33: posts big blind $0.02
apodive: sits out=20
*** HOLE CARDS ***
Dealt to the_wickstar [Js Ts]
the_wickstar: folds=20
baymi: folds=20
MalyshkinAle: folds=20
baymi leaves the table
dymarko joins the table at seat #6=20
JekaPoyniak: raises $0.06 to $0.08
Geyko.K: folds=20
greezex: folds=20
fomik33: folds=20
Uncalled bet ($0.06) returned to JekaPoyniak
JekaPoyniak collected $0.05 from pot
*** SUMMARY ***
Total pot $0.05 | Rake $0=20
Seat 2: Geyko.K (button) folded before Flop (didn't bet)
Seat 3: greezex (small blind) folded before Flop
Seat 4: fomik33 (big blind) folded before Flop
Seat 5: the_wickstar folded before Flop (didn't bet)
Seat 6: baymi folded before Flop (didn't bet)
Seat 8: MalyshkinAle folded before Flop (didn't bet)
Seat 9: JekaPoyniak collected ($0.05)


*********** # 152 **************
PokerStars Hand #169939836708:  Hold'em No Limit ($0.01/$0.02 USD) - 20=
17/05/05 0:26:41 CUST [2017/05/04 10:26:41 ET]
Table 'Idomeneus' 9-max Seat #9 is the button
Seat 2: Geyko.K ($2.97 in chips)=20
Seat 3: greezex ($2.42 in chips)=20
Seat 4: fomik33 ($2 in chips)=20
Seat 5: the_wickstar ($1 in chips)=20
Seat 6: baymi ($1.27 in chips)=20
Seat 8: MalyshkinAle ($2.51 in chips)=20
Seat 9: JekaPoyniak ($2 in chips)=20
apodive will be allowed to play after the button
Geyko.K: posts small blind $0.01
greezex: posts big blind $0.02
*** HOLE CARDS ***
Dealt to the_wickstar [3c 6s]
fomik33: folds=20
the_wickstar: folds=20
baymi: folds=20
MalyshkinAle: folds=20
JekaPoyniak: folds=20
Geyko.K: folds=20
Uncalled bet ($0.01) returned to greezex
greezex collected $0.02 from pot
greezex: doesn't show hand=20
*** SUMMARY ***
Total pot $0.02 | Rake $0=20
Seat 2: Geyko.K (small blind) folded before Flop
Seat 3: greezex (big blind) collected ($0.02)
Seat 4: fomik33 folded before Flop (didn't bet)
Seat 5: the_wickstar folded before Flop (didn't bet)
Seat 6: baymi folded before Flop (didn't bet)
Seat 8: MalyshkinAle folded before Flop (didn't bet)
Seat 9: JekaPoyniak (button) folded before Flop (didn't bet)


*********** # 153 **************
PokerStars Hand #169939833345:  Hold'em No Limit ($0.01/$0.02 USD) - 20=
17/05/05 0:26:36 CUST [2017/05/04 10:26:36 ET]
Table 'Benetnash' 9-max Seat #5 is the button
Seat 2: Ainur M ($1.17 in chips)=20
Seat 3: wolf.ukr ($2.67 in chips)=20
Seat 4: AliceX6 ($2 in chips)=20
Seat 5: Krol165 ($1.69 in chips)=20
Seat 6: the_wickstar ($1.83 in chips)=20
Seat 7: Donenko345 ($1 in chips)=20
Seat 8: HokageVIP ($2.08 in chips)=20
Seat 9: gizmondouk ($3.08 in chips)=20
the_wickstar: posts small blind $0.01
Donenko345: posts big blind $0.02
*** HOLE CARDS ***
Dealt to the_wickstar [5s 7d]
HokageVIP: calls $0.02
gizmondouk: folds=20
Ainur M: folds=20
wolf.ukr: folds=20
AliceX6: folds=20
Krol165: raises $0.07 to $0.09
the_wickstar: folds=20
Donenko345: folds=20
HokageVIP: folds=20
Uncalled bet ($0.07) returned to Krol165
Donenko345 leaves the table
Krol165 collected $0.07 from pot
Krol165: doesn't show hand=20
*** SUMMARY ***
Total pot $0.07 | Rake $0=20
Seat 2: Ainur M folded before Flop (didn't bet)
Seat 3: wolf.ukr folded before Flop (didn't bet)
Seat 4: AliceX6 folded before Flop (didn't bet)
Seat 5: Krol165 (button) collected ($0.07)
Seat 6: the_wickstar (small blind) folded before Flop
Seat 7: Donenko345 (big blind) folded before Flop
Seat 8: HokageVIP folded before Flop
Seat 9: gizmondouk folded before Flop (didn't bet)


*********** # 154 **************
PokerStars Hand #169939812242:  Hold'em No Limit ($0.01/$0.02 USD) - 20=
17/05/05 0:26:03 CUST [2017/05/04 10:26:03 ET]
Table 'Idomeneus' 9-max Seat #8 is the button
Seat 2: Geyko.K ($2.99 in chips)=20
Seat 3: greezex ($2.42 in chips)=20
Seat 4: fomik33 ($2 in chips)=20
Seat 5: the_wickstar ($1 in chips)=20
Seat 6: baymi ($1.24 in chips)=20
Seat 8: MalyshkinAle ($2.51 in chips)=20
Seat 9: JekaPoyniak ($2 in chips)=20
JekaPoyniak: posts small blind $0.01
Geyko.K: posts big blind $0.02
*** HOLE CARDS ***
Dealt to the_wickstar [9d 3h]
greezex: folds=20
fomik33: folds=20
the_wickstar: folds=20
baymi: raises $0.02 to $0.04
MalyshkinAle: folds=20
JekaPoyniak: folds=20
Geyko.K: folds=20
Uncalled bet ($0.02) returned to baymi
baymi collected $0.05 from pot
*** SUMMARY ***
Total pot $0.05 | Rake $0=20
Seat 2: Geyko.K (big blind) folded before Flop
Seat 3: greezex folded before Flop (didn't bet)
Seat 4: fomik33 folded before Flop (didn't bet)
Seat 5: the_wickstar folded before Flop (didn't bet)
Seat 6: baymi collected ($0.05)
Seat 8: MalyshkinAle (button) folded before Flop (didn't bet)
Seat 9: JekaPoyniak (small blind) folded before Flop


*********** # 155 **************
PokerStars Hand #169939803303:  Hold'em No Limit ($0.01/$0.02 USD) - 20=
17/05/05 0:25:49 CUST [2017/05/04 10:25:49 ET]
Table 'Benetnash' 9-max Seat #4 is the button
Seat 1: KoXa8319 ($2 in chips)=20
Seat 2: Ainur M ($1.17 in chips)=20
Seat 3: wolf.ukr ($2.59 in chips)=20
Seat 4: AliceX6 ($2 in chips)=20
Seat 5: Krol165 ($1.70 in chips)=20
Seat 6: the_wickstar ($1.85 in chips)=20
Seat 7: Donenko345 ($1 in chips)=20
Seat 8: HokageVIP ($2.08 in chips)=20
Seat 9: gizmondouk ($3.08 in chips)=20
Krol165: posts small blind $0.01
the_wickstar: posts big blind $0.02
*** HOLE CARDS ***
Dealt to the_wickstar [2d 7d]
Donenko345: folds=20
HokageVIP: folds=20
gizmondouk: folds=20
KoXa8319: raises $0.04 to $0.06
Ainur M: folds=20
wolf.ukr: calls $0.06
AliceX6: folds=20
Krol165: folds=20
the_wickstar: folds=20
*** FLOP *** [7c 9s 9h]
KoXa8319: checks=20
wolf.ukr: checks=20
*** TURN *** [7c 9s 9h] [Kh]
KoXa8319: checks=20
wolf.ukr: checks=20
*** RIVER *** [7c 9s 9h Kh] [5c]
KoXa8319: checks=20
wolf.ukr: checks=20
*** SHOW DOWN ***
KoXa8319: shows [As Jd] (a pair of Nines)
wolf.ukr: shows [4d 4h] (two pair, Nines and Fours)
wolf.ukr collected $0.14 from pot
*** SUMMARY ***
Total pot $0.15 | Rake $0.01=20
Board [7c 9s 9h Kh 5c]
Seat 1: KoXa8319 showed [As Jd] and lost with a pair of Nines
Seat 2: Ainur M folded before Flop (didn't bet)
Seat 3: wolf.ukr showed [4d 4h] and won ($0.14) with two pair, Nines an=
d Fours
Seat 4: AliceX6 (button) folded before Flop (didn't bet)
Seat 5: Krol165 (small blind) folded before Flop
Seat 6: the_wickstar (big blind) folded before Flop
Seat 7: Donenko345 folded before Flop (didn't bet)
Seat 8: HokageVIP folded before Flop (didn't bet)
Seat 9: gizmondouk folded before Flop (didn't bet)


*********** # 156 **************
PokerStars Hand #169939799633:  Hold'em No Limit ($0.01/$0.02 USD) - 20=
17/05/05 0:25:44 CUST [2017/05/04 10:25:44 ET]
Table 'Idomeneus' 9-max Seat #6 is the button
Seat 2: Geyko.K ($2.99 in chips)=20
Seat 3: greezex ($2.42 in chips)=20
Seat 4: fomik33 ($2 in chips)=20
Seat 5: the_wickstar ($1 in chips)=20
Seat 6: baymi ($1.24 in chips)=20
Seat 8: MalyshkinAle ($2.49 in chips)=20
Seat 9: JekaPoyniak ($2 in chips)=20
MalyshkinAle: posts small blind $0.01
JekaPoyniak: posts big blind $0.02
*** HOLE CARDS ***
Dealt to the_wickstar [8h 9s]
Geyko.K: folds=20
greezex: folds=20
fomik33: folds=20
the_wickstar: folds=20
baymi: folds=20
MalyshkinAle: raises $0.02 to $0.04
JekaPoyniak: folds=20
Uncalled bet ($0.02) returned to MalyshkinAle
MalyshkinAle collected $0.04 from pot
MalyshkinAle: doesn't show hand=20
*** SUMMARY ***
Total pot $0.04 | Rake $0=20
Seat 2: Geyko.K folded before Flop (didn't bet)
Seat 3: greezex folded before Flop (didn't bet)
Seat 4: fomik33 folded before Flop (didn't bet)
Seat 5: the_wickstar folded before Flop (didn't bet)
Seat 6: baymi (button) folded before Flop (didn't bet)
Seat 8: MalyshkinAle (small blind) collected ($0.04)
Seat 9: JekaPoyniak (big blind) folded before Flop


*********** # 157 **************
PokerStars Hand #169939777451:  Hold'em No Limit ($0.01/$0.02 USD) - 20=
17/05/05 0:25:10 CUST [2017/05/04 10:25:10 ET]
Table 'Benetnash' 9-max Seat #3 is the button
Seat 1: KoXa8319 ($2 in chips)=20
Seat 2: Ainur M ($1.17 in chips)=20
Seat 3: wolf.ukr ($2.59 in chips)=20
Seat 4: AliceX6 ($2 in chips)=20
Seat 5: Krol165 ($1.72 in chips)=20
Seat 6: the_wickstar ($1.85 in chips)=20
Seat 7: Donenko345 ($1 in chips)=20
Seat 8: HokageVIP ($2 in chips)=20
Seat 9: gizmondouk ($3.08 in chips)=20
AliceX6: posts small blind $0.01
Krol165: posts big blind $0.02
*** HOLE CARDS ***
Dealt to the_wickstar [8d Th]
the_wickstar: folds=20
Donenko345: folds=20
HokageVIP: raises $0.04 to $0.06
gizmondouk: folds=20
KoXa8319: folds=20
Ainur M: folds=20
wolf.ukr: folds=20
AliceX6: calls $0.05
Krol165: folds=20
*** FLOP *** [Qh Jd 8s]
AliceX6: checks=20
HokageVIP: bets $0.08
AliceX6: folds=20
Uncalled bet ($0.08) returned to HokageVIP
HokageVIP collected $0.14 from pot
HokageVIP: doesn't show hand=20
*** SUMMARY ***
Total pot $0.14 | Rake $0=20
Board [Qh Jd 8s]
Seat 1: KoXa8319 folded before Flop (didn't bet)
Seat 2: Ainur M folded before Flop (didn't bet)
Seat 3: wolf.ukr (button) folded before Flop (didn't bet)
Seat 4: AliceX6 (small blind) folded on the Flop
Seat 5: Krol165 (big blind) folded before Flop
Seat 6: the_wickstar folded before Flop (didn't bet)
Seat 7: Donenko345 folded before Flop (didn't bet)
Seat 8: HokageVIP collected ($0.14)
Seat 9: gizmondouk folded before Flop (didn't bet)


*********** # 158 **************
PokerStars Hand #169939756045:  Hold'em No Limit ($0.01/$0.02 USD) - 20=
17/05/05 0:24:37 CUST [2017/05/04 10:24:37 ET]
Table 'Idomeneus' 9-max Seat #5 is the button
Seat 2: Geyko.K ($2.99 in chips)=20
Seat 3: greezex ($2.42 in chips)=20
Seat 4: fomik33 ($2 in chips)=20
Seat 5: the_wickstar ($1.06 in chips)=20
Seat 6: baymi ($1.25 in chips)=20
Seat 8: MalyshkinAle ($2.41 in chips)=20
Seat 9: JekaPoyniak ($2 in chips)=20
baymi: posts small blind $0.01
MalyshkinAle: posts big blind $0.02
*** HOLE CARDS ***
Dealt to the_wickstar [3d Jh]
JekaPoyniak: folds=20
Geyko.K: folds=20
greezex: folds=20
fomik33: calls $0.02
the_wickstar: calls $0.02
baymi: folds=20
MalyshkinAle: checks=20
*** FLOP *** [3s 9c 9s]
MalyshkinAle: bets $0.04
fomik33: folds=20
the_wickstar: calls $0.04
*** TURN *** [3s 9c 9s] [8c]
MalyshkinAle: checks=20
the_wickstar: checks=20
*** RIVER *** [3s 9c 9s 8c] [7d]
MalyshkinAle: checks=20
the_wickstar: checks=20
*** SHOW DOWN ***
MalyshkinAle: shows [Kh 3c] (two pair, Nines and Threes)
the_wickstar: mucks hand=20
MalyshkinAle collected $0.14 from pot
*** SUMMARY ***
Total pot $0.15 | Rake $0.01=20
Board [3s 9c 9s 8c 7d]
Seat 2: Geyko.K folded before Flop (didn't bet)
Seat 3: greezex folded before Flop (didn't bet)
Seat 4: fomik33 folded on the Flop
Seat 5: the_wickstar (button) mucked [3d Jh]
Seat 6: baymi (small blind) folded before Flop
Seat 8: MalyshkinAle (big blind) showed [Kh 3c] and won ($0.14) with tw=
o pair, Nines and Threes
Seat 9: JekaPoyniak folded before Flop (didn't bet)


*********** # 159 **************
PokerStars Hand #169939726583:  Hold'em No Limit ($0.01/$0.02 USD) - 20=
17/05/05 0:23:52 CUST [2017/05/04 10:23:52 ET]
Table 'Benetnash' 9-max Seat #2 is the button
Seat 1: KoXa8319 ($2 in chips)=20
Seat 2: Ainur M ($1.17 in chips)=20
Seat 3: wolf.ukr ($2.90 in chips)=20
Seat 4: AliceX6 ($2.03 in chips)=20
Seat 5: Krol165 ($1.72 in chips)=20
Seat 6: the_wickstar ($1.50 in chips)=20
Seat 7: Donenko345 ($1 in chips)=20
Seat 8: HokageVIP ($2 in chips)=20
Seat 9: gizmondouk ($3.08 in chips)=20
wolf.ukr: posts small blind $0.01
AliceX6: posts big blind $0.02
*** HOLE CARDS ***
Dealt to the_wickstar [Ad Kc]
Krol165: folds=20
the_wickstar: raises $0.04 to $0.06
Donenko345: folds=20
HokageVIP: folds=20
gizmondouk: folds=20
KoXa8319: folds=20
Ainur M: folds=20
wolf.ukr: calls $0.05
AliceX6: calls $0.04
*** FLOP *** [6s Ks 4c]
wolf.ukr: checks=20
AliceX6: checks=20
the_wickstar: bets $0.10
wolf.ukr: calls $0.10
AliceX6: folds=20
*** TURN *** [6s Ks 4c] [2d]
wolf.ukr: checks=20
the_wickstar: checks=20
*** RIVER *** [6s Ks 4c 2d] [7d]
wolf.ukr: bets $0.15
the_wickstar: calls $0.15
*** SHOW DOWN ***
wolf.ukr: shows [Js Jd] (a pair of Jacks)
the_wickstar: shows [Ad Kc] (a pair of Kings)
the_wickstar collected $0.66 from pot
*** SUMMARY ***
Total pot $0.68 | Rake $0.02=20
Board [6s Ks 4c 2d 7d]
Seat 1: KoXa8319 folded before Flop (didn't bet)
Seat 2: Ainur M (button) folded before Flop (didn't bet)
Seat 3: wolf.ukr (small blind) showed [Js Jd] and lost with a pair of J=
acks
Seat 4: AliceX6 (big blind) folded on the Flop
Seat 5: Krol165 folded before Flop (didn't bet)
Seat 6: the_wickstar showed [Ad Kc] and won ($0.66) with a pair of Kings
Seat 7: Donenko345 folded before Flop (didn't bet)
Seat 8: HokageVIP folded before Flop (didn't bet)
Seat 9: gizmondouk folded before Flop (didn't bet)


*********** # 160 **************
PokerStars Hand #169939724198:  Hold'em No Limit ($0.01/$0.02 USD) - 20=
17/05/05 0:23:48 CUST [2017/05/04 10:23:48 ET]
Table 'Idomeneus' 9-max Seat #4 is the button
Seat 2: Geyko.K ($2.99 in chips)=20
Seat 3: greezex ($2.42 in chips)=20
Seat 4: fomik33 ($2 in chips)=20
Seat 5: the_wickstar ($1.07 in chips)=20
Seat 6: baymi ($1.11 in chips)=20
Seat 8: MalyshkinAle ($2.41 in chips)=20
Seat 9: JekaPoyniak ($2.10 in chips)=20
the_wickstar: posts small blind $0.01
baymi: posts big blind $0.02
*** HOLE CARDS ***
Dealt to the_wickstar [5c 6c]
MalyshkinAle: folds=20
JekaPoyniak: raises $0.06 to $0.08
Geyko.K: folds=20
greezex: folds=20
fomik33: folds=20
the_wickstar: folds=20
baymi: calls $0.06
*** FLOP *** [4d Qh 8s]
baymi: bets $0.06
JekaPoyniak: calls $0.06
*** TURN *** [4d Qh 8s] [2s]
baymi: bets $0.06
JekaPoyniak: folds=20
Uncalled bet ($0.06) returned to baymi
baymi collected $0.28 from pot
*** SUMMARY ***
Total pot $0.29 | Rake $0.01=20
Board [4d Qh 8s 2s]
Seat 2: Geyko.K folded before Flop (didn't bet)
Seat 3: greezex folded before Flop (didn't bet)
Seat 4: fomik33 (button) folded before Flop (didn't bet)
Seat 5: the_wickstar (small blind) folded before Flop
Seat 6: baymi (big blind) collected ($0.28)
Seat 8: MalyshkinAle folded before Flop (didn't bet)
Seat 9: JekaPoyniak folded on the Turn


*********** # 161 **************
PokerStars Hand #169939705420:  Hold'em No Limit ($0.01/$0.02 USD) - 20=
17/05/05 0:23:19 CUST [2017/05/04 10:23:19 ET]
Table 'Idomeneus' 9-max Seat #3 is the button
Seat 2: Geyko.K ($2.99 in chips)=20
Seat 3: greezex ($2.39 in chips)=20
Seat 4: fomik33 ($2 in chips)=20
Seat 5: the_wickstar ($1.09 in chips)=20
Seat 6: baymi ($1.11 in chips)=20
Seat 8: MalyshkinAle ($2.41 in chips)=20
Seat 9: JekaPoyniak ($2.10 in chips)=20
fomik33: posts small blind $0.01
the_wickstar: posts big blind $0.02
*** HOLE CARDS ***
Dealt to the_wickstar [Th 4s]
baymi: folds=20
MalyshkinAle: folds=20
JekaPoyniak: folds=20
Geyko.K: folds=20
greezex: raises $0.04 to $0.06
fomik33: folds=20
the_wickstar: folds=20
Uncalled bet ($0.04) returned to greezex
greezex collected $0.05 from pot
greezex: doesn't show hand=20
*** SUMMARY ***
Total pot $0.05 | Rake $0=20
Seat 2: Geyko.K folded before Flop (didn't bet)
Seat 3: greezex (button) collected ($0.05)
Seat 4: fomik33 (small blind) folded before Flop
Seat 5: the_wickstar (big blind) folded before Flop
Seat 6: baymi folded before Flop (didn't bet)
Seat 8: MalyshkinAle folded before Flop (didn't bet)
Seat 9: JekaPoyniak folded before Flop (didn't bet)


*********** # 162 **************
PokerStars Hand #169939685295:  Hold'em No Limit ($0.01/$0.02 USD) - 20=
17/05/05 0:22:48 CUST [2017/05/04 10:22:48 ET]
Table 'Idomeneus' 9-max Seat #2 is the button
Seat 2: Geyko.K ($3.03 in chips)=20
Seat 3: greezex ($2.33 in chips)=20
Seat 4: fomik33 ($2 in chips)=20
Seat 5: the_wickstar ($1.09 in chips)=20
Seat 6: baymi ($1.11 in chips)=20
Seat 8: MalyshkinAle ($2.41 in chips)=20
Seat 9: JekaPoyniak ($2.10 in chips)=20
greezex: posts small blind $0.01
fomik33: posts big blind $0.02
*** HOLE CARDS ***
Dealt to the_wickstar [5c 8c]
the_wickstar: folds=20
baymi: folds=20
MalyshkinAle: folds=20
JekaPoyniak: folds=20
Geyko.K: raises $0.02 to $0.04
greezex: calls $0.03
fomik33: folds=20
*** FLOP *** [Qd Th Kh]
greezex: bets $0.10
Geyko.K: folds=20
Uncalled bet ($0.10) returned to greezex
greezex collected $0.10 from pot
greezex: doesn't show hand=20
*** SUMMARY ***
Total pot $0.10 | Rake $0=20
Board [Qd Th Kh]
Seat 2: Geyko.K (button) folded on the Flop
Seat 3: greezex (small blind) collected ($0.10)
Seat 4: fomik33 (big blind) folded before Flop
Seat 5: the_wickstar folded before Flop (didn't bet)
Seat 6: baymi folded before Flop (didn't bet)
Seat 8: MalyshkinAle folded before Flop (didn't bet)
Seat 9: JekaPoyniak folded before Flop (didn't bet)


*********** # 163 **************
PokerStars Hand #169939676772:  Hold'em No Limit ($0.01/$0.02 USD) - 20=
17/05/05 0:22:35 CUST [2017/05/04 10:22:35 ET]
Table 'Benetnash' 9-max Seat #1 is the button
Seat 1: KoXa8319 ($2 in chips)=20
Seat 2: Ainur M ($1.18 in chips)=20
Seat 3: wolf.ukr ($2.92 in chips)=20
Seat 4: AliceX6 ($2.03 in chips)=20
Seat 5: Krol165 ($1.72 in chips)=20
Seat 6: the_wickstar ($1.47 in chips)=20
Seat 7: Donenko345 ($1 in chips)=20
Seat 8: HokageVIP ($2 in chips)=20
Seat 9: gizmondouk ($3.08 in chips)=20
Ainur M: posts small blind $0.01
wolf.ukr: posts big blind $0.02
*** HOLE CARDS ***
Dealt to the_wickstar [4c As]
AliceX6: folds=20
Krol165: folds=20
the_wickstar: calls $0.02
Donenko345: folds=20
HokageVIP: folds=20
gizmondouk: folds=20
KoXa8319: folds=20
Ainur M: folds=20
wolf.ukr: checks=20
*** FLOP *** [3s Kd Jh]
wolf.ukr: checks=20
the_wickstar: checks=20
*** TURN *** [3s Kd Jh] [5c]
wolf.ukr: checks=20
the_wickstar: checks=20
*** RIVER *** [3s Kd Jh 5c] [6c]
wolf.ukr: checks=20
the_wickstar: bets $0.03
wolf.ukr: folds=20
Uncalled bet ($0.03) returned to the_wickstar
the_wickstar collected $0.05 from pot
*** SUMMARY ***
Total pot $0.05 | Rake $0=20
Board [3s Kd Jh 5c 6c]
Seat 1: KoXa8319 (button) folded before Flop (didn't bet)
Seat 2: Ainur M (small blind) folded before Flop
Seat 3: wolf.ukr (big blind) folded on the River
Seat 4: AliceX6 folded before Flop (didn't bet)
Seat 5: Krol165 folded before Flop (didn't bet)
Seat 6: the_wickstar collected ($0.05)
Seat 7: Donenko345 folded before Flop (didn't bet)
Seat 8: HokageVIP folded before Flop (didn't bet)
Seat 9: gizmondouk folded before Flop (didn't bet)


*********** # 164 **************
PokerStars Hand #169939665653:  Hold'em No Limit ($0.01/$0.02 USD) - 20=
17/05/05 0:22:18 CUST [2017/05/04 10:22:18 ET]
Table 'Idomeneus' 9-max Seat #9 is the button
Seat 1: apodive ($2 in chips)=20
Seat 2: Geyko.K ($3.05 in chips)=20
Seat 3: greezex ($2.33 in chips)=20
Seat 4: fomik33 ($2 in chips)=20
Seat 5: the_wickstar ($1.09 in chips)=20
Seat 6: baymi ($1.11 in chips)=20
Seat 8: MalyshkinAle ($2.38 in chips)=20
Seat 9: JekaPoyniak ($2.10 in chips)=20
apodive: posts small blind $0.01
Geyko.K: posts big blind $0.02
*** HOLE CARDS ***
Dealt to the_wickstar [Qc 2c]
greezex: folds=20
fomik33: folds=20
the_wickstar: folds=20
baymi: folds=20
MalyshkinAle: raises $0.04 to $0.06
JekaPoyniak: folds=20
apodive: folds=20
Geyko.K: folds=20
Uncalled bet ($0.04) returned to MalyshkinAle
MalyshkinAle collected $0.05 from pot
MalyshkinAle: doesn't show hand=20
*** SUMMARY ***
Total pot $0.05 | Rake $0=20
Seat 1: apodive (small blind) folded before Flop
Seat 2: Geyko.K (big blind) folded before Flop
Seat 3: greezex folded before Flop (didn't bet)
Seat 4: fomik33 folded before Flop (didn't bet)
Seat 5: the_wickstar folded before Flop (didn't bet)
Seat 6: baymi folded before Flop (didn't bet)
Seat 8: MalyshkinAle collected ($0.05)
Seat 9: JekaPoyniak (button) folded before Flop (didn't bet)


*********** # 165 **************
PokerStars Hand #169939651674:  Hold'em No Limit ($0.01/$0.02 USD) - 20=
17/05/05 0:21:57 CUST [2017/05/04 10:21:57 ET]
Table 'Idomeneus' 9-max Seat #8 is the button
Seat 1: apodive ($2 in chips)=20
Seat 2: Geyko.K ($3.05 in chips)=20
Seat 3: greezex ($2.30 in chips)=20
Seat 4: fomik33 ($2 in chips)=20
Seat 5: the_wickstar ($1.09 in chips)=20
Seat 6: baymi ($1.11 in chips)=20
Seat 8: MalyshkinAle ($2.38 in chips)=20
Seat 9: JekaPoyniak ($2.11 in chips)=20
JekaPoyniak: posts small blind $0.01
apodive: posts big blind $0.02
*** HOLE CARDS ***
Dealt to the_wickstar [4s Jc]
Geyko.K: folds=20
greezex: raises $0.06 to $0.08
fomik33: folds=20
the_wickstar: folds=20
baymi: folds=20
MalyshkinAle: folds=20
JekaPoyniak: folds=20
apodive: folds=20
Uncalled bet ($0.06) returned to greezex
greezex collected $0.05 from pot
greezex: doesn't show hand=20
*** SUMMARY ***
Total pot $0.05 | Rake $0=20
Seat 1: apodive (big blind) folded before Flop
Seat 2: Geyko.K folded before Flop (didn't bet)
Seat 3: greezex collected ($0.05)
Seat 4: fomik33 folded before Flop (didn't bet)
Seat 5: the_wickstar folded before Flop (didn't bet)
Seat 6: baymi folded before Flop (didn't bet)
Seat 8: MalyshkinAle (button) folded before Flop (didn't bet)
Seat 9: JekaPoyniak (small blind) folded before Flop


*********** # 166 **************
PokerStars Hand #169939650550:  Hold'em No Limit ($0.01/$0.02 USD) - 20=
17/05/05 0:21:55 CUST [2017/05/04 10:21:55 ET]
Table 'Benetnash' 9-max Seat #9 is the button
Seat 1: KoXa8319 ($2 in chips)=20
Seat 2: Ainur M ($1.20 in chips)=20
Seat 3: wolf.ukr ($2.92 in chips)=20
Seat 4: AliceX6 ($2.03 in chips)=20
Seat 5: Krol165 ($1.72 in chips)=20
Seat 6: the_wickstar ($1.47 in chips)=20
Seat 7: Donenko345 ($1 in chips)=20
Seat 8: HokageVIP ($2 in chips)=20
Seat 9: gizmondouk ($3.05 in chips)=20
KoXa8319: posts small blind $0.01
Ainur M: posts big blind $0.02
*** HOLE CARDS ***
Dealt to the_wickstar [4d 5c]
wolf.ukr: folds=20
AliceX6: folds=20
Krol165: folds=20
the_wickstar: folds=20
Donenko345: folds=20
HokageVIP: folds=20
gizmondouk: raises $0.04 to $0.06
KoXa8319: folds=20
Ainur M: folds=20
Uncalled bet ($0.04) returned to gizmondouk
gizmondouk collected $0.05 from pot
gizmondouk: doesn't show hand=20
*** SUMMARY ***
Total pot $0.05 | Rake $0=20
Seat 1: KoXa8319 (small blind) folded before Flop
Seat 2: Ainur M (big blind) folded before Flop
Seat 3: wolf.ukr folded before Flop (didn't bet)
Seat 4: AliceX6 folded before Flop (didn't bet)
Seat 5: Krol165 folded before Flop (didn't bet)
Seat 6: the_wickstar folded before Flop (didn't bet)
Seat 7: Donenko345 folded before Flop (didn't bet)
Seat 8: HokageVIP folded before Flop (didn't bet)
Seat 9: gizmondouk (button) collected ($0.05)


*********** # 167 **************
PokerStars Hand #169939638137:  Hold'em No Limit ($0.01/$0.02 USD) - 20=
17/05/05 0:21:36 CUST [2017/05/04 10:21:36 ET]
Table 'Idomeneus' 9-max Seat #6 is the button
Seat 1: apodive ($2 in chips)=20
Seat 2: Geyko.K ($3.05 in chips)=20
Seat 3: greezex ($2.30 in chips)=20
Seat 4: fomik33 ($2 in chips)=20
Seat 5: the_wickstar ($1.09 in chips)=20
Seat 6: baymi ($1.11 in chips)=20
Seat 8: MalyshkinAle ($2.39 in chips)=20
Seat 9: JekaPoyniak ($2.10 in chips)=20
MalyshkinAle: posts small blind $0.01
JekaPoyniak: posts big blind $0.02
*** HOLE CARDS ***
Dealt to the_wickstar [5c 9d]
apodive: folds=20
Geyko.K: folds=20
greezex: folds=20
fomik33: folds=20
the_wickstar: folds=20
baymi: folds=20
MalyshkinAle: folds=20
Uncalled bet ($0.01) returned to JekaPoyniak
JekaPoyniak collected $0.02 from pot
*** SUMMARY ***
Total pot $0.02 | Rake $0=20
Seat 1: apodive folded before Flop (didn't bet)
Seat 2: Geyko.K folded before Flop (didn't bet)
Seat 3: greezex folded before Flop (didn't bet)
Seat 4: fomik33 folded before Flop (didn't bet)
Seat 5: the_wickstar folded before Flop (didn't bet)
Seat 6: baymi (button) folded before Flop (didn't bet)
Seat 8: MalyshkinAle (small blind) folded before Flop
Seat 9: JekaPoyniak (big blind) collected ($0.02)


*********** # 168 **************
PokerStars Hand #169939594745:  Hold'em No Limit ($0.01/$0.02 USD) - 20=
17/05/05 0:20:31 CUST [2017/05/04 10:20:31 ET]
Table 'Idomeneus' 9-max Seat #5 is the button
Seat 1: apodive ($2 in chips)=20
Seat 2: Geyko.K ($3.05 in chips)=20
Seat 3: greezex ($2.30 in chips)=20
Seat 4: fomik33 ($2 in chips)=20
Seat 5: the_wickstar ($1.09 in chips)=20
Seat 6: baymi ($1.23 in chips)=20
Seat 8: MalyshkinAle ($2.28 in chips)=20
Seat 9: JekaPoyniak ($2.10 in chips)=20
baymi: posts small blind $0.01
toxizo: is sitting out=20
MalyshkinAle: posts big blind $0.02
*** HOLE CARDS ***
Dealt to the_wickstar [6h Jh]
JekaPoyniak: folds=20
apodive: folds=20
Geyko.K: folds=20
greezex: folds=20
fomik33 has timed out
fomik33: folds=20
the_wickstar: folds=20
baymi: raises $0.02 to $0.04
MalyshkinAle: calls $0.02
*** FLOP *** [2d Th Ks]
baymi: bets $0.04
MalyshkinAle: raises $0.04 to $0.08
baymi: calls $0.04
*** TURN *** [2d Th Ks] [Ad]
baymi: checks=20
MalyshkinAle: bets $0.17
baymi: folds=20
Uncalled bet ($0.17) returned to MalyshkinAle
MalyshkinAle collected $0.23 from pot
MalyshkinAle: doesn't show hand=20
*** SUMMARY ***
Total pot $0.24 | Rake $0.01=20
Board [2d Th Ks Ad]
Seat 1: apodive folded before Flop (didn't bet)
Seat 2: Geyko.K folded before Flop (didn't bet)
Seat 3: greezex folded before Flop (didn't bet)
Seat 4: fomik33 folded before Flop (didn't bet)
Seat 5: the_wickstar (button) folded before Flop (didn't bet)
Seat 6: baymi (small blind) folded on the Turn
Seat 8: MalyshkinAle (big blind) collected ($0.23)
Seat 9: JekaPoyniak folded before Flop (didn't bet)


*********** # 169 **************
PokerStars Hand #169939587262:  Hold'em No Limit ($0.01/$0.02 USD) - 20=
17/05/05 0:20:19 CUST [2017/05/04 10:20:19 ET]
Table 'Benetnash' 9-max Seat #8 is the button
Seat 1: KoXa8319 ($2 in chips)=20
Seat 2: Ainur M ($1.20 in chips)=20
Seat 3: wolf.ukr ($2.92 in chips)=20
Seat 4: AliceX6 ($2.03 in chips)=20
Seat 5: Krol165 ($1.93 in chips)=20
Seat 6: the_wickstar ($1.10 in chips)=20
Seat 7: Donenko345 ($1 in chips)=20
Seat 8: HokageVIP ($2 in chips)=20
Seat 9: gizmondouk ($3.11 in chips)=20
gizmondouk: posts small blind $0.01
KoXa8319: posts big blind $0.02
*** HOLE CARDS ***
Dealt to the_wickstar [Qd Jc]
Ainur M: folds=20
wolf.ukr: folds=20
AliceX6: folds=20
Krol165: raises $0.04 to $0.06
the_wickstar: calls $0.06
Donenko345: calls $0.06
HokageVIP: folds=20
gizmondouk: calls $0.05
KoXa8319: calls $0.04
*** FLOP *** [8s Jd 2h]
gizmondouk: checks=20
KoXa8319: checks=20
Krol165: checks=20
the_wickstar: bets $0.15
Donenko345: folds=20
gizmondouk: folds=20
KoXa8319: folds=20
Krol165: calls $0.15
*** TURN *** [8s Jd 2h] [4h]
Krol165: checks=20
the_wickstar: checks=20
*** RIVER *** [8s Jd 2h 4h] [5s]
Krol165: checks=20
the_wickstar: bets $0.30
Krol165: folds=20
Uncalled bet ($0.30) returned to the_wickstar
the_wickstar collected $0.58 from pot
*** SUMMARY ***
Total pot $0.60 | Rake $0.02=20
Board [8s Jd 2h 4h 5s]
Seat 1: KoXa8319 (big blind) folded on the Flop
Seat 2: Ainur M folded before Flop (didn't bet)
Seat 3: wolf.ukr folded before Flop (didn't bet)
Seat 4: AliceX6 folded before Flop (didn't bet)
Seat 5: Krol165 folded on the River
Seat 6: the_wickstar collected ($0.58)
Seat 7: Donenko345 folded on the Flop
Seat 8: HokageVIP (button) folded before Flop (didn't bet)
Seat 9: gizmondouk (small blind) folded on the Flop


*********** # 170 **************
PokerStars Hand #169939551875:  Hold'em No Limit ($0.01/$0.02 USD) - 20=
17/05/05 0:19:26 CUST [2017/05/04 10:19:26 ET]
Table 'Idomeneus' 9-max Seat #4 is the button
Seat 1: apodive ($2 in chips)=20
Seat 2: Geyko.K ($3.05 in chips)=20
Seat 3: greezex ($2.36 in chips)=20
Seat 4: fomik33 ($2 in chips)=20
Seat 5: the_wickstar ($1.15 in chips)=20
Seat 6: baymi ($1.29 in chips)=20
Seat 7: toxizo ($2 in chips)=20
Seat 8: MalyshkinAle ($2.11 in chips)=20
Seat 9: JekaPoyniak ($2.10 in chips)=20
the_wickstar: posts small blind $0.01
baymi: posts big blind $0.02
*** HOLE CARDS ***
Dealt to the_wickstar [Tc 4s]
toxizo: folds=20
MalyshkinAle: raises $0.04 to $0.06
JekaPoyniak: folds=20
apodive: folds=20
Geyko.K: folds=20
greezex: calls $0.06
fomik33: folds=20
fomik33 is disconnected=20
the_wickstar: calls $0.05
baymi: calls $0.04
*** FLOP *** [Qs 5s 9c]
the_wickstar: checks=20
baymi: checks=20
MalyshkinAle: bets $0.12
greezex: folds=20
the_wickstar: folds=20
baymi: folds=20
Uncalled bet ($0.12) returned to MalyshkinAle
MalyshkinAle collected $0.23 from pot
MalyshkinAle: doesn't show hand=20
*** SUMMARY ***
Total pot $0.24 | Rake $0.01=20
Board [Qs 5s 9c]
Seat 1: apodive folded before Flop (didn't bet)
Seat 2: Geyko.K folded before Flop (didn't bet)
Seat 3: greezex folded on the Flop
Seat 4: fomik33 (button) folded before Flop (didn't bet)
Seat 5: the_wickstar (small blind) folded on the Flop
Seat 6: baymi (big blind) folded on the Flop
Seat 7: toxizo folded before Flop (didn't bet)
Seat 8: MalyshkinAle collected ($0.23)
Seat 9: JekaPoyniak folded before Flop (didn't bet)


*********** # 171 **************
PokerStars Hand #169939537641:  Hold'em No Limit ($0.01/$0.02 USD) - 20=
17/05/05 0:19:05 CUST [2017/05/04 10:19:05 ET]
Table 'Idomeneus' 9-max Seat #3 is the button
Seat 1: apodive ($2 in chips)=20
Seat 2: Geyko.K ($3.05 in chips)=20
Seat 3: greezex ($2.36 in chips)=20
Seat 4: fomik33 ($2 in chips)=20
Seat 5: the_wickstar ($1.14 in chips)=20
Seat 6: baymi ($1.29 in chips)=20
Seat 7: toxizo ($2 in chips)=20
Seat 8: MalyshkinAle ($2.11 in chips)=20
Seat 9: JekaPoyniak ($2.10 in chips)=20
fomik33: posts small blind $0.01
the_wickstar: posts big blind $0.02
*** HOLE CARDS ***
Dealt to the_wickstar [Qh 3c]
baymi: folds=20
toxizo: folds=20
MalyshkinAle: folds=20
JekaPoyniak: folds=20
apodive: folds=20
Geyko.K: folds=20
greezex: folds=20
fomik33: folds=20
Uncalled bet ($0.01) returned to the_wickstar
the_wickstar collected $0.02 from pot
*** SUMMARY ***
Total pot $0.02 | Rake $0=20
Seat 1: apodive folded before Flop (didn't bet)
Seat 2: Geyko.K folded before Flop (didn't bet)
Seat 3: greezex (button) folded before Flop (didn't bet)
Seat 4: fomik33 (small blind) folded before Flop
Seat 5: the_wickstar (big blind) collected ($0.02)
Seat 6: baymi folded before Flop (didn't bet)
Seat 7: toxizo folded before Flop (didn't bet)
Seat 8: MalyshkinAle folded before Flop (didn't bet)
Seat 9: JekaPoyniak folded before Flop (didn't bet)


*********** # 172 **************
PokerStars Hand #169939526287:  Hold'em No Limit ($0.01/$0.02 USD) - 20=
17/05/05 0:18:48 CUST [2017/05/04 10:18:48 ET]
Table 'Benetnash' 9-max Seat #5 is the button
Seat 2: Ainur M ($1.20 in chips)=20
Seat 3: wolf.ukr ($2.92 in chips)=20
Seat 4: AliceX6 ($2.03 in chips)=20
Seat 5: Krol165 ($1.13 in chips)=20
Seat 6: the_wickstar ($0.84 in chips)=20
Seat 7: Donenko345 ($1.02 in chips)=20
Seat 8: HokageVIP ($2 in chips)=20
Seat 9: gizmondouk ($3.10 in chips)=20
the_wickstar: posts small blind $0.01
Donenko345: posts big blind $0.02
KoXa8319: sits out=20
*** HOLE CARDS ***
Dealt to the_wickstar [Ks Kd]
HokageVIP: folds=20
gizmondouk: folds=20
Ainur M: folds=20
wolf.ukr: folds=20
AliceX6: folds=20
Krol165: raises $0.04 to $0.06
the_wickstar: raises $0.06 to $0.12
Donenko345: folds=20
Krol165: calls $0.06
*** FLOP *** [9c Td 5d]
the_wickstar: bets $0.12
Krol165: calls $0.12
*** TURN *** [9c Td 5d] [6d]
the_wickstar: checks=20
Krol165: bets $0.36
the_wickstar: calls $0.36
*** RIVER *** [9c Td 5d 6d] [Js]
the_wickstar: checks=20
Krol165: bets $0.53 and is all-in
the_wickstar: calls $0.24 and is all-in
Uncalled bet ($0.29) returned to Krol165
*** SHOW DOWN ***
Krol165: shows [9d Jd] (a flush, Jack high)
the_wickstar: shows [Ks Kd] (a pair of Kings)
Krol165 collected $1.64 from pot
*** SUMMARY ***
Total pot $1.70 | Rake $0.06=20
Board [9c Td 5d 6d Js]
Seat 2: Ainur M folded before Flop (didn't bet)
Seat 3: wolf.ukr folded before Flop (didn't bet)
Seat 4: AliceX6 folded before Flop (didn't bet)
Seat 5: Krol165 (button) showed [9d Jd] and won ($1.64) with a flush, J=
ack high
Seat 6: the_wickstar (small blind) showed [Ks Kd] and lost with a pair =
of Kings
Seat 7: Donenko345 (big blind) folded before Flop
Seat 8: HokageVIP folded before Flop (didn't bet)
Seat 9: gizmondouk folded before Flop (didn't bet)


*********** # 173 **************
PokerStars Hand #169939518155:  Hold'em No Limit ($0.01/$0.02 USD) - 20=
17/05/05 0:18:36 CUST [2017/05/04 10:18:36 ET]
Table 'Idomeneus' 9-max Seat #2 is the button
Seat 1: apodive ($2 in chips)=20
Seat 2: Geyko.K ($3.11 in chips)=20
Seat 3: greezex ($2.28 in chips)=20
Seat 4: fomik33 ($2 in chips)=20
Seat 5: the_wickstar ($1.14 in chips)=20
Seat 6: baymi ($1.29 in chips)=20
Seat 7: toxizo ($2 in chips)=20
Seat 8: MalyshkinAle ($2.11 in chips)=20
Seat 9: JekaPoyniak ($2.10 in chips)=20
greezex: posts small blind $0.01
fomik33: posts big blind $0.02
*** HOLE CARDS ***
Dealt to the_wickstar [Qd Tc]
the_wickstar: folds=20
baymi: folds=20
toxizo: folds=20
MalyshkinAle: folds=20
JekaPoyniak: folds=20
apodive: folds=20
Geyko.K: raises $0.04 to $0.06
greezex: raises $0.18 to $0.24
fomik33: folds=20
Geyko.K: folds=20
Uncalled bet ($0.18) returned to greezex
greezex collected $0.14 from pot
greezex: doesn't show hand=20
*** SUMMARY ***
Total pot $0.14 | Rake $0=20
Seat 1: apodive folded before Flop (didn't bet)
Seat 2: Geyko.K (button) folded before Flop
Seat 3: greezex (small blind) collected ($0.14)
Seat 4: fomik33 (big blind) folded before Flop
Seat 5: the_wickstar folded before Flop (didn't bet)
Seat 6: baymi folded before Flop (didn't bet)
Seat 7: toxizo folded before Flop (didn't bet)
Seat 8: MalyshkinAle folded before Flop (didn't bet)
Seat 9: JekaPoyniak folded before Flop (didn't bet)


*********** # 174 **************
PokerStars Hand #169939512250:  Hold'em No Limit ($0.01/$0.02 USD) - 20=
17/05/05 0:18:28 CUST [2017/05/04 10:18:28 ET]
Table 'Benetnash' 9-max Seat #4 is the button
Seat 2: Ainur M ($1.20 in chips)=20
Seat 3: wolf.ukr ($2.92 in chips)=20
Seat 4: AliceX6 ($2.03 in chips)=20
Seat 5: Krol165 ($1.11 in chips)=20
Seat 6: the_wickstar ($0.86 in chips)=20
Seat 7: Donenko345 ($1.02 in chips)=20
Seat 8: HokageVIP ($2 in chips)=20
Seat 9: gizmondouk ($3.10 in chips)=20
Krol165: posts small blind $0.01
the_wickstar: posts big blind $0.02
KoXa8319: sits out=20
*** HOLE CARDS ***
Dealt to the_wickstar [6s 2c]
Donenko345: folds=20
HokageVIP: folds=20
gizmondouk: folds=20
Ainur M: folds=20
wolf.ukr: folds=20
AliceX6: folds=20
Krol165: raises $0.04 to $0.06
the_wickstar: folds=20
Uncalled bet ($0.04) returned to Krol165
Krol165 collected $0.04 from pot
Krol165: doesn't show hand=20
*** SUMMARY ***
Total pot $0.04 | Rake $0=20
Seat 2: Ainur M folded before Flop (didn't bet)
Seat 3: wolf.ukr folded before Flop (didn't bet)
Seat 4: AliceX6 (button) folded before Flop (didn't bet)
Seat 5: Krol165 (small blind) collected ($0.04)
Seat 6: the_wickstar (big blind) folded before Flop
Seat 7: Donenko345 folded before Flop (didn't bet)
Seat 8: HokageVIP folded before Flop (didn't bet)
Seat 9: gizmondouk folded before Flop (didn't bet)


*********** # 175 **************
PokerStars Hand #169939494034:  Hold'em No Limit ($0.01/$0.02 USD) - 20=
17/05/05 0:18:01 CUST [2017/05/04 10:18:01 ET]
Table 'Benetnash' 9-max Seat #3 is the button
Seat 2: Ainur M ($1.20 in chips)=20
Seat 3: wolf.ukr ($2.92 in chips)=20
Seat 4: AliceX6 ($2.04 in chips)=20
Seat 5: Krol165 ($1.10 in chips)=20
Seat 6: the_wickstar ($0.86 in chips)=20
Seat 7: Donenko345 ($1.02 in chips)=20
Seat 8: HokageVIP ($2 in chips)=20
Seat 9: gizmondouk ($3.10 in chips)=20
AliceX6: posts small blind $0.01
Krol165: posts big blind $0.02
KoXa8319: sits out=20
*** HOLE CARDS ***
Dealt to the_wickstar [6d Qs]
the_wickstar: folds=20
Donenko345: folds=20
HokageVIP: folds=20
gizmondouk: folds=20
Ainur M: folds=20
wolf.ukr: folds=20
AliceX6: folds=20
Uncalled bet ($0.01) returned to Krol165
Krol165 collected $0.02 from pot
Krol165: doesn't show hand=20
*** SUMMARY ***
Total pot $0.02 | Rake $0=20
Seat 2: Ainur M folded before Flop (didn't bet)
Seat 3: wolf.ukr (button) folded before Flop (didn't bet)
Seat 4: AliceX6 (small blind) folded before Flop
Seat 5: Krol165 (big blind) collected ($0.02)
Seat 6: the_wickstar folded before Flop (didn't bet)
Seat 7: Donenko345 folded before Flop (didn't bet)
Seat 8: HokageVIP folded before Flop (didn't bet)
Seat 9: gizmondouk folded before Flop (didn't bet)


*********** # 176 **************
PokerStars Hand #169939483278:  Hold'em No Limit ($0.01/$0.02 USD) - 20=
17/05/05 0:17:45 CUST [2017/05/04 10:17:45 ET]
Table 'Idomeneus' 9-max Seat #1 is the button
Seat 1: apodive ($2 in chips)=20
Seat 2: Geyko.K ($2.96 in chips)=20
Seat 3: greezex ($2.30 in chips)=20
Seat 5: the_wickstar ($1.14 in chips)=20
Seat 6: baymi ($1.29 in chips)=20
Seat 7: toxizo ($2 in chips)=20
Seat 8: MalyshkinAle ($2.11 in chips)=20
Seat 9: JekaPoyniak ($2.24 in chips)=20
Geyko.K: posts small blind $0.01
greezex: posts big blind $0.02
fomik33: sits out=20
*** HOLE CARDS ***
Dealt to the_wickstar [7d 4c]
the_wickstar: folds=20
baymi: folds=20
toxizo: folds=20
MalyshkinAle: folds=20
JekaPoyniak: raises $0.06 to $0.08
apodive: folds=20
Geyko.K: raises $0.06 to $0.14
greezex: folds=20
JekaPoyniak: calls $0.06
*** FLOP *** [Qd Ks 2s]
Geyko.K: bets $0.16
JekaPoyniak: folds=20
Uncalled bet ($0.16) returned to Geyko.K
Geyko.K collected $0.29 from pot
Geyko.K: doesn't show hand=20
*** SUMMARY ***
Total pot $0.30 | Rake $0.01=20
Board [Qd Ks 2s]
Seat 1: apodive (button) folded before Flop (didn't bet)
Seat 2: Geyko.K (small blind) collected ($0.29)
Seat 3: greezex (big blind) folded before Flop
Seat 5: the_wickstar folded before Flop (didn't bet)
Seat 6: baymi folded before Flop (didn't bet)
Seat 7: toxizo folded before Flop (didn't bet)
Seat 8: MalyshkinAle folded before Flop (didn't bet)
Seat 9: JekaPoyniak folded on the Flop


*********** # 177 **************
PokerStars Hand #169939456740:  Hold'em No Limit ($0.01/$0.02 USD) - 20=
17/05/05 0:17:06 CUST [2017/05/04 10:17:06 ET]
Table 'Benetnash' 9-max Seat #2 is the button
Seat 2: Ainur M ($1.20 in chips)=20
Seat 3: wolf.ukr ($2.93 in chips)=20
Seat 4: AliceX6 ($2.06 in chips)=20
Seat 5: Krol165 ($1.10 in chips)=20
Seat 6: the_wickstar ($0.83 in chips)=20
Seat 7: Donenko345 ($1.02 in chips)=20
Seat 8: HokageVIP ($2 in chips)=20
Seat 9: gizmondouk ($3.10 in chips)=20
wolf.ukr: posts small blind $0.01
AliceX6: posts big blind $0.02
*** HOLE CARDS ***
Dealt to the_wickstar [Jd Qs]
Krol165: folds=20
the_wickstar: raises $0.02 to $0.04
Donenko345: folds=20
HokageVIP: folds=20
gizmondouk: folds=20
Ainur M: folds=20
wolf.ukr: folds=20
AliceX6: folds=20
Uncalled bet ($0.02) returned to the_wickstar
the_wickstar collected $0.05 from pot
*** SUMMARY ***
Total pot $0.05 | Rake $0=20
Seat 2: Ainur M (button) folded before Flop (didn't bet)
Seat 3: wolf.ukr (small blind) folded before Flop
Seat 4: AliceX6 (big blind) folded before Flop
Seat 5: Krol165 folded before Flop (didn't bet)
Seat 6: the_wickstar collected ($0.05)
Seat 7: Donenko345 folded before Flop (didn't bet)
Seat 8: HokageVIP folded before Flop (didn't bet)
Seat 9: gizmondouk folded before Flop (didn't bet)


*********** # 178 **************
PokerStars Hand #169939447141:  Hold'em No Limit ($0.01/$0.02 USD) - 20=
17/05/05 0:16:52 CUST [2017/05/04 10:16:52 ET]
Table 'Idomeneus' 9-max Seat #9 is the button
Seat 1: apodive ($2 in chips)=20
Seat 2: Geyko.K ($2.98 in chips)=20
Seat 3: greezex ($2.30 in chips)=20
Seat 5: the_wickstar ($1.14 in chips)=20
Seat 6: baymi ($1.37 in chips)=20
Seat 7: toxizo ($2 in chips)=20
Seat 8: MalyshkinAle ($2.01 in chips)=20
Seat 9: JekaPoyniak ($2.24 in chips)=20
apodive: posts small blind $0.01
Geyko.K: posts big blind $0.02
*** HOLE CARDS ***
Dealt to the_wickstar [9c 2s]
fomik33 joins the table at seat #4=20
greezex: folds=20
the_wickstar: folds=20
baymi: raises $0.02 to $0.04
toxizo: folds=20
MalyshkinAle: calls $0.04
JekaPoyniak: folds=20
apodive: folds=20
Geyko.K: folds=20
*** FLOP *** [Js 6d 9h]
baymi: bets $0.04
MalyshkinAle: calls $0.04
*** TURN *** [Js 6d 9h] [Kc]
baymi: checks=20
MalyshkinAle: checks=20
*** RIVER *** [Js 6d 9h Kc] [3c]
baymi: checks=20
MalyshkinAle: checks=20
*** SHOW DOWN ***
baymi: shows [Ac 4h] (high card Ace)
MalyshkinAle: shows [Qc Kh] (a pair of Kings)
MalyshkinAle collected $0.18 from pot
*** SUMMARY ***
Total pot $0.19 | Rake $0.01=20
Board [Js 6d 9h Kc 3c]
Seat 1: apodive (small blind) folded before Flop
Seat 2: Geyko.K (big blind) folded before Flop
Seat 3: greezex folded before Flop (didn't bet)
Seat 5: the_wickstar folded before Flop (didn't bet)
Seat 6: baymi showed [Ac 4h] and lost with high card Ace
Seat 7: toxizo folded before Flop (didn't bet)
Seat 8: MalyshkinAle showed [Qc Kh] and won ($0.18) with a pair of Kings
Seat 9: JekaPoyniak (button) folded before Flop (didn't bet)


*********** # 179 **************
PokerStars Hand #169939434302:  Hold'em No Limit ($0.01/$0.02 USD) - 20=
17/05/05 0:16:33 CUST [2017/05/04 10:16:33 ET]
Table 'Benetnash' 9-max Seat #9 is the button
Seat 2: Ainur M ($1.21 in chips)=20
Seat 3: wolf.ukr ($2.95 in chips)=20
Seat 4: AliceX6 ($2.03 in chips)=20
Seat 5: Krol165 ($1.10 in chips)=20
Seat 6: the_wickstar ($0.83 in chips)=20
Seat 7: Donenko345 ($1.02 in chips)=20
Seat 8: HokageVIP ($2 in chips)=20
Seat 9: gizmondouk ($3.10 in chips)=20
Ainur M: posts small blind $0.01
wolf.ukr: posts big blind $0.02
*** HOLE CARDS ***
Dealt to the_wickstar [Ts 5d]
AliceX6: raises $0.04 to $0.06
Krol165: folds=20
the_wickstar: folds=20
Donenko345: folds=20
HokageVIP: folds=20
gizmondouk: folds=20
Ainur M: folds=20
wolf.ukr: folds=20
Uncalled bet ($0.04) returned to AliceX6
AliceX6 collected $0.05 from pot
AliceX6: doesn't show hand=20
*** SUMMARY ***
Total pot $0.05 | Rake $0=20
Seat 2: Ainur M (small blind) folded before Flop
Seat 3: wolf.ukr (big blind) folded before Flop
Seat 4: AliceX6 collected ($0.05)
Seat 5: Krol165 folded before Flop (didn't bet)
Seat 6: the_wickstar folded before Flop (didn't bet)
Seat 7: Donenko345 folded before Flop (didn't bet)
Seat 8: HokageVIP folded before Flop (didn't bet)
Seat 9: gizmondouk (button) folded before Flop (didn't bet)


*********** # 180 **************
PokerStars Hand #169939421579:  Hold'em No Limit ($0.01/$0.02 USD) - 20=
17/05/05 0:16:15 CUST [2017/05/04 10:16:15 ET]
Table 'Benetnash' 9-max Seat #8 is the button
Seat 2: Ainur M ($1.20 in chips)=20
Seat 3: wolf.ukr ($2.95 in chips)=20
Seat 4: AliceX6 ($2.03 in chips)=20
Seat 5: Krol165 ($1.10 in chips)=20
Seat 6: the_wickstar ($0.83 in chips)=20
Seat 7: Donenko345 ($1.02 in chips)=20
Seat 8: HokageVIP ($2 in chips)=20
Seat 9: gizmondouk ($3.11 in chips)=20
gizmondouk: posts small blind $0.01
Ainur M: posts big blind $0.02
*** HOLE CARDS ***
Dealt to the_wickstar [8c 5h]
wolf.ukr: folds=20
AliceX6: folds=20
Krol165: folds=20
the_wickstar: folds=20
Donenko345: folds=20
HokageVIP: folds=20
gizmondouk: folds=20
Uncalled bet ($0.01) returned to Ainur M
Ainur M collected $0.02 from pot
*** SUMMARY ***
Total pot $0.02 | Rake $0=20
Seat 2: Ainur M (big blind) collected ($0.02)
Seat 3: wolf.ukr folded before Flop (didn't bet)
Seat 4: AliceX6 folded before Flop (didn't bet)
Seat 5: Krol165 folded before Flop (didn't bet)
Seat 6: the_wickstar folded before Flop (didn't bet)
Seat 7: Donenko345 folded before Flop (didn't bet)
Seat 8: HokageVIP (button) folded before Flop (didn't bet)
Seat 9: gizmondouk (small blind) folded before Flop


*********** # 181 **************
PokerStars Hand #169939418230:  Hold'em No Limit ($0.01/$0.02 USD) - 20=
17/05/05 0:16:10 CUST [2017/05/04 10:16:10 ET]
Table 'Idomeneus' 9-max Seat #8 is the button
Seat 1: apodive ($2 in chips)=20
Seat 2: Geyko.K ($2.98 in chips)=20
Seat 3: greezex ($2.30 in chips)=20
Seat 4: littelmonste ($0.90 in chips)=20
Seat 5: the_wickstar ($1.18 in chips)=20
Seat 6: baymi ($1.57 in chips)=20
Seat 7: toxizo ($2 in chips)=20
Seat 8: MalyshkinAle ($2.01 in chips)=20
Seat 9: JekaPoyniak ($2 in chips)=20
JekaPoyniak: posts small blind $0.01
apodive: posts big blind $0.02
*** HOLE CARDS ***
Dealt to the_wickstar [8d Ah]
Geyko.K: folds=20
greezex: folds=20
littelmonste: folds=20
the_wickstar: raises $0.02 to $0.04
baymi: calls $0.04
toxizo: folds=20
MalyshkinAle: folds=20
JekaPoyniak: raises $0.16 to $0.20
apodive: folds=20
the_wickstar: folds=20
baymi: calls $0.16
*** FLOP *** [Ac 6h Kc]
littelmonste leaves the table
JekaPoyniak: bets $0.33
baymi: folds=20
Uncalled bet ($0.33) returned to JekaPoyniak
JekaPoyniak collected $0.44 from pot
*** SUMMARY ***
Total pot $0.46 | Rake $0.02=20
Board [Ac 6h Kc]
Seat 1: apodive (big blind) folded before Flop
Seat 2: Geyko.K folded before Flop (didn't bet)
Seat 3: greezex folded before Flop (didn't bet)
Seat 4: littelmonste folded before Flop (didn't bet)
Seat 5: the_wickstar folded before Flop
Seat 6: baymi folded on the Flop
Seat 7: toxizo folded before Flop (didn't bet)
Seat 8: MalyshkinAle (button) folded before Flop (didn't bet)
Seat 9: JekaPoyniak (small blind) collected ($0.44)


*********** # 182 **************
PokerStars Hand #169939402149:  Hold'em No Limit ($0.01/$0.02 USD) - 20=
17/05/05 0:15:46 CUST [2017/05/04 10:15:46 ET]
Table 'Benetnash' 9-max Seat #7 is the button
Seat 3: wolf.ukr ($2.92 in chips)=20
Seat 4: AliceX6 ($2.03 in chips)=20
Seat 5: Krol165 ($1.10 in chips)=20
Seat 6: the_wickstar ($0.83 in chips)=20
Seat 7: Donenko345 ($1.02 in chips)=20
Seat 8: HokageVIP ($2 in chips)=20
Seat 9: gizmondouk ($3.13 in chips)=20
HokageVIP: posts small blind $0.01
gizmondouk: posts big blind $0.02
Ainur M: sits out=20
*** HOLE CARDS ***
Dealt to the_wickstar [6d Kh]
wolf.ukr: raises $0.04 to $0.06
AliceX6: folds=20
Krol165: folds=20
the_wickstar: folds=20
Donenko345: folds=20
HokageVIP: folds=20
gizmondouk: folds=20
Uncalled bet ($0.04) returned to wolf.ukr
wolf.ukr collected $0.05 from pot
*** SUMMARY ***
Total pot $0.05 | Rake $0=20
Seat 3: wolf.ukr collected ($0.05)
Seat 4: AliceX6 folded before Flop (didn't bet)
Seat 5: Krol165 folded before Flop (didn't bet)
Seat 6: the_wickstar folded before Flop (didn't bet)
Seat 7: Donenko345 (button) folded before Flop (didn't bet)
Seat 8: HokageVIP (small blind) folded before Flop
Seat 9: gizmondouk (big blind) folded before Flop


*********** # 183 **************
PokerStars Hand #169939395845:  Hold'em No Limit ($0.01/$0.02 USD) - 20=
17/05/05 0:15:37 CUST [2017/05/04 10:15:37 ET]
Table 'Idomeneus' 9-max Seat #7 is the button
Seat 1: apodive ($2 in chips)=20
Seat 2: Geyko.K ($2.98 in chips)=20
Seat 3: greezex ($2.35 in chips)=20
Seat 4: littelmonste ($0.77 in chips)=20
Seat 5: the_wickstar ($1.18 in chips)=20
Seat 6: baymi ($1.57 in chips)=20
Seat 7: toxizo ($2 in chips)=20
Seat 8: MalyshkinAle ($2.02 in chips)=20
Seat 9: JekaPoyniak ($2 in chips)=20
MalyshkinAle: posts small blind $0.01
JekaPoyniak: posts big blind $0.02
*** HOLE CARDS ***
Dealt to the_wickstar [6c Qc]
apodive: raises $0.03 to $0.05
Geyko.K: folds=20
greezex: calls $0.05
littelmonste: raises $0.13 to $0.18
the_wickstar: folds=20
baymi: folds=20
toxizo: folds=20
MalyshkinAle: folds=20
JekaPoyniak: folds=20
apodive: folds=20
greezex: folds=20
Uncalled bet ($0.13) returned to littelmonste
littelmonste collected $0.18 from pot
littelmonste: doesn't show hand=20
*** SUMMARY ***
Total pot $0.18 | Rake $0=20
Seat 1: apodive folded before Flop
Seat 2: Geyko.K folded before Flop (didn't bet)
Seat 3: greezex folded before Flop
Seat 4: littelmonste collected ($0.18)
Seat 5: the_wickstar folded before Flop (didn't bet)
Seat 6: baymi folded before Flop (didn't bet)
Seat 7: toxizo (button) folded before Flop (didn't bet)
Seat 8: MalyshkinAle (small blind) folded before Flop
Seat 9: JekaPoyniak (big blind) folded before Flop


*********** # 184 **************
PokerStars Hand #169939386880:  Hold'em No Limit ($0.01/$0.02 USD) - 20=
17/05/05 0:15:24 CUST [2017/05/04 10:15:24 ET]
Table 'Benetnash' 9-max Seat #6 is the button
Seat 3: wolf.ukr ($2.92 in chips)=20
Seat 4: AliceX6 ($2.03 in chips)=20
Seat 5: Krol165 ($1.07 in chips)=20
Seat 6: the_wickstar ($0.83 in chips)=20
Seat 7: Donenko345 ($1.03 in chips)=20
Seat 8: HokageVIP ($2 in chips)=20
Seat 9: gizmondouk ($3.13 in chips)=20
Donenko345: posts small blind $0.01
HokageVIP: posts big blind $0.02
Ainur M: sits out=20
*** HOLE CARDS ***
Dealt to the_wickstar [Qd 5h]
gizmondouk: folds=20
wolf.ukr: folds=20
AliceX6: folds=20
Krol165: raises $0.04 to $0.06
the_wickstar: folds=20
Donenko345: folds=20
HokageVIP: folds=20
Uncalled bet ($0.04) returned to Krol165
Krol165 collected $0.05 from pot
Krol165: doesn't show hand=20
*** SUMMARY ***
Total pot $0.05 | Rake $0=20
Seat 3: wolf.ukr folded before Flop (didn't bet)
Seat 4: AliceX6 folded before Flop (didn't bet)
Seat 5: Krol165 collected ($0.05)
Seat 6: the_wickstar (button) folded before Flop (didn't bet)
Seat 7: Donenko345 (small blind) folded before Flop
Seat 8: HokageVIP (big blind) folded before Flop
Seat 9: gizmondouk folded before Flop (didn't bet)


*********** # 185 **************
PokerStars Hand #169939364315:  Hold'em No Limit ($0.01/$0.02 USD) - 20=
17/05/05 0:14:51 CUST [2017/05/04 10:14:51 ET]
Table 'Idomeneus' 9-max Seat #6 is the button
Seat 1: apodive ($2 in chips)=20
Seat 2: Geyko.K ($2.98 in chips)=20
Seat 3: greezex ($2.35 in chips)=20
Seat 4: littelmonste ($0.77 in chips)=20
Seat 5: the_wickstar ($1.18 in chips)=20
Seat 6: baymi ($1.54 in chips)=20
Seat 7: toxizo ($2 in chips)=20
Seat 8: MalyshkinAle ($2.04 in chips)=20
Seat 9: JekaPoyniak ($2 in chips)=20
toxizo: posts small blind $0.01
MalyshkinAle: posts big blind $0.02
*** HOLE CARDS ***
Dealt to the_wickstar [6s Td]
JekaPoyniak: folds=20
apodive: folds=20
Geyko.K: folds=20
greezex: folds=20
littelmonste: folds=20
the_wickstar: folds=20
baymi: raises $0.02 to $0.04
toxizo: folds=20
MalyshkinAle: folds=20
Uncalled bet ($0.02) returned to baymi
baymi collected $0.05 from pot
baymi: doesn't show hand=20
*** SUMMARY ***
Total pot $0.05 | Rake $0=20
Seat 1: apodive folded before Flop (didn't bet)
Seat 2: Geyko.K folded before Flop (didn't bet)
Seat 3: greezex folded before Flop (didn't bet)
Seat 4: littelmonste folded before Flop (didn't bet)
Seat 5: the_wickstar folded before Flop (didn't bet)
Seat 6: baymi (button) collected ($0.05)
Seat 7: toxizo (small blind) folded before Flop
Seat 8: MalyshkinAle (big blind) folded before Flop
Seat 9: JekaPoyniak folded before Flop (didn't bet)


*********** # 186 **************
PokerStars Hand #169939351815:  Hold'em No Limit ($0.01/$0.02 USD) - 20=
17/05/05 0:14:32 CUST [2017/05/04 10:14:32 ET]
Table 'Benetnash' 9-max Seat #5 is the button
Seat 3: wolf.ukr ($2.92 in chips)=20
Seat 4: AliceX6 ($2.09 in chips)=20
Seat 5: Krol165 ($1.07 in chips)=20
Seat 6: the_wickstar ($0.84 in chips)=20
Seat 7: Donenko345 ($1.05 in chips)=20
Seat 8: HokageVIP ($2 in chips)=20
Seat 9: gizmondouk ($3.05 in chips)=20
the_wickstar: posts small blind $0.01
Donenko345: posts big blind $0.02
Ainur M: sits out=20
*** HOLE CARDS ***
Dealt to the_wickstar [6h 2c]
HokageVIP: folds=20
gizmondouk: raises $0.04 to $0.06
wolf.ukr: folds=20
AliceX6: calls $0.06
Krol165: folds=20
the_wickstar: folds=20
Donenko345: folds=20
*** FLOP *** [Kc 9h Kd]
gizmondouk: checks=20
AliceX6: checks=20
*** TURN *** [Kc 9h Kd] [5d]
gizmondouk: bets $0.08
AliceX6: folds=20
Uncalled bet ($0.08) returned to gizmondouk
gizmondouk collected $0.14 from pot
gizmondouk: doesn't show hand=20
*** SUMMARY ***
Total pot $0.15 | Rake $0.01=20
Board [Kc 9h Kd 5d]
Seat 3: wolf.ukr folded before Flop (didn't bet)
Seat 4: AliceX6 folded on the Turn
Seat 5: Krol165 (button) folded before Flop (didn't bet)
Seat 6: the_wickstar (small blind) folded before Flop
Seat 7: Donenko345 (big blind) folded before Flop
Seat 8: HokageVIP folded before Flop (didn't bet)
Seat 9: gizmondouk collected ($0.14)


*********** # 187 **************
PokerStars Hand #169939338247:  Hold'em No Limit ($0.01/$0.02 USD) - 20=
17/05/05 0:14:12 CUST [2017/05/04 10:14:12 ET]
Table 'Idomeneus' 9-max Seat #5 is the button
Seat 1: apodive ($2 in chips)=20
Seat 2: Geyko.K ($2.98 in chips)=20
Seat 3: greezex ($2.43 in chips)=20
Seat 4: littelmonste ($0.77 in chips)=20
Seat 5: the_wickstar ($1.07 in chips)=20
Seat 6: baymi ($1.55 in chips)=20
Seat 7: toxizo ($2 in chips)=20
Seat 8: MalyshkinAle ($2.04 in chips)=20
Seat 9: JekaPoyniak ($2 in chips)=20
baymi: posts small blind $0.01
toxizo: posts big blind $0.02
*** HOLE CARDS ***
Dealt to the_wickstar [As Kh]
MalyshkinAle: folds=20
JekaPoyniak: folds=20
apodive: folds=20
Geyko.K: folds=20
greezex: raises $0.06 to $0.08
littelmonste: folds=20
the_wickstar: raises $0.16 to $0.24
baymi: folds=20
toxizo: folds=20
greezex: folds=20
Uncalled bet ($0.16) returned to the_wickstar
the_wickstar collected $0.19 from pot
*** SUMMARY ***
Total pot $0.19 | Rake $0=20
Seat 1: apodive folded before Flop (didn't bet)
Seat 2: Geyko.K folded before Flop (didn't bet)
Seat 3: greezex folded before Flop
Seat 4: littelmonste folded before Flop (didn't bet)
Seat 5: the_wickstar (button) collected ($0.19)
Seat 6: baymi (small blind) folded before Flop
Seat 7: toxizo (big blind) folded before Flop
Seat 8: MalyshkinAle folded before Flop (didn't bet)
Seat 9: JekaPoyniak folded before Flop (didn't bet)


*********** # 188 **************
PokerStars Hand #169939327243:  Hold'em No Limit ($0.01/$0.02 USD) - 20=
17/05/05 0:13:56 CUST [2017/05/04 10:13:56 ET]
Table 'Benetnash' 9-max Seat #4 is the button
Seat 3: wolf.ukr ($2.92 in chips)=20
Seat 4: AliceX6 ($2 in chips)=20
Seat 5: Krol165 ($1.08 in chips)=20
Seat 6: the_wickstar ($0.86 in chips)=20
Seat 7: Donenko345 ($1.05 in chips)=20
Seat 8: HokageVIP ($2 in chips)=20
Seat 9: gizmondouk ($3.11 in chips)=20
Krol165: posts small blind $0.01
the_wickstar: posts big blind $0.02
Ainur M: sits out=20
*** HOLE CARDS ***
Dealt to the_wickstar [Qc 4h]
Donenko345: folds=20
HokageVIP: folds=20
gizmondouk: raises $0.04 to $0.06
wolf.ukr: folds=20
AliceX6: raises $0.12 to $0.18
Krol165: folds=20
the_wickstar: folds=20
gizmondouk: folds=20
Uncalled bet ($0.12) returned to AliceX6
AliceX6 collected $0.15 from pot
AliceX6: doesn't show hand=20
*** SUMMARY ***
Total pot $0.15 | Rake $0=20
Seat 3: wolf.ukr folded before Flop (didn't bet)
Seat 4: AliceX6 (button) collected ($0.15)
Seat 5: Krol165 (small blind) folded before Flop
Seat 6: the_wickstar (big blind) folded before Flop
Seat 7: Donenko345 folded before Flop (didn't bet)
Seat 8: HokageVIP folded before Flop (didn't bet)
Seat 9: gizmondouk folded before Flop


*********** # 189 **************
PokerStars Hand #169939305688:  Hold'em No Limit ($0.01/$0.02 USD) - 20=
17/05/05 0:13:25 CUST [2017/05/04 10:13:25 ET]
Table 'Benetnash' 9-max Seat #3 is the button
Seat 3: wolf.ukr ($2.92 in chips)=20
Seat 4: AliceX6 ($2 in chips)=20
Seat 5: Krol165 ($1.07 in chips)=20
Seat 6: the_wickstar ($0.86 in chips)=20
Seat 7: Donenko345 ($1.05 in chips)=20
Seat 8: HokageVIP ($2 in chips)=20
Seat 9: gizmondouk ($3.11 in chips)=20
AliceX6: posts small blind $0.01
Krol165: posts big blind $0.02
Ainur M: sits out=20
*** HOLE CARDS ***
Dealt to the_wickstar [8d 2s]
the_wickstar: folds=20
Donenko345: folds=20
HokageVIP: folds=20
gizmondouk: folds=20
wolf.ukr: folds=20
AliceX6: folds=20
Uncalled bet ($0.01) returned to Krol165
Krol165 collected $0.02 from pot
Krol165: doesn't show hand=20
*** SUMMARY ***
Total pot $0.02 | Rake $0=20
Seat 3: wolf.ukr (button) folded before Flop (didn't bet)
Seat 4: AliceX6 (small blind) folded before Flop
Seat 5: Krol165 (big blind) collected ($0.02)
Seat 6: the_wickstar folded before Flop (didn't bet)
Seat 7: Donenko345 folded before Flop (didn't bet)
Seat 8: HokageVIP folded before Flop (didn't bet)
Seat 9: gizmondouk folded before Flop (didn't bet)


*********** # 190 **************
PokerStars Hand #169939288829:  Hold'em No Limit ($0.01/$0.02 USD) - 20=
17/05/05 0:13:00 CUST [2017/05/04 10:13:00 ET]
Table 'Idomeneus' 9-max Seat #4 is the button
Seat 1: apodive ($2 in chips)=20
Seat 2: Geyko.K ($2.98 in chips)=20
Seat 3: greezex ($2.35 in chips)=20
Seat 4: littelmonste ($0.77 in chips)=20
Seat 5: the_wickstar ($1.08 in chips)=20
Seat 6: baymi ($1.63 in chips)=20
Seat 7: toxizo ($2 in chips)=20
Seat 8: MalyshkinAle ($2.04 in chips)=20
Seat 9: JekaPoyniak ($2 in chips)=20
the_wickstar: posts small blind $0.01
baymi: posts big blind $0.02
*** HOLE CARDS ***
Dealt to the_wickstar [8s Kc]
toxizo: folds=20
MalyshkinAle: folds=20
JekaPoyniak: folds=20
apodive: folds=20
Geyko.K: folds=20
greezex: raises $0.06 to $0.08
littelmonste: folds=20
the_wickstar: folds=20
baymi: calls $0.06
*** FLOP *** [As 4s 9d]
baymi: checks=20
greezex: bets $0.12
baymi: folds=20
Uncalled bet ($0.12) returned to greezex
greezex collected $0.16 from pot
greezex: doesn't show hand=20
*** SUMMARY ***
Total pot $0.17 | Rake $0.01=20
Board [As 4s 9d]
Seat 1: apodive folded before Flop (didn't bet)
Seat 2: Geyko.K folded before Flop (didn't bet)
Seat 3: greezex collected ($0.16)
Seat 4: littelmonste (button) folded before Flop (didn't bet)
Seat 5: the_wickstar (small blind) folded before Flop
Seat 6: baymi (big blind) folded on the Flop
Seat 7: toxizo folded before Flop (didn't bet)
Seat 8: MalyshkinAle folded before Flop (didn't bet)
Seat 9: JekaPoyniak folded before Flop (didn't bet)


*********** # 191 **************
PokerStars Hand #169939275890:  Hold'em No Limit ($0.01/$0.02 USD) - 20=
17/05/05 0:12:41 CUST [2017/05/04 10:12:41 ET]
Table 'Idomeneus' 9-max Seat #3 is the button
Seat 1: apodive ($2 in chips)=20
Seat 2: Geyko.K ($2.98 in chips)=20
Seat 3: greezex ($2.32 in chips)=20
Seat 4: littelmonste ($0.78 in chips)=20
Seat 5: the_wickstar ($1.10 in chips)=20
Seat 6: baymi ($1.63 in chips)=20
Seat 7: toxizo ($2 in chips)=20
Seat 8: MalyshkinAle ($2.04 in chips)=20
Seat 9: JekaPoyniak ($2 in chips)=20
littelmonste: posts small blind $0.01
the_wickstar: posts big blind $0.02
*** HOLE CARDS ***
Dealt to the_wickstar [7d Tc]
baymi: folds=20
toxizo: folds=20
MalyshkinAle: folds=20
JekaPoyniak: folds=20
apodive: folds=20
Geyko.K: folds=20
greezex: raises $0.04 to $0.06
littelmonste: folds=20
the_wickstar: folds=20
Uncalled bet ($0.04) returned to greezex
greezex collected $0.05 from pot
greezex: doesn't show hand=20
*** SUMMARY ***
Total pot $0.05 | Rake $0=20
Seat 1: apodive folded before Flop (didn't bet)
Seat 2: Geyko.K folded before Flop (didn't bet)
Seat 3: greezex (button) collected ($0.05)
Seat 4: littelmonste (small blind) folded before Flop
Seat 5: the_wickstar (big blind) folded before Flop
Seat 6: baymi folded before Flop (didn't bet)
Seat 7: toxizo folded before Flop (didn't bet)
Seat 8: MalyshkinAle folded before Flop (didn't bet)
Seat 9: JekaPoyniak folded before Flop (didn't bet)


*********** # 192 **************
PokerStars Hand #169939258915:  Hold'em No Limit ($0.01/$0.02 USD) - 20=
17/05/05 0:12:16 CUST [2017/05/04 10:12:16 ET]
Table 'Benetnash' 9-max Seat #1 is the button
Seat 1: KoXa8319 ($2 in chips)=20
Seat 3: wolf.ukr ($2.77 in chips)=20
Seat 4: AliceX6 ($2 in chips)=20
Seat 5: Krol165 ($1.07 in chips)=20
Seat 6: the_wickstar ($0.86 in chips)=20
Seat 7: Donenko345 ($1.05 in chips)=20
Seat 8: HokageVIP ($2 in chips)=20
Seat 9: gizmondouk ($3.25 in chips)=20
Ainur M will be allowed to play after the button
wolf.ukr: posts small blind $0.01
AliceX6: posts big blind $0.02
*** HOLE CARDS ***
Dealt to the_wickstar [6d Kc]
Krol165: folds=20
the_wickstar: folds=20
Donenko345: folds=20
HokageVIP: folds=20
gizmondouk: raises $0.04 to $0.06
KoXa8319: folds=20
wolf.ukr: calls $0.05
AliceX6: folds=20
*** FLOP *** [3d Ts 7h]
wolf.ukr: checks=20
gizmondouk: bets $0.08
wolf.ukr: calls $0.08
*** TURN *** [3d Ts 7h] [Ks]
wolf.ukr: checks=20
gizmondouk: checks=20
*** RIVER *** [3d Ts 7h Ks] [4s]
wolf.ukr: bets $0.18
gizmondouk: folds=20
Uncalled bet ($0.18) returned to wolf.ukr
wolf.ukr collected $0.29 from pot
*** SUMMARY ***
Total pot $0.30 | Rake $0.01=20
Board [3d Ts 7h Ks 4s]
Seat 1: KoXa8319 (button) folded before Flop (didn't bet)
Seat 3: wolf.ukr (small blind) collected ($0.29)
Seat 4: AliceX6 (big blind) folded before Flop
Seat 5: Krol165 folded before Flop (didn't bet)
Seat 6: the_wickstar folded before Flop (didn't bet)
Seat 7: Donenko345 folded before Flop (didn't bet)
Seat 8: HokageVIP folded before Flop (didn't bet)
Seat 9: gizmondouk folded on the River


*********** # 193 **************
PokerStars Hand #169939233264:  Hold'em No Limit ($0.01/$0.02 USD) - 20=
17/05/05 0:11:39 CUST [2017/05/04 10:11:39 ET]
Table 'Idomeneus' 9-max Seat #2 is the button
Seat 1: apodive ($2 in chips)=20
Seat 2: Geyko.K ($2.68 in chips)=20
Seat 3: greezex ($2.33 in chips)=20
Seat 4: littelmonste ($0.80 in chips)=20
Seat 5: the_wickstar ($1.10 in chips)=20
Seat 6: baymi ($1.63 in chips)=20
Seat 7: toxizo ($2 in chips)=20
Seat 8: MalyshkinAle ($2.04 in chips)=20
Seat 9: JekaPoyniak ($2 in chips)=20
greezex: posts small blind $0.01
littelmonste: posts big blind $0.02
*** HOLE CARDS ***
Dealt to the_wickstar [6s Jd]
the_wickstar: folds=20
baymi: folds=20
toxizo: folds=20
MalyshkinAle: folds=20
JekaPoyniak: raises $0.06 to $0.08
apodive: folds=20
Geyko.K: raises $0.06 to $0.14
greezex: folds=20
littelmonste: folds=20
JekaPoyniak: calls $0.06
*** FLOP *** [5c 6h Qh]
JekaPoyniak: bets $0.15
Geyko.K: raises $0.15 to $0.30
JekaPoyniak: folds=20
Uncalled bet ($0.15) returned to Geyko.K
Geyko.K collected $0.59 from pot
Geyko.K: doesn't show hand=20
*** SUMMARY ***
Total pot $0.61 | Rake $0.02=20
Board [5c 6h Qh]
Seat 1: apodive folded before Flop (didn't bet)
Seat 2: Geyko.K (button) collected ($0.59)
Seat 3: greezex (small blind) folded before Flop
Seat 4: littelmonste (big blind) folded before Flop
Seat 5: the_wickstar folded before Flop (didn't bet)
Seat 6: baymi folded before Flop (didn't bet)
Seat 7: toxizo folded before Flop (didn't bet)
Seat 8: MalyshkinAle folded before Flop (didn't bet)
Seat 9: JekaPoyniak folded on the Flop


*********** # 194 **************
PokerStars Hand #169939230961:  Hold'em No Limit ($0.01/$0.02 USD) - 20=
17/05/05 0:11:35 CUST [2017/05/04 10:11:35 ET]
Table 'Benetnash' 9-max Seat #9 is the button
Seat 1: KoXa8319 ($2 in chips)=20
Seat 3: wolf.ukr ($2.79 in chips)=20
Seat 5: Krol165 ($1.07 in chips)=20
Seat 6: the_wickstar ($0.88 in chips)=20
Seat 7: Donenko345 ($1 in chips)=20
Seat 8: HokageVIP ($2 in chips)=20
Seat 9: gizmondouk ($3.25 in chips)=20
KoXa8319: posts small blind $0.01
MalyshkinAle: is sitting out=20
wolf.ukr: posts big blind $0.02
AliceX6: sits out=20
*** HOLE CARDS ***
Dealt to the_wickstar [Qh Ts]
Krol165: folds=20
MalyshkinAle leaves the table
the_wickstar: calls $0.02
Donenko345: raises $0.07 to $0.09
HokageVIP: folds=20
Ainur M joins the table at seat #2=20
gizmondouk: folds=20
KoXa8319: folds=20
wolf.ukr: folds=20
the_wickstar: folds=20
Uncalled bet ($0.07) returned to Donenko345
Donenko345 collected $0.07 from pot
Donenko345: doesn't show hand=20
*** SUMMARY ***
Total pot $0.07 | Rake $0=20
Seat 1: KoXa8319 (small blind) folded before Flop
Seat 3: wolf.ukr (big blind) folded before Flop
Seat 5: Krol165 folded before Flop (didn't bet)
Seat 6: the_wickstar folded before Flop
Seat 7: Donenko345 collected ($0.07)
Seat 8: HokageVIP folded before Flop (didn't bet)
Seat 9: gizmondouk (button) folded before Flop (didn't bet)


*********** # 195 **************
PokerStars Hand #169939213725:  Hold'em No Limit ($0.01/$0.02 USD) - 20=
17/05/05 0:11:10 CUST [2017/05/04 10:11:10 ET]
Table 'Idomeneus' 9-max Seat #1 is the button
Seat 1: apodive ($2 in chips)=20
Seat 2: Geyko.K ($2.69 in chips)=20
Seat 3: greezex ($2.35 in chips)=20
Seat 5: the_wickstar ($1.10 in chips)=20
Seat 6: baymi ($1.60 in chips)=20
Seat 7: toxizo ($2 in chips)=20
Seat 8: MalyshkinAle ($2.04 in chips)=20
Seat 9: JekaPoyniak ($2 in chips)=20
Geyko.K: posts small blind $0.01
greezex: posts big blind $0.02
littelmonste: sits out=20
*** HOLE CARDS ***
Dealt to the_wickstar [Js 7s]
the_wickstar: folds=20
baymi: raises $0.02 to $0.04
toxizo: folds=20
MalyshkinAle: folds=20
JekaPoyniak: folds=20
apodive: folds=20
Geyko.K: folds=20
greezex: folds=20
Uncalled bet ($0.02) returned to baymi
baymi collected $0.05 from pot
*** SUMMARY ***
Total pot $0.05 | Rake $0=20
Seat 1: apodive (button) folded before Flop (didn't bet)
Seat 2: Geyko.K (small blind) folded before Flop
Seat 3: greezex (big blind) folded before Flop
Seat 5: the_wickstar folded before Flop (didn't bet)
Seat 6: baymi collected ($0.05)
Seat 7: toxizo folded before Flop (didn't bet)
Seat 8: MalyshkinAle folded before Flop (didn't bet)
Seat 9: JekaPoyniak folded before Flop (didn't bet)


*********** # 196 **************
PokerStars Hand #169939208784:  Hold'em No Limit ($0.01/$0.02 USD) - 20=
17/05/05 0:11:03 CUST [2017/05/04 10:11:03 ET]
Table 'Benetnash' 9-max Seat #8 is the button
Seat 1: KoXa8319 ($2 in chips)=20
Seat 2: MalyshkinAle ($2 in chips)=20
Seat 3: wolf.ukr ($2.79 in chips)=20
Seat 5: Krol165 ($1.07 in chips)=20
Seat 6: the_wickstar ($0.88 in chips)=20
Seat 7: Donenko345 ($1 in chips)=20
Seat 8: HokageVIP ($2 in chips)=20
Seat 9: gizmondouk ($3.26 in chips)=20
gizmondouk: posts small blind $0.01
KoXa8319: posts big blind $0.02
AliceX6: sits out=20
*** HOLE CARDS ***
Dealt to the_wickstar [Qc 5s]
MalyshkinAle: raises $0.04 to $0.06
wolf.ukr: folds=20
Krol165: folds=20
the_wickstar: folds=20
Donenko345: folds=20
HokageVIP: calls $0.06
gizmondouk: folds=20
KoXa8319: folds=20
*** FLOP *** [9d 4c 6c]
MalyshkinAle: bets $0.07
HokageVIP: folds=20
Uncalled bet ($0.07) returned to MalyshkinAle
MalyshkinAle collected $0.14 from pot
MalyshkinAle: doesn't show hand=20
*** SUMMARY ***
Total pot $0.15 | Rake $0.01=20
Board [9d 4c 6c]
Seat 1: KoXa8319 (big blind) folded before Flop
Seat 2: MalyshkinAle collected ($0.14)
Seat 3: wolf.ukr folded before Flop (didn't bet)
Seat 5: Krol165 folded before Flop (didn't bet)
Seat 6: the_wickstar folded before Flop (didn't bet)
Seat 7: Donenko345 folded before Flop (didn't bet)
Seat 8: HokageVIP (button) folded on the Flop
Seat 9: gizmondouk (small blind) folded before Flop


*********** # 197 **************
PokerStars Hand #169939189119:  Hold'em No Limit ($0.01/$0.02 USD) - 20=
17/05/05 0:10:34 CUST [2017/05/04 10:10:34 ET]
Table 'Idomeneus' 9-max Seat #9 is the button
Seat 1: apodive ($2 in chips)=20
Seat 2: Geyko.K ($2.71 in chips)=20
Seat 3: greezex ($2.35 in chips)=20
Seat 4: Bozzuka ($2.59 in chips)=20
Seat 5: the_wickstar ($1.10 in chips)=20
Seat 6: baymi ($1.57 in chips)=20
Seat 7: toxizo ($2 in chips)=20
Seat 8: MalyshkinAle ($2.04 in chips)=20
Seat 9: JekaPoyniak ($2 in chips)=20
apodive: posts small blind $0.01
Geyko.K: posts big blind $0.02
*** HOLE CARDS ***
Dealt to the_wickstar [2s Ac]
greezex: folds=20
Bozzuka: folds=20
the_wickstar: folds=20
baymi: raises $0.02 to $0.04
toxizo: folds=20
MalyshkinAle: folds=20
JekaPoyniak: folds=20
Bozzuka leaves the table
apodive: folds=20
Geyko.K: folds=20
Uncalled bet ($0.02) returned to baymi
baymi collected $0.05 from pot
littelmonste joins the table at seat #4=20
*** SUMMARY ***
Total pot $0.05 | Rake $0=20
Seat 1: apodive (small blind) folded before Flop
Seat 2: Geyko.K (big blind) folded before Flop
Seat 3: greezex folded before Flop (didn't bet)
Seat 4: Bozzuka folded before Flop (didn't bet)
Seat 5: the_wickstar folded before Flop (didn't bet)
Seat 6: baymi collected ($0.05)
Seat 7: toxizo folded before Flop (didn't bet)
Seat 8: MalyshkinAle folded before Flop (didn't bet)
Seat 9: JekaPoyniak (button) folded before Flop (didn't bet)


*********** # 198 **************
PokerStars Hand #169939177686:  Hold'em No Limit ($0.01/$0.02 USD) - 20=
17/05/05 0:10:17 CUST [2017/05/04 10:10:17 ET]
Table 'Benetnash' 9-max Seat #7 is the button
Seat 1: KoXa8319 ($2 in chips)=20
Seat 2: MalyshkinAle ($2 in chips)=20
Seat 3: wolf.ukr ($2.76 in chips)=20
Seat 5: Krol165 ($1.07 in chips)=20
Seat 6: the_wickstar ($0.88 in chips)=20
Seat 7: Donenko345 ($1 in chips)=20
Seat 8: HokageVIP ($2 in chips)=20
Seat 9: gizmondouk ($3.28 in chips)=20
HokageVIP: posts small blind $0.01
gizmondouk: posts big blind $0.02
AliceX6: sits out=20
*** HOLE CARDS ***
Dealt to the_wickstar [9d Ks]
KoXa8319: folds=20
MalyshkinAle: folds=20
wolf.ukr: raises $0.04 to $0.06
Krol165: folds=20
the_wickstar: folds=20
Donenko345: folds=20
HokageVIP: folds=20
gizmondouk: folds=20
Uncalled bet ($0.04) returned to wolf.ukr
wolf.ukr collected $0.05 from pot
*** SUMMARY ***
Total pot $0.05 | Rake $0=20
Seat 1: KoXa8319 folded before Flop (didn't bet)
Seat 2: MalyshkinAle folded before Flop (didn't bet)
Seat 3: wolf.ukr collected ($0.05)
Seat 5: Krol165 folded before Flop (didn't bet)
Seat 6: the_wickstar folded before Flop (didn't bet)
Seat 7: Donenko345 (button) folded before Flop (didn't bet)
Seat 8: HokageVIP (small blind) folded before Flop
Seat 9: gizmondouk (big blind) folded before Flop


*********** # 199 **************
PokerStars Hand #169939154073:  Hold'em No Limit ($0.01/$0.02 USD) - 20=
17/05/05 0:09:42 CUST [2017/05/04 10:09:42 ET]
Table 'Idomeneus' 9-max Seat #8 is the button
Seat 1: apodive ($2 in chips)=20
Seat 2: Geyko.K ($2.71 in chips)=20
Seat 3: greezex ($2.32 in chips)=20
Seat 4: Bozzuka ($2.59 in chips)=20
Seat 5: the_wickstar ($1.10 in chips)=20
Seat 6: baymi ($1.57 in chips)=20
Seat 7: toxizo ($2 in chips)=20
Seat 8: MalyshkinAle ($2.04 in chips)=20
Seat 9: JekaPoyniak ($2 in chips)=20
JekaPoyniak: posts small blind $0.01
apodive: posts big blind $0.02
*** HOLE CARDS ***
Dealt to the_wickstar [As 6c]
Geyko.K: folds=20
greezex: raises $0.06 to $0.08
Bozzuka: folds=20
the_wickstar: folds=20
baymi: folds=20
toxizo: folds=20
MalyshkinAle: folds=20
JekaPoyniak: folds=20
apodive: folds=20
Uncalled bet ($0.06) returned to greezex
greezex collected $0.05 from pot
greezex: doesn't show hand=20
*** SUMMARY ***
Total pot $0.05 | Rake $0=20
Seat 1: apodive (big blind) folded before Flop
Seat 2: Geyko.K folded before Flop (didn't bet)
Seat 3: greezex collected ($0.05)
Seat 4: Bozzuka folded before Flop (didn't bet)
Seat 5: the_wickstar folded before Flop (didn't bet)
Seat 6: baymi folded before Flop (didn't bet)
Seat 7: toxizo folded before Flop (didn't bet)
Seat 8: MalyshkinAle (button) folded before Flop (didn't bet)
Seat 9: JekaPoyniak (small blind) folded before Flop


*********** # 200 **************
PokerStars Hand #169939149225:  Hold'em No Limit ($0.01/$0.02 USD) - 20=
17/05/05 0:09:35 CUST [2017/05/04 10:09:35 ET]
Table 'Benetnash' 9-max Seat #6 is the button
Seat 1: KoXa8319 ($2 in chips)=20
Seat 2: MalyshkinAle ($2 in chips)=20
Seat 3: wolf.ukr ($2.76 in chips)=20
Seat 5: Krol165 ($1.07 in chips)=20
Seat 6: the_wickstar ($0.79 in chips)=20
Seat 7: Donenko345 ($1.01 in chips)=20
Seat 8: HokageVIP ($2 in chips)=20
Seat 9: gizmondouk ($3.28 in chips)=20
Donenko345: posts small blind $0.01
HokageVIP: posts big blind $0.02
AliceX6: sits out=20
*** HOLE CARDS ***
Dealt to the_wickstar [Th Td]
gizmondouk: folds=20
KoXa8319: raises $0.04 to $0.06
MalyshkinAle: folds=20
wolf.ukr: folds=20
Krol165: folds=20
the_wickstar: raises $0.06 to $0.12
Donenko345: folds=20
HokageVIP: folds=20
KoXa8319: folds=20
Uncalled bet ($0.06) returned to the_wickstar
the_wickstar collected $0.15 from pot
*** SUMMARY ***
Total pot $0.15 | Rake $0=20
Seat 1: KoXa8319 folded before Flop
Seat 2: MalyshkinAle folded before Flop (didn't bet)
Seat 3: wolf.ukr folded before Flop (didn't bet)
Seat 5: Krol165 folded before Flop (didn't bet)
Seat 6: the_wickstar (button) collected ($0.15)
Seat 7: Donenko345 (small blind) folded before Flop
Seat 8: HokageVIP (big blind) folded before Flop
Seat 9: gizmondouk folded before Flop (didn't bet)



If you have any questions, please contact us at "PokerStars Support" <s=
upport@pokerstars.com>


