Delivered-To: sherhan.wicky@gmail.com
Received: by 10.79.162.140 with SMTP id k12csp306953ivh;
        Sun, 23 Apr 2017 21:21:09 -0700 (PDT)
X-Received: by 10.28.10.67 with SMTP id 64mr8126950wmk.126.1493007669704;
        Sun, 23 Apr 2017 21:21:09 -0700 (PDT)
Return-Path: <support@pokerstars.com>
Received: from mx13.pokerstars.eu (mx13.pokerstars.eu. [77.87.179.125])
        by mx.google.com with ESMTPS id s37si2038459eda.251.2017.04.23.21.21.09
        for <sherhan.wicky@gmail.com>
        (version=TLS1_2 cipher=ECDHE-RSA-AES128-GCM-SHA256 bits=128/128);
        Sun, 23 Apr 2017 21:21:09 -0700 (PDT)
Received-SPF: pass (google.com: domain of support@pokerstars.com designates 77.87.179.125 as permitted sender) client-ip=77.87.179.125;
Authentication-Results: mx.google.com;
       dkim=pass (test mode) header.i=@pokerstars.com;
       spf=pass (google.com: domain of support@pokerstars.com designates 77.87.179.125 as permitted sender) smtp.mailfrom=support@pokerstars.com
Received: by mx13.pokerstars.eu (mailer, from userid 503)
	id F35BF1FCD694; Mon, 24 Apr 2017 00:21:08 -0400 (EDT)
DKIM-Signature: v=1; a=rsa-sha1; c=relaxed; d=pokerstars.com; h=date
	:from:to:subject:message-id:mime-version:content-type
	:content-transfer-encoding; s=s1024; bh=sQfrTBatb2PjTUEZfsCFNzY4
	i3A=; b=sT9SLwYDdHvdjq6ucEwSY8MaipDMN3PZLBz/8wTKVQY1mbu1vwyx1GS8
	9iD0BcbSPtV85kTNrF8lR+vCj1gmCHmCB2Cz9CZxiFZ/Ihhhlb1VgAw1rvnBcGaQ
	NzLkb/xmRIyQt3d+bk8ERlD6B+2UmM0Qr8PqPQoVhCcw3gJdnwc=
X-PS-ID: c2hlcmhhbi53aWNreUBnbWFpbC5jb20=
Received: from pokerstars.com (IOM-20-81 [192.168.8.81])
	by mx13.pokerstars.eu (mailer) with SMTP id DC4F01FCD6DE
	for <sherhan.wicky@gmail.com>; Mon, 24 Apr 2017 00:21:08 -0400 (EDT)
Date: Mon, 24 Apr 2017 00:21:08 -0400
From: "PokerStars Support" <support@pokerstars.com>
To: sherhan.wicky@gmail.com
Subject: PokerStars Hand History Request - last 1 week of play
Message-Id: <58FD7D34.7AFE3AA7D1702E@pokerstars.com>
MIME-Version: 1.0
Content-Type: text/plain;
 charset="windows-1252"
Content-Transfer-Encoding: quoted-printable


Transcript for last 1 week of play requested by the_wickstar (sherhan.w=
icky@gmail.com)

*********** # 1 **************
PokerStars Hand #169407909222:  Hold'em No Limit ($0.01/$0.02 USD) - 20=
17/04/23 4:05:39 CUST [2017/04/22 14:05:39 ET]
Table 'Joella' 9-max Seat #3 is the button
Seat 2: the_wickstar ($1.32 in chips)=20
Seat 3: oSkARiLLo85 ($0.89 in chips)=20
Seat 4: yjqian23 ($1.98 in chips)=20
Seat 5: Chernovsky ($2.51 in chips)=20
Seat 6: kiiits82 ($1.66 in chips)=20
Seat 8: infiniti888 ($2.19 in chips)=20
Seat 9: Rimsky101 ($2.07 in chips)=20
yjqian23: posts small blind $0.01
Chernovsky: posts big blind $0.02
sedoided: sits out=20
*** HOLE CARDS ***
Dealt to the_wickstar [Qs 5d]
kiiits82 has timed out
kiiits82: folds=20
infiniti888: folds=20
Rimsky101: folds=20
the_wickstar: folds=20
oSkARiLLo85: calls $0.02
yjqian23: calls $0.01
Chernovsky: checks=20
*** FLOP *** [8c Th Tc]
yjqian23: checks=20
Chernovsky: checks=20
oSkARiLLo85: checks=20
*** TURN *** [8c Th Tc] [6c]
yjqian23: checks=20
Chernovsky: checks=20
oSkARiLLo85: checks=20
*** RIVER *** [8c Th Tc 6c] [5h]
yjqian23: checks=20
the_wickstar leaves the table
Chernovsky: checks=20
oSkARiLLo85: checks=20
*** SHOW DOWN ***
yjqian23: shows [Ah 9d] (a pair of Tens)
Chernovsky: shows [5s Kd] (two pair, Tens and Fives)
oSkARiLLo85: mucks hand=20
Chernovsky collected $0.06 from pot
*** SUMMARY ***
Total pot $0.06 | Rake $0=20
Board [8c Th Tc 6c 5h]
Seat 2: the_wickstar folded before Flop (didn't bet)
Seat 3: oSkARiLLo85 (button) mucked [3h Ad]
Seat 4: yjqian23 (small blind) showed [Ah 9d] and lost with a pair of T=
ens
Seat 5: Chernovsky (big blind) showed [5s Kd] and won ($0.06) with two =
pair, Tens and Fives
Seat 6: kiiits82 folded before Flop (didn't bet)
Seat 8: infiniti888 folded before Flop (didn't bet)
Seat 9: Rimsky101 folded before Flop (didn't bet)


*********** # 2 **************
PokerStars Hand #169407851278:  Hold'em No Limit ($0.01/$0.02 USD) - 20=
17/04/23 4:04:27 CUST [2017/04/22 14:04:27 ET]
Table 'Joella' 9-max Seat #2 is the button
Seat 2: the_wickstar ($1.10 in chips)=20
Seat 3: oSkARiLLo85 ($1.11 in chips)=20
Seat 4: yjqian23 ($2 in chips)=20
Seat 5: Chernovsky ($2.51 in chips)=20
Seat 6: kiiits82 ($1.66 in chips)=20
Seat 8: infiniti888 ($2.19 in chips)=20
Seat 9: Rimsky101 ($2.07 in chips)=20
oSkARiLLo85: posts small blind $0.01
yjqian23: posts big blind $0.02
sedoided: sits out=20
*** HOLE CARDS ***
Dealt to the_wickstar [Tc Ac]
Chernovsky: folds=20
kiiits82: folds=20
infiniti888: folds=20
Rimsky101: folds=20
the_wickstar: raises $0.04 to $0.06
oSkARiLLo85: calls $0.05
yjqian23: folds=20
*** FLOP *** [2s 7c 5c]
oSkARiLLo85: bets $0.06
the_wickstar: raises $0.06 to $0.12
oSkARiLLo85: calls $0.06
*** TURN *** [2s 7c 5c] [2d]
oSkARiLLo85: bets $0.02
the_wickstar: calls $0.02
*** RIVER *** [2s 7c 5c 2d] [9c]
oSkARiLLo85: bets $0.02
the_wickstar: raises $0.39 to $0.41
oSkARiLLo85: folds=20
Uncalled bet ($0.39) returned to the_wickstar
the_wickstar collected $0.44 from pot
*** SUMMARY ***
Total pot $0.46 | Rake $0.02=20
Board [2s 7c 5c 2d 9c]
Seat 2: the_wickstar (button) collected ($0.44)
Seat 3: oSkARiLLo85 (small blind) folded on the River
Seat 4: yjqian23 (big blind) folded before Flop
Seat 5: Chernovsky folded before Flop (didn't bet)
Seat 6: kiiits82 folded before Flop (didn't bet)
Seat 8: infiniti888 folded before Flop (didn't bet)
Seat 9: Rimsky101 folded before Flop (didn't bet)


*********** # 3 **************
PokerStars Hand #169407823620:  Hold'em No Limit ($0.01/$0.02 USD) - 20=
17/04/23 4:03:52 CUST [2017/04/22 14:03:52 ET]
Table 'Joella' 9-max Seat #9 is the button
Seat 2: the_wickstar ($1.11 in chips)=20
Seat 3: oSkARiLLo85 ($1.18 in chips)=20
Seat 5: Chernovsky ($2.51 in chips)=20
Seat 6: kiiits82 ($1.66 in chips)=20
Seat 8: infiniti888 ($2.19 in chips)=20
Seat 9: Rimsky101 ($2 in chips)=20
the_wickstar: posts small blind $0.01
oSkARiLLo85: posts big blind $0.02
yjqian23: sits out=20
sedoided: sits out=20
*** HOLE CARDS ***
Dealt to the_wickstar [3c 2h]
Chernovsky: folds=20
kiiits82: folds=20
infiniti888: folds=20
Rimsky101: raises $0.03 to $0.05
the_wickstar: folds=20
oSkARiLLo85: calls $0.03
*** FLOP *** [Qc Ks 5s]
oSkARiLLo85: bets $0.02
Rimsky101: raises $0.04 to $0.06
oSkARiLLo85: folds=20
Uncalled bet ($0.04) returned to Rimsky101
Rimsky101 collected $0.14 from pot
Rimsky101: doesn't show hand=20
*** SUMMARY ***
Total pot $0.15 | Rake $0.01=20
Board [Qc Ks 5s]
Seat 2: the_wickstar (small blind) folded before Flop
Seat 3: oSkARiLLo85 (big blind) folded on the Flop
Seat 5: Chernovsky folded before Flop (didn't bet)
Seat 6: kiiits82 folded before Flop (didn't bet)
Seat 8: infiniti888 folded before Flop (didn't bet)
Seat 9: Rimsky101 (button) collected ($0.14)


*********** # 4 **************
PokerStars Hand #169407807240:  Hold'em No Limit ($0.01/$0.02 USD) - 20=
17/04/23 4:03:32 CUST [2017/04/22 14:03:32 ET]
Table 'Joella' 9-max Seat #8 is the button
Seat 2: the_wickstar ($1.13 in chips)=20
Seat 3: oSkARiLLo85 ($1.15 in chips)=20
Seat 5: Chernovsky ($2.51 in chips)=20
Seat 6: kiiits82 ($1.66 in chips)=20
Seat 8: infiniti888 ($2.19 in chips)=20
Seat 9: Rimsky101 ($2 in chips)=20
Rimsky101: posts small blind $0.01
the_wickstar: posts big blind $0.02
yjqian23: sits out=20
sedoided: sits out=20
*** HOLE CARDS ***
Dealt to the_wickstar [Th 8h]
oSkARiLLo85: raises $0.02 to $0.04
Chernovsky: folds=20
kiiits82: folds=20
infiniti888: folds=20
Rimsky101: folds=20
the_wickstar: folds=20
Uncalled bet ($0.02) returned to oSkARiLLo85
oSkARiLLo85 collected $0.05 from pot
oSkARiLLo85: doesn't show hand=20
*** SUMMARY ***
Total pot $0.05 | Rake $0=20
Seat 2: the_wickstar (big blind) folded before Flop
Seat 3: oSkARiLLo85 collected ($0.05)
Seat 5: Chernovsky folded before Flop (didn't bet)
Seat 6: kiiits82 folded before Flop (didn't bet)
Seat 8: infiniti888 (button) folded before Flop (didn't bet)
Seat 9: Rimsky101 (small blind) folded before Flop


*********** # 5 **************
PokerStars Hand #169407760047:  Hold'em No Limit ($0.01/$0.02 USD) - 20=
17/04/23 4:02:33 CUST [2017/04/22 14:02:33 ET]
Table 'Joella' 9-max Seat #6 is the button
Seat 1: ThaMilkyman ($2.05 in chips)=20
Seat 2: the_wickstar ($1.13 in chips)=20
Seat 3: oSkARiLLo85 ($1.33 in chips)=20
Seat 5: Chernovsky ($2.51 in chips)=20
Seat 6: kiiits82 ($1.46 in chips)=20
Seat 7: michispaw ($3.11 in chips)=20
Seat 8: infiniti888 ($2.21 in chips)=20
Seat 9: Rimsky101 ($2 in chips)=20
michispaw: posts small blind $0.01
infiniti888: posts big blind $0.02
yjqian23: sits out=20
*** HOLE CARDS ***
Dealt to the_wickstar [Jd 9h]
Rimsky101: folds=20
ThaMilkyman: folds=20
the_wickstar: folds=20
oSkARiLLo85: calls $0.02
Chernovsky: folds=20
kiiits82: raises $0.10 to $0.12
michispaw: folds=20
infiniti888: folds=20
oSkARiLLo85: calls $0.10
*** FLOP *** [4d 6c 5s]
michispaw leaves the table
sedoided joins the table at seat #7=20
oSkARiLLo85: bets $0.02
kiiits82: calls $0.02
*** TURN *** [4d 6c 5s] [Ts]
oSkARiLLo85: bets $0.02
kiiits82: calls $0.02
*** RIVER *** [4d 6c 5s Ts] [Ah]
oSkARiLLo85: bets $0.02
kiiits82: calls $0.02
*** SHOW DOWN ***
oSkARiLLo85: shows [2d Kh] (high card Ace)
kiiits82: shows [Js As] (a pair of Aces)
kiiits82 collected $0.38 from pot
*** SUMMARY ***
Total pot $0.39 | Rake $0.01=20
Board [4d 6c 5s Ts Ah]
Seat 1: ThaMilkyman folded before Flop (didn't bet)
Seat 2: the_wickstar folded before Flop (didn't bet)
Seat 3: oSkARiLLo85 showed [2d Kh] and lost with high card Ace
Seat 5: Chernovsky folded before Flop (didn't bet)
Seat 6: kiiits82 (button) showed [Js As] and won ($0.38) with a pair of=
 Aces
Seat 7: michispaw (small blind) folded before Flop
Seat 8: infiniti888 (big blind) folded before Flop
Seat 9: Rimsky101 folded before Flop (didn't bet)


*********** # 6 **************
PokerStars Hand #169407727940:  Hold'em No Limit ($0.01/$0.02 USD) - 20=
17/04/23 4:01:50 CUST [2017/04/22 14:01:50 ET]
Table 'Enif' 9-max Seat #7 is the button
Seat 1: iliyan66 ($1.99 in chips)=20
Seat 2: the_wickstar ($1.04 in chips)=20
Seat 4: RastaBoss777 ($1.20 in chips)=20
Seat 7: Helmut969 ($1.63 in chips)=20
Seat 8: Schewczik ($1.90 in chips)=20
Schewczik: posts small blind $0.01
iliyan66: posts big blind $0.02
Rolkomolko: sits out=20
Aracidus: sits out=20
*** HOLE CARDS ***
Dealt to the_wickstar [8h Ah]
Radom94 leaves the table
the_wickstar: folds=20
the_wickstar leaves the table
elenkachumak joins the table at seat #9=20
RastaBoss777: raises $0.04 to $0.06
Helmut969: folds=20
Schewczik: raises $0.14 to $0.20
iliyan66: folds=20
gladyseirium joins the table at seat #2=20
RastaBoss777: calls $0.14
*** FLOP *** [Js 5h 6s]
Schewczik: bets $0.22
RastaBoss777: folds=20
Uncalled bet ($0.22) returned to Schewczik
Schewczik collected $0.41 from pot
Schewczik: doesn't show hand=20
*** SUMMARY ***
Total pot $0.42 | Rake $0.01=20
Board [Js 5h 6s]
Seat 1: iliyan66 (big blind) folded before Flop
Seat 2: the_wickstar folded before Flop (didn't bet)
Seat 4: RastaBoss777 folded on the Flop
Seat 7: Helmut969 (button) folded before Flop (didn't bet)
Seat 8: Schewczik (small blind) collected ($0.41)


*********** # 7 **************
PokerStars Hand #169407709588:  Hold'em No Limit ($0.01/$0.02 USD) - 20=
17/04/23 4:01:25 CUST [2017/04/22 14:01:25 ET]
Table 'Enif' 9-max Seat #4 is the button
Seat 1: iliyan66 ($1.58 in chips)=20
Seat 2: the_wickstar ($1.04 in chips)=20
Seat 4: RastaBoss777 ($1.20 in chips)=20
Seat 7: Helmut969 ($1.64 in chips)=20
Seat 8: Schewczik ($1.92 in chips)=20
Seat 9: Radom94 ($0.41 in chips)=20
Aracidus will be allowed to play after the button
Helmut969: posts small blind $0.01
Schewczik: posts big blind $0.02
Rolkomolko: sits out=20
*** HOLE CARDS ***
Dealt to the_wickstar [Td 7c]
Radom94: raises $0.02 to $0.04
iliyan66: raises $1.54 to $1.58 and is all-in
the_wickstar: folds=20
RastaBoss777: folds=20
Helmut969: folds=20
Schewczik: folds=20
Radom94: calls $0.37 and is all-in
Uncalled bet ($1.17) returned to iliyan66
*** FLOP *** [Jc Qh 5h]
*** TURN *** [Jc Qh 5h] [4d]
*** RIVER *** [Jc Qh 5h 4d] [8h]
*** SHOW DOWN ***
Radom94: shows [6c 6h] (a pair of Sixes)
iliyan66: shows [Ah Kh] (a flush, Ace high)
iliyan66 collected $0.82 from pot
*** SUMMARY ***
Total pot $0.85 | Rake $0.03=20
Board [Jc Qh 5h 4d 8h]
Seat 1: iliyan66 showed [Ah Kh] and won ($0.82) with a flush, Ace high
Seat 2: the_wickstar folded before Flop (didn't bet)
Seat 4: RastaBoss777 (button) folded before Flop (didn't bet)
Seat 7: Helmut969 (small blind) folded before Flop
Seat 8: Schewczik (big blind) folded before Flop
Seat 9: Radom94 showed [6c 6h] and lost with a pair of Sixes


*********** # 8 **************
PokerStars Hand #169407704770:  Hold'em No Limit ($0.01/$0.02 USD) - 20=
17/04/23 4:01:18 CUST [2017/04/22 14:01:18 ET]
Table 'Joella' 9-max Seat #5 is the button
Seat 1: ThaMilkyman ($2.05 in chips)=20
Seat 2: the_wickstar ($1.13 in chips)=20
Seat 3: oSkARiLLo85 ($1.02 in chips)=20
Seat 5: Chernovsky ($2.51 in chips)=20
Seat 6: kiiits82 ($1.77 in chips)=20
Seat 7: michispaw ($3.13 in chips)=20
Seat 8: infiniti888 ($2.21 in chips)=20
Seat 9: Rimsky101 ($2 in chips)=20
kiiits82: posts small blind $0.01
michispaw: posts big blind $0.02
yjqian23: sits out=20
*** HOLE CARDS ***
Dealt to the_wickstar [9d 2s]
infiniti888 has timed out
infiniti888: folds=20
Rimsky101: folds=20
ThaMilkyman: folds=20
the_wickstar: folds=20
oSkARiLLo85: calls $0.02
Chernovsky: folds=20
kiiits82: raises $0.12 to $0.14
michispaw: folds=20
oSkARiLLo85: calls $0.12
*** FLOP *** [5c 6d 8h]
kiiits82: bets $0.15
oSkARiLLo85: calls $0.15
*** TURN *** [5c 6d 8h] [Th]
kiiits82: checks=20
oSkARiLLo85: bets $0.02
kiiits82: calls $0.02
*** RIVER *** [5c 6d 8h Th] [Ks]
kiiits82: checks=20
oSkARiLLo85: checks=20
*** SHOW DOWN ***
kiiits82: shows [Ad Ah] (a pair of Aces)
oSkARiLLo85: shows [Kh 8s] (two pair, Kings and Eights)
oSkARiLLo85 collected $0.62 from pot
*** SUMMARY ***
Total pot $0.64 | Rake $0.02=20
Board [5c 6d 8h Th Ks]
Seat 1: ThaMilkyman folded before Flop (didn't bet)
Seat 2: the_wickstar folded before Flop (didn't bet)
Seat 3: oSkARiLLo85 showed [Kh 8s] and won ($0.62) with two pair, Kings=
 and Eights
Seat 5: Chernovsky (button) folded before Flop (didn't bet)
Seat 6: kiiits82 (small blind) showed [Ad Ah] and lost with a pair of A=
ces
Seat 7: michispaw (big blind) folded before Flop
Seat 8: infiniti888 folded before Flop (didn't bet)
Seat 9: Rimsky101 folded before Flop (didn't bet)


*********** # 9 **************
PokerStars Hand #169407683670:  Hold'em No Limit ($0.01/$0.02 USD) - 20=
17/04/23 4:00:48 CUST [2017/04/22 14:00:48 ET]
Table 'Joella' 9-max Seat #3 is the button
Seat 1: ThaMilkyman ($2.05 in chips)=20
Seat 2: the_wickstar ($1.13 in chips)=20
Seat 3: oSkARiLLo85 ($1.22 in chips)=20
Seat 5: Chernovsky ($2.52 in chips)=20
Seat 6: kiiits82 ($1.79 in chips)=20
Seat 7: michispaw ($3.13 in chips)=20
Seat 8: infiniti888 ($2 in chips)=20
Seat 9: Rimsky101 ($2 in chips)=20
yjqian23 will be allowed to play after the button
Chernovsky: posts small blind $0.01
kiiits82: posts big blind $0.02
*** HOLE CARDS ***
Dealt to the_wickstar [Th 8c]
michispaw: folds=20
infiniti888: raises $0.18 to $0.20
Rimsky101: folds=20
ThaMilkyman: folds=20
the_wickstar: folds=20
oSkARiLLo85: calls $0.20
Chernovsky: folds=20
kiiits82: folds=20
*** FLOP *** [Ac Ad 3h]
infiniti888: bets $0.21
oSkARiLLo85: folds=20
Uncalled bet ($0.21) returned to infiniti888
infiniti888 collected $0.41 from pot
*** SUMMARY ***
Total pot $0.43 | Rake $0.02=20
Board [Ac Ad 3h]
Seat 1: ThaMilkyman folded before Flop (didn't bet)
Seat 2: the_wickstar folded before Flop (didn't bet)
Seat 3: oSkARiLLo85 (button) folded on the Flop
Seat 5: Chernovsky (small blind) folded before Flop
Seat 6: kiiits82 (big blind) folded before Flop
Seat 7: michispaw folded before Flop (didn't bet)
Seat 8: infiniti888 collected ($0.41)
Seat 9: Rimsky101 folded before Flop (didn't bet)


*********** # 10 **************
PokerStars Hand #169407671241:  Hold'em No Limit ($0.01/$0.02 USD) - 20=
17/04/23 4:00:29 CUST [2017/04/22 14:00:29 ET]
Table 'Enif' 9-max Seat #3 is the button
Seat 1: iliyan66 ($1.58 in chips)=20
Seat 2: the_wickstar ($1.06 in chips)=20
Seat 3: sergey347 ($1.50 in chips)=20
Seat 4: RastaBoss777 ($1.22 in chips)=20
Seat 7: Helmut969 ($1.60 in chips)=20
Seat 8: Schewczik ($1.92 in chips)=20
Seat 9: Radom94 ($0.41 in chips)=20
RastaBoss777: posts small blind $0.01
Helmut969: posts big blind $0.02
*** HOLE CARDS ***
Dealt to the_wickstar [7d Ah]
Schewczik: folds=20
Radom94: folds=20
iliyan66: folds=20
the_wickstar: calls $0.02
sergey347: folds=20
sergey347 leaves the table
Rolkomolko joins the table at seat #3=20
RastaBoss777: calls $0.01
Helmut969: checks=20
*** FLOP *** [Kd 7h Th]
RastaBoss777: checks=20
Helmut969: bets $0.08
the_wickstar: folds=20
RastaBoss777: folds=20
Uncalled bet ($0.08) returned to Helmut969
Helmut969 collected $0.06 from pot
*** SUMMARY ***
Total pot $0.06 | Rake $0=20
Board [Kd 7h Th]
Seat 1: iliyan66 folded before Flop (didn't bet)
Seat 2: the_wickstar folded on the Flop
Seat 3: sergey347 (button) folded before Flop (didn't bet)
Seat 4: RastaBoss777 (small blind) folded on the Flop
Seat 7: Helmut969 (big blind) collected ($0.06)
Seat 8: Schewczik folded before Flop (didn't bet)
Seat 9: Radom94 folded before Flop (didn't bet)


*********** # 11 **************
PokerStars Hand #169407656657:  Hold'em No Limit ($0.01/$0.02 USD) - 20=
17/04/23 4:00:07 CUST [2017/04/22 14:00:07 ET]
Table 'Joella' 9-max Seat #2 is the button
Seat 1: ThaMilkyman ($2.05 in chips)=20
Seat 2: the_wickstar ($1.15 in chips)=20
Seat 3: oSkARiLLo85 ($1.18 in chips)=20
Seat 5: Chernovsky ($2.54 in chips)=20
Seat 6: kiiits82 ($1.79 in chips)=20
Seat 7: michispaw ($3.13 in chips)=20
Seat 8: infiniti888 ($2 in chips)=20
Seat 9: Rimsky101 ($2 in chips)=20
oSkARiLLo85: posts small blind $0.01
enchantressA: is sitting out=20
enchantressA leaves the table
Chernovsky: posts big blind $0.02
*** HOLE CARDS ***
Dealt to the_wickstar [Qc 7s]
kiiits82: folds=20
yjqian23 joins the table at seat #4=20
michispaw: folds=20
infiniti888: folds=20
Rimsky101: folds=20
ThaMilkyman: folds=20
the_wickstar: calls $0.02
oSkARiLLo85: calls $0.01
Chernovsky: checks=20
*** FLOP *** [6h 4s 9c]
oSkARiLLo85: bets $0.10
Chernovsky: folds=20
the_wickstar: folds=20
Uncalled bet ($0.10) returned to oSkARiLLo85
oSkARiLLo85 collected $0.06 from pot
oSkARiLLo85: doesn't show hand=20
*** SUMMARY ***
Total pot $0.06 | Rake $0=20
Board [6h 4s 9c]
Seat 1: ThaMilkyman folded before Flop (didn't bet)
Seat 2: the_wickstar (button) folded on the Flop
Seat 3: oSkARiLLo85 (small blind) collected ($0.06)
Seat 5: Chernovsky (big blind) folded on the Flop
Seat 6: kiiits82 folded before Flop (didn't bet)
Seat 7: michispaw folded before Flop (didn't bet)
Seat 8: infiniti888 folded before Flop (didn't bet)
Seat 9: Rimsky101 folded before Flop (didn't bet)


*********** # 12 **************
PokerStars Hand #169407639673:  Hold'em No Limit ($0.01/$0.02 USD) - 20=
17/04/23 3:59:45 CUST [2017/04/22 13:59:45 ET]
Table 'Enif' 9-max Seat #2 is the button
Seat 1: iliyan66 ($1.58 in chips)=20
Seat 2: the_wickstar ($1.06 in chips)=20
Seat 3: sergey347 ($1.51 in chips)=20
Seat 4: RastaBoss777 ($1.26 in chips)=20
Seat 7: Helmut969 ($1.55 in chips)=20
Seat 8: Schewczik ($1.92 in chips)=20
Seat 9: Radom94 ($0.41 in chips)=20
sergey347: posts small blind $0.01
RastaBoss777: posts big blind $0.02
*** HOLE CARDS ***
Dealt to the_wickstar [8s 3h]
Helmut969: calls $0.02
Schewczik: folds=20
Radom94: folds=20
iliyan66: folds=20
the_wickstar: folds=20
sergey347: folds=20
RastaBoss777: raises $0.02 to $0.04
Helmut969: calls $0.02
*** FLOP *** [6d 6s 2c]
RastaBoss777: checks=20
Helmut969: bets $0.08
RastaBoss777: folds=20
Uncalled bet ($0.08) returned to Helmut969
Helmut969 collected $0.09 from pot
*** SUMMARY ***
Total pot $0.09 | Rake $0=20
Board [6d 6s 2c]
Seat 1: iliyan66 folded before Flop (didn't bet)
Seat 2: the_wickstar (button) folded before Flop (didn't bet)
Seat 3: sergey347 (small blind) folded before Flop
Seat 4: RastaBoss777 (big blind) folded on the Flop
Seat 7: Helmut969 collected ($0.09)
Seat 8: Schewczik folded before Flop (didn't bet)
Seat 9: Radom94 folded before Flop (didn't bet)


*********** # 13 **************
PokerStars Hand #169407629676:  Hold'em No Limit ($0.01/$0.02 USD) - 20=
17/04/23 3:59:29 CUST [2017/04/22 13:59:29 ET]
Table 'Joella' 9-max Seat #1 is the button
Seat 1: ThaMilkyman ($2.05 in chips)=20
Seat 2: the_wickstar ($1.21 in chips)=20
Seat 3: oSkARiLLo85 ($1.07 in chips)=20
Seat 4: enchantressA ($3.71 in chips)=20
Seat 5: Chernovsky ($2.54 in chips)=20
Seat 6: kiiits82 ($1.79 in chips)=20
Seat 7: michispaw ($3.13 in chips)=20
Seat 8: infiniti888 ($2 in chips)=20
Seat 9: Rimsky101 ($2 in chips)=20
the_wickstar: posts small blind $0.01
oSkARiLLo85: posts big blind $0.02
*** HOLE CARDS ***
Dealt to the_wickstar [Kd Qd]
enchantressA: raises $0.04 to $0.06
Chernovsky: folds=20
kiiits82: folds=20
michispaw: folds=20
infiniti888: folds=20
Rimsky101: folds=20
ThaMilkyman: folds=20
the_wickstar: calls $0.05
oSkARiLLo85: calls $0.04
*** FLOP *** [9h 9s Js]
the_wickstar: checks=20
oSkARiLLo85: bets $0.14
enchantressA: folds=20
the_wickstar: folds=20
Uncalled bet ($0.14) returned to oSkARiLLo85
oSkARiLLo85 collected $0.17 from pot
oSkARiLLo85: doesn't show hand=20
*** SUMMARY ***
Total pot $0.18 | Rake $0.01=20
Board [9h 9s Js]
Seat 1: ThaMilkyman (button) folded before Flop (didn't bet)
Seat 2: the_wickstar (small blind) folded on the Flop
Seat 3: oSkARiLLo85 (big blind) collected ($0.17)
Seat 4: enchantressA folded on the Flop
Seat 5: Chernovsky folded before Flop (didn't bet)
Seat 6: kiiits82 folded before Flop (didn't bet)
Seat 7: michispaw folded before Flop (didn't bet)
Seat 8: infiniti888 folded before Flop (didn't bet)
Seat 9: Rimsky101 folded before Flop (didn't bet)


*********** # 14 **************
PokerStars Hand #169407603035:  Hold'em No Limit ($0.01/$0.02 USD) - 20=
17/04/23 3:58:46 CUST [2017/04/22 13:58:46 ET]
Table 'Joella' 9-max Seat #9 is the button
Seat 1: ThaMilkyman ($2.06 in chips)=20
Seat 2: the_wickstar ($1.23 in chips)=20
Seat 3: oSkARiLLo85 ($1.09 in chips)=20
Seat 4: enchantressA ($3.71 in chips)=20
Seat 5: Chernovsky ($2.49 in chips)=20
Seat 6: kiiits82 ($1.79 in chips)=20
Seat 7: michispaw ($3.13 in chips)=20
Seat 8: infiniti888 ($2 in chips)=20
Seat 9: Rimsky101 ($2 in chips)=20
ThaMilkyman: posts small blind $0.01
the_wickstar: posts big blind $0.02
*** HOLE CARDS ***
Dealt to the_wickstar [Jc 8d]
oSkARiLLo85: calls $0.02
enchantressA: folds=20
Chernovsky: raises $0.05 to $0.07
kiiits82: folds=20
michispaw: folds=20
infiniti888: folds=20
Rimsky101: folds=20
ThaMilkyman: folds=20
the_wickstar: folds=20
oSkARiLLo85: folds=20
Uncalled bet ($0.05) returned to Chernovsky
Chernovsky collected $0.07 from pot
Chernovsky: doesn't show hand=20
*** SUMMARY ***
Total pot $0.07 | Rake $0=20
Seat 1: ThaMilkyman (small blind) folded before Flop
Seat 2: the_wickstar (big blind) folded before Flop
Seat 3: oSkARiLLo85 folded before Flop
Seat 4: enchantressA folded before Flop (didn't bet)
Seat 5: Chernovsky collected ($0.07)
Seat 6: kiiits82 folded before Flop (didn't bet)
Seat 7: michispaw folded before Flop (didn't bet)
Seat 8: infiniti888 folded before Flop (didn't bet)
Seat 9: Rimsky101 (button) folded before Flop (didn't bet)


*********** # 15 **************
PokerStars Hand #169407589902:  Hold'em No Limit ($0.01/$0.02 USD) - 20=
17/04/23 3:58:25 CUST [2017/04/22 13:58:25 ET]
Table 'Enif' 9-max Seat #1 is the button
Seat 1: iliyan66 ($1.58 in chips)=20
Seat 2: the_wickstar ($1 in chips)=20
Seat 3: sergey347 ($1.53 in chips)=20
Seat 4: RastaBoss777 ($1.28 in chips)=20
Seat 5: space127 ($2.75 in chips)=20
Seat 6: Aracidus ($0.95 in chips)=20
Seat 7: Helmut969 ($1.57 in chips)=20
Seat 8: Schewczik ($1.92 in chips)=20
Seat 9: Radom94 ($0.41 in chips)=20
the_wickstar: posts small blind $0.01
sergey347: posts big blind $0.02
*** HOLE CARDS ***
Dealt to the_wickstar [Tc 8c]
RastaBoss777: calls $0.02
space127 has timed out
space127: folds=20
Aracidus: folds=20
Helmut969: calls $0.02
Schewczik: folds=20
Radom94: folds=20
iliyan66: folds=20
the_wickstar: calls $0.01
sergey347: checks=20
*** FLOP *** [Ts 6s 8d]
the_wickstar: bets $0.08
sergey347: folds=20
RastaBoss777: folds=20
Helmut969: folds=20
Uncalled bet ($0.08) returned to the_wickstar
the_wickstar collected $0.08 from pot
*** SUMMARY ***
Total pot $0.08 | Rake $0=20
Board [Ts 6s 8d]
Seat 1: iliyan66 (button) folded before Flop (didn't bet)
Seat 2: the_wickstar (small blind) collected ($0.08)
Seat 3: sergey347 (big blind) folded on the Flop
Seat 4: RastaBoss777 folded on the Flop
Seat 5: space127 folded before Flop (didn't bet)
Seat 6: Aracidus folded before Flop (didn't bet)
Seat 7: Helmut969 folded on the Flop
Seat 8: Schewczik folded before Flop (didn't bet)
Seat 9: Radom94 folded before Flop (didn't bet)


*********** # 16 **************
PokerStars Hand #169407553266:  Hold'em No Limit ($0.01/$0.02 USD) - 20=
17/04/23 3:57:25 CUST [2017/04/22 13:57:25 ET]
Table 'Joella' 9-max Seat #8 is the button
Seat 1: ThaMilkyman ($2.08 in chips)=20
Seat 2: the_wickstar ($1.58 in chips)=20
Seat 3: oSkARiLLo85 ($0.35 in chips)=20
Seat 4: enchantressA ($3.71 in chips)=20
Seat 5: Chernovsky ($2.49 in chips)=20
Seat 6: kiiits82 ($2.14 in chips)=20
Seat 7: michispaw ($3.13 in chips)=20
Seat 8: infiniti888 ($2 in chips)=20
Seat 9: Rimsky101 ($2 in chips)=20
Rimsky101: posts small blind $0.01
ThaMilkyman: posts big blind $0.02
*** HOLE CARDS ***
Dealt to the_wickstar [8h 8d]
the_wickstar: raises $0.04 to $0.06
oSkARiLLo85: calls $0.06
enchantressA: folds=20
Chernovsky: folds=20
kiiits82: calls $0.06
michispaw: folds=20
infiniti888: folds=20
Rimsky101: calls $0.05
ThaMilkyman: folds=20
*** FLOP *** [4d 5h 7h]
Rimsky101: checks=20
the_wickstar: bets $0.25
oSkARiLLo85: raises $0.04 to $0.29 and is all-in
kiiits82: calls $0.29
Rimsky101: folds=20
the_wickstar: calls $0.04
*** TURN *** [4d 5h 7h] [5s]
the_wickstar: checks=20
kiiits82: checks=20
*** RIVER *** [4d 5h 7h 5s] [Td]
the_wickstar: checks=20
kiiits82: checks=20
*** SHOW DOWN ***
the_wickstar: shows [8h 8d] (two pair, Eights and Fives)
oSkARiLLo85: shows [8s 6c] (a straight, Four to Eight)
kiiits82: mucks hand=20
oSkARiLLo85 collected $1.09 from pot
*** SUMMARY ***
Total pot $1.13 | Rake $0.04=20
Board [4d 5h 7h 5s Td]
Seat 1: ThaMilkyman (big blind) folded before Flop
Seat 2: the_wickstar showed [8h 8d] and lost with two pair, Eights and =
Fives
Seat 3: oSkARiLLo85 showed [8s 6c] and won ($1.09) with a straight, Fou=
r to Eight
Seat 4: enchantressA folded before Flop (didn't bet)
Seat 5: Chernovsky folded before Flop (didn't bet)
Seat 6: kiiits82 mucked [Ac 7c]
Seat 7: michispaw folded before Flop (didn't bet)
Seat 8: infiniti888 (button) folded before Flop (didn't bet)
Seat 9: Rimsky101 (small blind) folded on the Flop


*********** # 17 **************
PokerStars Hand #169407511183:  Hold'em No Limit ($0.01/$0.02 USD) - 20=
17/04/23 3:56:17 CUST [2017/04/22 13:56:17 ET]
Table 'Joella' 9-max Seat #7 is the button
Seat 1: ThaMilkyman ($2.08 in chips)=20
Seat 2: the_wickstar ($1.58 in chips)=20
Seat 3: oSkARiLLo85 ($0.47 in chips)=20
Seat 4: enchantressA ($3.71 in chips)=20
Seat 5: Chernovsky ($2.49 in chips)=20
Seat 6: kiiits82 ($2.14 in chips)=20
Seat 7: michispaw ($2.99 in chips)=20
Seat 8: infiniti888 ($2 in chips)=20
Seat 9: Rimsky101 ($2 in chips)=20
infiniti888: posts small blind $0.01
Rimsky101: posts big blind $0.02
*** HOLE CARDS ***
Dealt to the_wickstar [2h Kh]
ThaMilkyman: folds=20
the_wickstar: folds=20
oSkARiLLo85: calls $0.02
enchantressA: folds=20
Chernovsky: folds=20
kiiits82: folds=20
michispaw: raises $0.04 to $0.06
infiniti888: folds=20
Rimsky101: folds=20
oSkARiLLo85: calls $0.04
*** FLOP *** [Jc Ad Ts]
oSkARiLLo85: bets $0.02
michispaw: calls $0.02
*** TURN *** [Jc Ad Ts] [2s]
oSkARiLLo85: bets $0.02
michispaw: calls $0.02
*** RIVER *** [Jc Ad Ts 2s] [Ac]
oSkARiLLo85: bets $0.02
michispaw: calls $0.02
*** SHOW DOWN ***
oSkARiLLo85: shows [Qc 9c] (a pair of Aces)
michispaw: shows [9h 9d] (two pair, Aces and Nines)
michispaw collected $0.26 from pot
*** SUMMARY ***
Total pot $0.27 | Rake $0.01=20
Board [Jc Ad Ts 2s Ac]
Seat 1: ThaMilkyman folded before Flop (didn't bet)
Seat 2: the_wickstar folded before Flop (didn't bet)
Seat 3: oSkARiLLo85 showed [Qc 9c] and lost with a pair of Aces
Seat 4: enchantressA folded before Flop (didn't bet)
Seat 5: Chernovsky folded before Flop (didn't bet)
Seat 6: kiiits82 folded before Flop (didn't bet)
Seat 7: michispaw (button) showed [9h 9d] and won ($0.26) with two pair=
, Aces and Nines
Seat 8: infiniti888 (small blind) folded before Flop
Seat 9: Rimsky101 (big blind) folded before Flop


*********** # 18 **************
PokerStars Hand #169407492081:  Hold'em No Limit ($0.01/$0.02 USD) - 20=
17/04/23 3:55:45 CUST [2017/04/22 13:55:45 ET]
Table 'Joella' 9-max Seat #6 is the button
Seat 1: ThaMilkyman ($2 in chips)=20
Seat 2: the_wickstar ($1.58 in chips)=20
Seat 3: oSkARiLLo85 ($0.53 in chips)=20
Seat 4: enchantressA ($3.71 in chips)=20
Seat 5: Chernovsky ($2.49 in chips)=20
Seat 6: kiiits82 ($2.14 in chips)=20
Seat 7: michispaw ($3 in chips)=20
Seat 8: infiniti888 ($2 in chips)=20
michispaw: posts small blind $0.01
infiniti888: posts big blind $0.02
Rimsky101: sits out=20
*** HOLE CARDS ***
Dealt to the_wickstar [Ts 5s]
ThaMilkyman: raises $0.04 to $0.06
the_wickstar: folds=20
oSkARiLLo85: calls $0.06
enchantressA: folds=20
Chernovsky: folds=20
kiiits82: folds=20
michispaw: folds=20
infiniti888: folds=20
*** FLOP *** [Jh 4h 3d]
ThaMilkyman: bets $0.10
oSkARiLLo85: folds=20
Uncalled bet ($0.10) returned to ThaMilkyman
ThaMilkyman collected $0.14 from pot
ThaMilkyman: doesn't show hand=20
*** SUMMARY ***
Total pot $0.15 | Rake $0.01=20
Board [Jh 4h 3d]
Seat 1: ThaMilkyman collected ($0.14)
Seat 2: the_wickstar folded before Flop (didn't bet)
Seat 3: oSkARiLLo85 folded on the Flop
Seat 4: enchantressA folded before Flop (didn't bet)
Seat 5: Chernovsky folded before Flop (didn't bet)
Seat 6: kiiits82 (button) folded before Flop (didn't bet)
Seat 7: michispaw (small blind) folded before Flop
Seat 8: infiniti888 (big blind) folded before Flop


*********** # 19 **************
PokerStars Hand #169407488192:  Hold'em No Limit ($0.01/$0.02 USD) - 20=
17/04/23 3:55:38 CUST [2017/04/22 13:55:38 ET]
Table 'Enif' 9-max Seat #9 is the button
Seat 1: iliyan66 ($1.66 in chips)=20
Seat 2: the_wickstar ($1.08 in chips)=20
Seat 3: sergey347 ($1.79 in chips)=20
Seat 4: RastaBoss777 ($1.28 in chips)=20
Seat 5: space127 ($2.28 in chips)=20
Seat 6: Aracidus ($0.95 in chips)=20
Seat 7: Helmut969 ($1.57 in chips)=20
Seat 8: Schewczik ($2 in chips)=20
Seat 9: Radom94 ($0.41 in chips)=20
iliyan66: posts small blind $0.01
the_wickstar: posts big blind $0.02
Schewczik: posts big blind $0.02
*** HOLE CARDS ***
Dealt to the_wickstar [2c 3c]
sergey347: calls $0.02
RastaBoss777: folds=20
space127: raises $0.04 to $0.06
Aracidus: folds=20
Helmut969: folds=20
Schewczik: calls $0.04
Radom94: folds=20
iliyan66: calls $0.05
the_wickstar: calls $0.04
sergey347: calls $0.04
*** FLOP *** [7c Qs 6c]
iliyan66: checks=20
the_wickstar: checks=20
sergey347: checks=20
space127: bets $0.02
Schewczik: calls $0.02
iliyan66: calls $0.02
the_wickstar: calls $0.02
sergey347: calls $0.02
*** TURN *** [7c Qs 6c] [As]
iliyan66: checks=20
the_wickstar: checks=20
sergey347: bets $0.08
space127: raises $0.10 to $0.18
Schewczik: folds=20
iliyan66: folds=20
the_wickstar: folds=20
sergey347: calls $0.10
*** RIVER *** [7c Qs 6c As] [3s]
sergey347: checks=20
space127: checks=20
*** SHOW DOWN ***
sergey347: shows [Jd Ah] (a pair of Aces)
space127: shows [Ad Kc] (a pair of Aces - King kicker)
space127 collected $0.73 from pot
*** SUMMARY ***
Total pot $0.76 | Rake $0.03=20
Board [7c Qs 6c As 3s]
Seat 1: iliyan66 (small blind) folded on the Turn
Seat 2: the_wickstar (big blind) folded on the Turn
Seat 3: sergey347 showed [Jd Ah] and lost with a pair of Aces
Seat 4: RastaBoss777 folded before Flop (didn't bet)
Seat 5: space127 showed [Ad Kc] and won ($0.73) with a pair of Aces
Seat 6: Aracidus folded before Flop (didn't bet)
Seat 7: Helmut969 folded before Flop (didn't bet)
Seat 8: Schewczik folded on the Turn
Seat 9: Radom94 (button) folded before Flop (didn't bet)


*********** # 20 **************
PokerStars Hand #169407479099:  Hold'em No Limit ($0.01/$0.02 USD) - 20=
17/04/23 3:55:23 CUST [2017/04/22 13:55:23 ET]
Table 'Joella' 9-max Seat #5 is the button
Seat 1: ThaMilkyman ($1.97 in chips)=20
Seat 2: the_wickstar ($1.58 in chips)=20
Seat 3: oSkARiLLo85 ($0.53 in chips)=20
Seat 4: enchantressA ($3.71 in chips)=20
Seat 5: Chernovsky ($2.49 in chips)=20
Seat 6: kiiits82 ($2.15 in chips)=20
Seat 7: michispaw ($3.02 in chips)=20
kiiits82: posts small blind $0.01
michispaw: posts big blind $0.02
infiniti888: sits out=20
Rimsky101: sits out=20
*** HOLE CARDS ***
Dealt to the_wickstar [9h 7h]
ThaMilkyman: raises $0.04 to $0.06
the_wickstar: folds=20
oSkARiLLo85: folds=20
enchantressA: folds=20
Chernovsky: folds=20
kiiits82: folds=20
michispaw: folds=20
Uncalled bet ($0.04) returned to ThaMilkyman
ThaMilkyman collected $0.05 from pot
ThaMilkyman: doesn't show hand=20
*** SUMMARY ***
Total pot $0.05 | Rake $0=20
Seat 1: ThaMilkyman collected ($0.05)
Seat 2: the_wickstar folded before Flop (didn't bet)
Seat 3: oSkARiLLo85 folded before Flop (didn't bet)
Seat 4: enchantressA folded before Flop (didn't bet)
Seat 5: Chernovsky (button) folded before Flop (didn't bet)
Seat 6: kiiits82 (small blind) folded before Flop
Seat 7: michispaw (big blind) folded before Flop


*********** # 21 **************
PokerStars Hand #169407451988:  Hold'em No Limit ($0.01/$0.02 USD) - 20=
17/04/23 3:54:46 CUST [2017/04/22 13:54:46 ET]
Table 'Joella' 9-max Seat #4 is the button
Seat 1: ThaMilkyman ($1.97 in chips)=20
Seat 2: the_wickstar ($1.58 in chips)=20
Seat 3: oSkARiLLo85 ($0.53 in chips)=20
Seat 4: enchantressA ($3.60 in chips)=20
Seat 5: Chernovsky ($2.50 in chips)=20
Seat 6: kiiits82 ($2.26 in chips)=20
Seat 7: michispaw ($3.02 in chips)=20
Seat 9: All IN-Fort ($2.49 in chips)=20
Chernovsky: posts small blind $0.01
kiiits82: posts big blind $0.02
infiniti888: sits out=20
*** HOLE CARDS ***
Dealt to the_wickstar [4s 8c]
michispaw: folds=20
All IN-Fort: folds=20
ThaMilkyman: folds=20
All IN-Fort leaves the table
Rimsky101 joins the table at seat #9=20
the_wickstar: folds=20
oSkARiLLo85: folds=20
enchantressA: raises $0.04 to $0.06
Chernovsky: folds=20
kiiits82: calls $0.04
*** FLOP *** [Th 4d Kh]
kiiits82: checks=20
enchantressA: checks=20
*** TURN *** [Th 4d Kh] [6d]
kiiits82: checks=20
enchantressA: bets $0.05
kiiits82: calls $0.05
*** RIVER *** [Th 4d Kh 6d] [7h]
kiiits82: checks=20
enchantressA: checks=20
*** SHOW DOWN ***
kiiits82: shows [As Js] (high card Ace)
enchantressA: shows [Ts 9d] (a pair of Tens)
enchantressA collected $0.22 from pot
*** SUMMARY ***
Total pot $0.23 | Rake $0.01=20
Board [Th 4d Kh 6d 7h]
Seat 1: ThaMilkyman folded before Flop (didn't bet)
Seat 2: the_wickstar folded before Flop (didn't bet)
Seat 3: oSkARiLLo85 folded before Flop (didn't bet)
Seat 4: enchantressA (button) showed [Ts 9d] and won ($0.22) with a pai=
r of Tens
Seat 5: Chernovsky (small blind) folded before Flop
Seat 6: kiiits82 (big blind) showed [As Js] and lost with high card Ace
Seat 7: michispaw folded before Flop (didn't bet)
Seat 9: All IN-Fort folded before Flop (didn't bet)


*********** # 22 **************
PokerStars Hand #169407413428:  Hold'em No Limit ($0.01/$0.02 USD) - 20=
17/04/23 3:53:58 CUST [2017/04/22 13:53:58 ET]
Table 'Joella' 9-max Seat #3 is the button
Seat 1: ThaMilkyman ($1.97 in chips)=20
Seat 2: the_wickstar ($1.64 in chips)=20
Seat 3: oSkARiLLo85 ($0.22 in chips)=20
Seat 4: enchantressA ($3.61 in chips)=20
Seat 5: Chernovsky ($2.52 in chips)=20
Seat 6: kiiits82 ($2.28 in chips)=20
Seat 7: michispaw ($3.02 in chips)=20
Seat 9: All IN-Fort ($2.71 in chips)=20
enchantressA: posts small blind $0.01
Chernovsky: posts big blind $0.02
infiniti888: sits out=20
*** HOLE CARDS ***
Dealt to the_wickstar [Jc Kc]
kiiits82: calls $0.02
michispaw: folds=20
All IN-Fort: raises $0.04 to $0.06
ThaMilkyman: folds=20
the_wickstar: calls $0.06
oSkARiLLo85: raises $0.16 to $0.22 and is all-in
enchantressA: folds=20
Chernovsky: folds=20
kiiits82: folds=20
All IN-Fort: raises $0.16 to $0.38
the_wickstar: folds=20
Uncalled bet ($0.16) returned to All IN-Fort
*** FLOP *** [Td Ad Js]
*** TURN *** [Td Ad Js] [8c]
*** RIVER *** [Td Ad Js 8c] [5s]
*** SHOW DOWN ***
All IN-Fort: shows [7s 8d] (a pair of Eights)
oSkARiLLo85: shows [Ac 3c] (a pair of Aces)
oSkARiLLo85 collected $0.53 from pot
*** SUMMARY ***
Total pot $0.55 | Rake $0.02=20
Board [Td Ad Js 8c 5s]
Seat 1: ThaMilkyman folded before Flop (didn't bet)
Seat 2: the_wickstar folded before Flop
Seat 3: oSkARiLLo85 (button) showed [Ac 3c] and won ($0.53) with a pair=
 of Aces
Seat 4: enchantressA (small blind) folded before Flop
Seat 5: Chernovsky (big blind) folded before Flop
Seat 6: kiiits82 folded before Flop
Seat 7: michispaw folded before Flop (didn't bet)
Seat 9: All IN-Fort showed [7s 8d] and lost with a pair of Eights


*********** # 23 **************
PokerStars Hand #169407401386:  Hold'em No Limit ($0.01/$0.02 USD) - 20=
17/04/23 3:53:43 CUST [2017/04/22 13:53:43 ET]
Table 'Enif' 9-max Seat #7 is the button
Seat 1: iliyan66 ($1.93 in chips)=20
Seat 2: the_wickstar ($0.79 in chips)=20
Seat 3: sergey347 ($1.79 in chips)=20
Seat 4: RastaBoss777 ($1.30 in chips)=20
Seat 5: space127 ($2.28 in chips)=20
Seat 6: Aracidus ($0.95 in chips)=20
Seat 7: Helmut969 ($1.57 in chips)=20
Seat 9: Radom94 ($0.43 in chips)=20
Schewczik will be allowed to play after the button
Radom94: posts small blind $0.01
iliyan66: posts big blind $0.02
*** HOLE CARDS ***
Dealt to the_wickstar [2s 2h]
the_wickstar: calls $0.02
sergey347: folds=20
RastaBoss777: calls $0.02
space127: folds=20
Aracidus: folds=20
Helmut969: folds=20
Radom94: calls $0.01
iliyan66: checks=20
*** FLOP *** [Qh As 2c]
Radom94: checks=20
iliyan66: checks=20
the_wickstar: bets $0.06
RastaBoss777: folds=20
Radom94: folds=20
iliyan66: calls $0.06
*** TURN *** [Qh As 2c] [Th]
iliyan66: checks=20
the_wickstar: bets $0.19
iliyan66: calls $0.19
*** RIVER *** [Qh As 2c Th] [Js]
iliyan66: checks=20
the_wickstar: checks=20
*** SHOW DOWN ***
iliyan66: shows [Qs Jh] (two pair, Queens and Jacks)
the_wickstar: shows [2s 2h] (three of a kind, Deuces)
the_wickstar collected $0.56 from pot
*** SUMMARY ***
Total pot $0.58 | Rake $0.02=20
Board [Qh As 2c Th Js]
Seat 1: iliyan66 (big blind) showed [Qs Jh] and lost with two pair, Que=
ens and Jacks
Seat 2: the_wickstar showed [2s 2h] and won ($0.56) with three of a kin=
d, Deuces
Seat 3: sergey347 folded before Flop (didn't bet)
Seat 4: RastaBoss777 folded on the Flop
Seat 5: space127 folded before Flop (didn't bet)
Seat 6: Aracidus folded before Flop (didn't bet)
Seat 7: Helmut969 (button) folded before Flop (didn't bet)
Seat 9: Radom94 (small blind) folded on the Flop


*********** # 24 **************
PokerStars Hand #169407363248:  Hold'em No Limit ($0.01/$0.02 USD) - 20=
17/04/23 3:52:55 CUST [2017/04/22 13:52:55 ET]
Table 'Enif' 9-max Seat #6 is the button
Seat 1: iliyan66 ($1.93 in chips)=20
Seat 2: the_wickstar ($0.79 in chips)=20
Seat 3: sergey347 ($1.79 in chips)=20
Seat 4: RastaBoss777 ($1.32 in chips)=20
Seat 5: space127 ($2.28 in chips)=20
Seat 6: Aracidus ($0.95 in chips)=20
Seat 7: Helmut969 ($1.58 in chips)=20
Seat 9: Radom94 ($0.40 in chips)=20
Helmut969: posts small blind $0.01
Tom13333 was removed from the table for failing to post
Radom94: posts big blind $0.02
*** HOLE CARDS ***
Dealt to the_wickstar [3d 7h]
iliyan66: folds=20
the_wickstar: folds=20
sergey347: folds=20
RastaBoss777: calls $0.02
Schewczik joins the table at seat #8=20
space127: folds=20
Aracidus: folds=20
Helmut969: folds=20
Radom94: checks=20
*** FLOP *** [8h 5d 2h]
Radom94: checks=20
RastaBoss777: checks=20
*** TURN *** [8h 5d 2h] [Js]
Radom94: checks=20
RastaBoss777: checks=20
*** RIVER *** [8h 5d 2h Js] [7d]
Radom94: bets $0.06
RastaBoss777: folds=20
Uncalled bet ($0.06) returned to Radom94
Radom94 collected $0.05 from pot
Radom94: doesn't show hand=20
*** SUMMARY ***
Total pot $0.05 | Rake $0=20
Board [8h 5d 2h Js 7d]
Seat 1: iliyan66 folded before Flop (didn't bet)
Seat 2: the_wickstar folded before Flop (didn't bet)
Seat 3: sergey347 folded before Flop (didn't bet)
Seat 4: RastaBoss777 folded on the River
Seat 5: space127 folded before Flop (didn't bet)
Seat 6: Aracidus (button) folded before Flop (didn't bet)
Seat 7: Helmut969 (small blind) folded before Flop
Seat 9: Radom94 (big blind) collected ($0.05)


*********** # 25 **************
PokerStars Hand #169407349537:  Hold'em No Limit ($0.01/$0.02 USD) - 20=
17/04/23 3:52:38 CUST [2017/04/22 13:52:38 ET]
Table 'Joella' 9-max Seat #2 is the button
Seat 1: ThaMilkyman ($1.97 in chips)=20
Seat 2: the_wickstar ($1.41 in chips)=20
Seat 3: oSkARiLLo85 ($0.26 in chips)=20
Seat 4: enchantressA ($3.77 in chips)=20
Seat 5: Chernovsky ($2.52 in chips)=20
Seat 6: kiiits82 ($2.28 in chips)=20
Seat 7: michispaw ($3.06 in chips)=20
Seat 9: All IN-Fort ($2.71 in chips)=20
oSkARiLLo85: posts small blind $0.01
enchantressA: posts big blind $0.02
*** HOLE CARDS ***
Dealt to the_wickstar [4c Qs]
Chernovsky: folds=20
kiiits82: folds=20
infiniti888 joins the table at seat #8=20
michispaw: raises $0.02 to $0.04
All IN-Fort: folds=20
ThaMilkyman: folds=20
the_wickstar: calls $0.04
oSkARiLLo85: calls $0.03
enchantressA: calls $0.02
*** FLOP *** [8d Ks 7c]
oSkARiLLo85: checks=20
enchantressA: checks=20
michispaw: checks=20
the_wickstar: bets $0.12
oSkARiLLo85: folds=20
enchantressA: calls $0.12
michispaw: folds=20
*** TURN *** [8d Ks 7c] [5d]
enchantressA: checks=20
the_wickstar: checks=20
*** RIVER *** [8d Ks 7c 5d] [5c]
enchantressA: checks=20
the_wickstar: checks=20
*** SHOW DOWN ***
enchantressA: shows [9d Jh] (a pair of Fives)
the_wickstar: shows [4c Qs] (a pair of Fives - King+Queen kicker)
the_wickstar collected $0.39 from pot
*** SUMMARY ***
Total pot $0.40 | Rake $0.01=20
Board [8d Ks 7c 5d 5c]
Seat 1: ThaMilkyman folded before Flop (didn't bet)
Seat 2: the_wickstar (button) showed [4c Qs] and won ($0.39) with a pai=
r of Fives
Seat 3: oSkARiLLo85 (small blind) folded on the Flop
Seat 4: enchantressA (big blind) showed [9d Jh] and lost with a pair of=
 Fives
Seat 5: Chernovsky folded before Flop (didn't bet)
Seat 6: kiiits82 folded before Flop (didn't bet)
Seat 7: michispaw folded on the Flop
Seat 9: All IN-Fort folded before Flop (didn't bet)


*********** # 26 **************
PokerStars Hand #169407336914:  Hold'em No Limit ($0.01/$0.02 USD) - 20=
17/04/23 3:52:22 CUST [2017/04/22 13:52:22 ET]
Table 'Enif' 9-max Seat #5 is the button
Seat 1: iliyan66 ($1.93 in chips)=20
Seat 2: the_wickstar ($0.79 in chips)=20
Seat 3: sergey347 ($1.79 in chips)=20
Seat 4: RastaBoss777 ($1.32 in chips)=20
Seat 5: space127 ($2.28 in chips)=20
Seat 6: Aracidus ($0.96 in chips)=20
Seat 7: Helmut969 ($1.60 in chips)=20
Seat 9: Radom94 ($0.37 in chips)=20
Aracidus: posts small blind $0.01
Helmut969: posts big blind $0.02
*** HOLE CARDS ***
Dealt to the_wickstar [Js 7c]
Radom94: raises $0.35 to $0.37 and is all-in
iliyan66: folds=20
the_wickstar: folds=20
sergey347: folds=20
RastaBoss777: folds=20
space127: folds=20
Aracidus: folds=20
Helmut969: folds=20
Uncalled bet ($0.35) returned to Radom94
Radom94 collected $0.05 from pot
Radom94: doesn't show hand=20
*** SUMMARY ***
Total pot $0.05 | Rake $0=20
Seat 1: iliyan66 folded before Flop (didn't bet)
Seat 2: the_wickstar folded before Flop (didn't bet)
Seat 3: sergey347 folded before Flop (didn't bet)
Seat 4: RastaBoss777 folded before Flop (didn't bet)
Seat 5: space127 (button) folded before Flop (didn't bet)
Seat 6: Aracidus (small blind) folded before Flop
Seat 7: Helmut969 (big blind) folded before Flop
Seat 9: Radom94 collected ($0.05)


*********** # 27 **************
PokerStars Hand #169407315690:  Hold'em No Limit ($0.01/$0.02 USD) - 20=
17/04/23 3:51:55 CUST [2017/04/22 13:51:55 ET]
Table 'Joella' 9-max Seat #1 is the button
Seat 1: ThaMilkyman ($1.97 in chips)=20
Seat 2: the_wickstar ($1.37 in chips)=20
Seat 3: oSkARiLLo85 ($0.30 in chips)=20
Seat 4: enchantressA ($3.77 in chips)=20
Seat 5: Chernovsky ($2.52 in chips)=20
Seat 6: kiiits82 ($2.28 in chips)=20
Seat 7: michispaw ($3.06 in chips)=20
Seat 9: All IN-Fort ($2.71 in chips)=20
the_wickstar: posts small blind $0.01
oSkARiLLo85: posts big blind $0.02
*** HOLE CARDS ***
Dealt to the_wickstar [4d Kc]
enchantressA: folds=20
Chernovsky: folds=20
kiiits82: folds=20
michispaw: folds=20
All IN-Fort: folds=20
ThaMilkyman: folds=20
the_wickstar: calls $0.01
oSkARiLLo85: checks=20
*** FLOP *** [Jh Js Qs]
the_wickstar: checks=20
oSkARiLLo85: checks=20
*** TURN *** [Jh Js Qs] [Kh]
the_wickstar: bets $0.02
oSkARiLLo85: calls $0.02
*** RIVER *** [Jh Js Qs Kh] [Qh]
Natsoviy711 leaves the table
the_wickstar: bets $0.02
oSkARiLLo85: folds=20
Uncalled bet ($0.02) returned to the_wickstar
the_wickstar collected $0.08 from pot
*** SUMMARY ***
Total pot $0.08 | Rake $0=20
Board [Jh Js Qs Kh Qh]
Seat 1: ThaMilkyman (button) folded before Flop (didn't bet)
Seat 2: the_wickstar (small blind) collected ($0.08)
Seat 3: oSkARiLLo85 (big blind) folded on the River
Seat 4: enchantressA folded before Flop (didn't bet)
Seat 5: Chernovsky folded before Flop (didn't bet)
Seat 6: kiiits82 folded before Flop (didn't bet)
Seat 7: michispaw folded before Flop (didn't bet)
Seat 9: All IN-Fort folded before Flop (didn't bet)


*********** # 28 **************
PokerStars Hand #169407255349:  Hold'em No Limit ($0.01/$0.02 USD) - 20=
17/04/23 3:50:40 CUST [2017/04/22 13:50:40 ET]
Table 'Joella' 9-max Seat #9 is the button
Seat 1: ThaMilkyman ($1.98 in chips)=20
Seat 2: the_wickstar ($1.39 in chips)=20
Seat 3: oSkARiLLo85 ($0.38 in chips)=20
Seat 4: enchantressA ($2 in chips)=20
Seat 5: Chernovsky ($2.52 in chips)=20
Seat 6: kiiits82 ($2.28 in chips)=20
Seat 7: michispaw ($3.06 in chips)=20
Seat 8: Natsoviy711 ($1.79 in chips)=20
Seat 9: All IN-Fort ($2.71 in chips)=20
ThaMilkyman: posts small blind $0.01
the_wickstar: posts big blind $0.02
*** HOLE CARDS ***
Dealt to the_wickstar [5c Ah]
oSkARiLLo85: calls $0.02
enchantressA: raises $0.06 to $0.08
Chernovsky: folds=20
kiiits82: folds=20
michispaw: folds=20
Natsoviy711: calls $0.08
All IN-Fort: folds=20
ThaMilkyman: folds=20
the_wickstar: folds=20
oSkARiLLo85: calls $0.06
*** FLOP *** [3c 4h Ad]
oSkARiLLo85: checks=20
enchantressA: bets $0.20
Natsoviy711: raises $0.20 to $0.40
oSkARiLLo85: folds=20
enchantressA: raises $0.53 to $0.93
Natsoviy711: calls $0.53
*** TURN *** [3c 4h Ad] [6c]
enchantressA: bets $0.97
Natsoviy711: calls $0.78 and is all-in
Uncalled bet ($0.19) returned to enchantressA
*** RIVER *** [3c 4h Ad 6c] [Kd]
*** SHOW DOWN ***
enchantressA: shows [4s As] (two pair, Aces and Fours)
Natsoviy711: shows [Qs Ac] (a pair of Aces)
enchantressA collected $3.56 from pot
*** SUMMARY ***
Total pot $3.69 | Rake $0.13=20
Board [3c 4h Ad 6c Kd]
Seat 1: ThaMilkyman (small blind) folded before Flop
Seat 2: the_wickstar (big blind) folded before Flop
Seat 3: oSkARiLLo85 folded on the Flop
Seat 4: enchantressA showed [4s As] and won ($3.56) with two pair, Aces=
 and Fours
Seat 5: Chernovsky folded before Flop (didn't bet)
Seat 6: kiiits82 folded before Flop (didn't bet)
Seat 7: michispaw folded before Flop (didn't bet)
Seat 8: Natsoviy711 showed [Qs Ac] and lost with a pair of Aces
Seat 9: All IN-Fort (button) folded before Flop (didn't bet)


*********** # 29 **************
PokerStars Hand #169407236952:  Hold'em No Limit ($0.01/$0.02 USD) - 20=
17/04/23 3:50:17 CUST [2017/04/22 13:50:17 ET]
Table 'Enif' 9-max Seat #4 is the button
Seat 1: iliyan66 ($1.93 in chips)=20
Seat 2: the_wickstar ($0.81 in chips)=20
Seat 3: sergey347 ($1.79 in chips)=20
Seat 4: RastaBoss777 ($1.34 in chips)=20
Seat 5: space127 ($1.94 in chips)=20
Seat 6: Aracidus ($0.98 in chips)=20
Seat 7: yjqian23 ($1.93 in chips)=20
Seat 9: Radom94 ($0.67 in chips)=20
space127: posts small blind $0.01
Aracidus: posts big blind $0.02
*** HOLE CARDS ***
Dealt to the_wickstar [Tc 2d]
yjqian23: folds=20
yjqian23 leaves the table
Radom94: calls $0.02
Helmut969 joins the table at seat #7=20
iliyan66: folds=20
the_wickstar: calls $0.02
sergey347: folds=20
RastaBoss777: calls $0.02
space127: calls $0.01
Aracidus: checks=20
*** FLOP *** [7d 9c 2h]
space127: checks=20
Aracidus: checks=20
Radom94: checks=20
the_wickstar: checks=20
RastaBoss777: checks=20
*** TURN *** [7d 9c 2h] [As]
space127: bets $0.08
Aracidus: folds=20
Radom94: calls $0.08
the_wickstar: folds=20
RastaBoss777: folds=20
*** RIVER *** [7d 9c 2h As] [Jc]
space127: bets $0.20
Radom94: calls $0.20
*** SHOW DOWN ***
space127: shows [7c 7h] (three of a kind, Sevens)
Radom94: mucks hand=20
space127 collected $0.64 from pot
*** SUMMARY ***
Total pot $0.66 | Rake $0.02=20
Board [7d 9c 2h As Jc]
Seat 1: iliyan66 folded before Flop (didn't bet)
Seat 2: the_wickstar folded on the Turn
Seat 3: sergey347 folded before Flop (didn't bet)
Seat 4: RastaBoss777 (button) folded on the Turn
Seat 5: space127 (small blind) showed [7c 7h] and won ($0.64) with thre=
e of a kind, Sevens
Seat 6: Aracidus (big blind) folded on the Turn
Seat 7: yjqian23 folded before Flop (didn't bet)
Seat 9: Radom94 mucked [Ad 8s]


*********** # 30 **************
PokerStars Hand #169407217330:  Hold'em No Limit ($0.01/$0.02 USD) - 20=
17/04/23 3:49:53 CUST [2017/04/22 13:49:53 ET]
Table 'Joella' 9-max Seat #8 is the button
Seat 1: ThaMilkyman ($2 in chips)=20
Seat 2: the_wickstar ($1.39 in chips)=20
Seat 3: oSkARiLLo85 ($0.50 in chips)=20
Seat 4: enchantressA ($2 in chips)=20
Seat 5: Chernovsky ($2.52 in chips)=20
Seat 6: kiiits82 ($2.28 in chips)=20
Seat 7: michispaw ($3.06 in chips)=20
Seat 8: Natsoviy711 ($1.65 in chips)=20
Seat 9: All IN-Fort ($2.72 in chips)=20
All IN-Fort: posts small blind $0.01
ThaMilkyman: posts big blind $0.02
*** HOLE CARDS ***
Dealt to the_wickstar [Qs 5c]
the_wickstar: folds=20
oSkARiLLo85: calls $0.02
enchantressA: folds=20
Chernovsky: folds=20
kiiits82: folds=20
michispaw: folds=20
Natsoviy711: calls $0.02
All IN-Fort: folds=20
ThaMilkyman: checks=20
*** FLOP *** [2h Js 5h]
ThaMilkyman: checks=20
oSkARiLLo85: checks=20
Natsoviy711: checks=20
*** TURN *** [2h Js 5h] [Th]
ThaMilkyman: checks=20
oSkARiLLo85: checks=20
Natsoviy711: checks=20
*** RIVER *** [2h Js 5h Th] [6h]
ThaMilkyman: checks=20
oSkARiLLo85: bets $0.10
Natsoviy711: calls $0.10
ThaMilkyman: folds=20
*** SHOW DOWN ***
oSkARiLLo85: shows [6c 5d] (two pair, Sixes and Fives)
Natsoviy711: shows [Ts Qh] (a flush, Queen high)
Natsoviy711 collected $0.26 from pot
*** SUMMARY ***
Total pot $0.27 | Rake $0.01=20
Board [2h Js 5h Th 6h]
Seat 1: ThaMilkyman (big blind) folded on the River
Seat 2: the_wickstar folded before Flop (didn't bet)
Seat 3: oSkARiLLo85 showed [6c 5d] and lost with two pair, Sixes and Fi=
ves
Seat 4: enchantressA folded before Flop (didn't bet)
Seat 5: Chernovsky folded before Flop (didn't bet)
Seat 6: kiiits82 folded before Flop (didn't bet)
Seat 7: michispaw folded before Flop (didn't bet)
Seat 8: Natsoviy711 (button) showed [Ts Qh] and won ($0.26) with a flus=
h, Queen high
Seat 9: All IN-Fort (small blind) folded before Flop


*********** # 31 **************
PokerStars Hand #169407205961:  Hold'em No Limit ($0.01/$0.02 USD) - 20=
17/04/23 3:49:39 CUST [2017/04/22 13:49:39 ET]
Table 'Enif' 9-max Seat #3 is the button
Seat 1: iliyan66 ($1.90 in chips)=20
Seat 2: the_wickstar ($0.81 in chips)=20
Seat 3: sergey347 ($1.79 in chips)=20
Seat 4: RastaBoss777 ($1.35 in chips)=20
Seat 5: space127 ($1.94 in chips)=20
Seat 6: Aracidus ($0.98 in chips)=20
Seat 7: yjqian23 ($1.93 in chips)=20
Seat 9: Radom94 ($0.67 in chips)=20
RastaBoss777: posts small blind $0.01
space127: posts big blind $0.02
*** HOLE CARDS ***
Dealt to the_wickstar [8d 5h]
Aracidus: folds=20
yjqian23: folds=20
Radom94: folds=20
iliyan66: raises $0.04 to $0.06
the_wickstar: folds=20
sergey347: folds=20
RastaBoss777: folds=20
space127: folds=20
Uncalled bet ($0.04) returned to iliyan66
iliyan66 collected $0.05 from pot
iliyan66: doesn't show hand=20
*** SUMMARY ***
Total pot $0.05 | Rake $0=20
Seat 1: iliyan66 collected ($0.05)
Seat 2: the_wickstar folded before Flop (didn't bet)
Seat 3: sergey347 (button) folded before Flop (didn't bet)
Seat 4: RastaBoss777 (small blind) folded before Flop
Seat 5: space127 (big blind) folded before Flop
Seat 6: Aracidus folded before Flop (didn't bet)
Seat 7: yjqian23 folded before Flop (didn't bet)
Seat 9: Radom94 folded before Flop (didn't bet)


*********** # 32 **************
PokerStars Hand #169407191122:  Hold'em No Limit ($0.01/$0.02 USD) - 20=
17/04/23 3:49:20 CUST [2017/04/22 13:49:20 ET]
Table 'Joella' 9-max Seat #7 is the button
Seat 2: the_wickstar ($1.39 in chips)=20
Seat 3: oSkARiLLo85 ($0.50 in chips)=20
Seat 4: enchantressA ($2 in chips)=20
Seat 5: Chernovsky ($2.52 in chips)=20
Seat 6: kiiits82 ($2.28 in chips)=20
Seat 7: michispaw ($3.10 in chips)=20
Seat 8: Natsoviy711 ($1.59 in chips)=20
Seat 9: All IN-Fort ($2.74 in chips)=20
Natsoviy711: posts small blind $0.01
All IN-Fort: posts big blind $0.02
ThaMilkyman: sits out=20
*** HOLE CARDS ***
Dealt to the_wickstar [9h 5d]
the_wickstar: folds=20
oSkARiLLo85: folds=20
enchantressA: folds=20
Chernovsky: folds=20
kiiits82: folds=20
michispaw: raises $0.02 to $0.04
Natsoviy711: raises $0.08 to $0.12
All IN-Fort: folds=20
michispaw: folds=20
Uncalled bet ($0.08) returned to Natsoviy711
Natsoviy711 collected $0.10 from pot
*** SUMMARY ***
Total pot $0.10 | Rake $0=20
Seat 2: the_wickstar folded before Flop (didn't bet)
Seat 3: oSkARiLLo85 folded before Flop (didn't bet)
Seat 4: enchantressA folded before Flop (didn't bet)
Seat 5: Chernovsky folded before Flop (didn't bet)
Seat 6: kiiits82 folded before Flop (didn't bet)
Seat 7: michispaw (button) folded before Flop
Seat 8: Natsoviy711 (small blind) collected ($0.10)
Seat 9: All IN-Fort (big blind) folded before Flop


*********** # 33 **************
PokerStars Hand #169407181329:  Hold'em No Limit ($0.01/$0.02 USD) - 20=
17/04/23 3:49:08 CUST [2017/04/22 13:49:08 ET]
Table 'Enif' 9-max Seat #2 is the button
Seat 1: iliyan66 ($1.90 in chips)=20
Seat 2: the_wickstar ($0.81 in chips)=20
Seat 3: sergey347 ($1.80 in chips)=20
Seat 4: RastaBoss777 ($1.34 in chips)=20
Seat 6: Aracidus ($0.98 in chips)=20
Seat 7: yjqian23 ($1.93 in chips)=20
Seat 9: Radom94 ($0.67 in chips)=20
sergey347: posts small blind $0.01
RastaBoss777: posts big blind $0.02
space127: sits out=20
*** HOLE CARDS ***
Dealt to the_wickstar [2h 4s]
Aracidus: folds=20
yjqian23: folds=20
Radom94: folds=20
iliyan66: folds=20
the_wickstar: folds=20
sergey347: folds=20
Uncalled bet ($0.01) returned to RastaBoss777
RastaBoss777 collected $0.02 from pot
RastaBoss777: doesn't show hand=20
*** SUMMARY ***
Total pot $0.02 | Rake $0=20
Seat 1: iliyan66 folded before Flop (didn't bet)
Seat 2: the_wickstar (button) folded before Flop (didn't bet)
Seat 3: sergey347 (small blind) folded before Flop
Seat 4: RastaBoss777 (big blind) collected ($0.02)
Seat 6: Aracidus folded before Flop (didn't bet)
Seat 7: yjqian23 folded before Flop (didn't bet)
Seat 9: Radom94 folded before Flop (didn't bet)


*********** # 34 **************
PokerStars Hand #169407154907:  Hold'em No Limit ($0.01/$0.02 USD) - 20=
17/04/23 3:48:36 CUST [2017/04/22 13:48:36 ET]
Table 'Joella' 9-max Seat #6 is the button
Seat 2: the_wickstar ($1.45 in chips)=20
Seat 3: oSkARiLLo85 ($0.41 in chips)=20
Seat 4: enchantressA ($2 in chips)=20
Seat 5: Chernovsky ($2.52 in chips)=20
Seat 6: kiiits82 ($2.28 in chips)=20
Seat 7: michispaw ($3.11 in chips)=20
Seat 8: Natsoviy711 ($1.61 in chips)=20
Seat 9: All IN-Fort ($2.74 in chips)=20
michispaw: posts small blind $0.01
Natsoviy711: posts big blind $0.02
ThaMilkyman: sits out=20
*** HOLE CARDS ***
Dealt to the_wickstar [Qc Tc]
All IN-Fort: folds=20
the_wickstar: raises $0.04 to $0.06
oSkARiLLo85: raises $0.35 to $0.41 and is all-in
enchantressA: folds=20
Chernovsky: folds=20
kiiits82: folds=20
michispaw: folds=20
Natsoviy711: folds=20
the_wickstar: folds=20
Uncalled bet ($0.35) returned to oSkARiLLo85
oSkARiLLo85 collected $0.15 from pot
oSkARiLLo85: doesn't show hand=20
*** SUMMARY ***
Total pot $0.15 | Rake $0=20
Seat 2: the_wickstar folded before Flop
Seat 3: oSkARiLLo85 collected ($0.15)
Seat 4: enchantressA folded before Flop (didn't bet)
Seat 5: Chernovsky folded before Flop (didn't bet)
Seat 6: kiiits82 (button) folded before Flop (didn't bet)
Seat 7: michispaw (small blind) folded before Flop
Seat 8: Natsoviy711 (big blind) folded before Flop
Seat 9: All IN-Fort folded before Flop (didn't bet)


*********** # 35 **************
PokerStars Hand #169407131369:  Hold'em No Limit ($0.01/$0.02 USD) - 20=
17/04/23 3:48:07 CUST [2017/04/22 13:48:07 ET]
Table 'Enif' 9-max Seat #1 is the button
Seat 1: iliyan66 ($1.90 in chips)=20
Seat 2: the_wickstar ($0.83 in chips)=20
Seat 3: sergey347 ($1.74 in chips)=20
Seat 4: RastaBoss777 ($1.36 in chips)=20
Seat 6: Aracidus ($0.98 in chips)=20
Seat 7: yjqian23 ($1.95 in chips)=20
Seat 9: Radom94 ($0.67 in chips)=20
the_wickstar: posts small blind $0.01
sergey347: posts big blind $0.02
space127: sits out=20
*** HOLE CARDS ***
Dealt to the_wickstar [Ts Ac]
RastaBoss777: calls $0.02
Aracidus: folds=20
yjqian23: calls $0.02
Radom94: folds=20
iliyan66: folds=20
the_wickstar: calls $0.01
sergey347: checks=20
*** FLOP *** [Kc 3s 5d]
the_wickstar: checks=20
sergey347: bets $0.05
RastaBoss777: folds=20
yjqian23: folds=20
the_wickstar: folds=20
Uncalled bet ($0.05) returned to sergey347
sergey347 collected $0.08 from pot
sergey347: doesn't show hand=20
*** SUMMARY ***
Total pot $0.08 | Rake $0=20
Board [Kc 3s 5d]
Seat 1: iliyan66 (button) folded before Flop (didn't bet)
Seat 2: the_wickstar (small blind) folded on the Flop
Seat 3: sergey347 (big blind) collected ($0.08)
Seat 4: RastaBoss777 folded on the Flop
Seat 6: Aracidus folded before Flop (didn't bet)
Seat 7: yjqian23 folded on the Flop
Seat 9: Radom94 folded before Flop (didn't bet)


*********** # 36 **************
PokerStars Hand #169407110589:  Hold'em No Limit ($0.01/$0.02 USD) - 20=
17/04/23 3:47:41 CUST [2017/04/22 13:47:41 ET]
Table 'Joella' 9-max Seat #5 is the button
Seat 2: the_wickstar ($1.45 in chips)=20
Seat 3: oSkARiLLo85 ($0.13 in chips)=20
Seat 4: enchantressA ($2 in chips)=20
Seat 5: Chernovsky ($2.52 in chips)=20
Seat 6: kiiits82 ($2.29 in chips)=20
Seat 7: michispaw ($3.13 in chips)=20
Seat 8: Natsoviy711 ($1.83 in chips)=20
Seat 9: All IN-Fort ($2.79 in chips)=20
kiiits82: posts small blind $0.01
michispaw: posts big blind $0.02
ThaMilkyman: sits out=20
*** HOLE CARDS ***
Dealt to the_wickstar [8d 6d]
Natsoviy711: calls $0.02
All IN-Fort: raises $0.02 to $0.04
the_wickstar: folds=20
oSkARiLLo85: raises $0.09 to $0.13 and is all-in
enchantressA: folds=20
Chernovsky: folds=20
kiiits82: folds=20
michispaw: folds=20
Natsoviy711: raises $0.09 to $0.22
All IN-Fort: calls $0.18
*** FLOP *** [Ts Jd 4c]
Natsoviy711: checks=20
All IN-Fort: bets $2.57 and is all-in
Natsoviy711: folds=20
Uncalled bet ($2.57) returned to All IN-Fort
*** TURN *** [Ts Jd 4c] [2d]
*** RIVER *** [Ts Jd 4c 2d] [5d]
*** SHOW DOWN ***
All IN-Fort: shows [Qs Ks] (high card King)
All IN-Fort collected $0.17 from side pot
oSkARiLLo85: shows [7h Th] (a pair of Tens)
oSkARiLLo85 collected $0.41 from main pot
*** SUMMARY ***
Total pot $0.60 Main pot $0.41. Side pot $0.17. | Rake $0.02=20
Board [Ts Jd 4c 2d 5d]
Seat 2: the_wickstar folded before Flop (didn't bet)
Seat 3: oSkARiLLo85 showed [7h Th] and won ($0.41) with a pair of Tens
Seat 4: enchantressA folded before Flop (didn't bet)
Seat 5: Chernovsky (button) folded before Flop (didn't bet)
Seat 6: kiiits82 (small blind) folded before Flop
Seat 7: michispaw (big blind) folded before Flop
Seat 8: Natsoviy711 folded on the Flop
Seat 9: All IN-Fort showed [Qs Ks] and won ($0.17) with high card King


*********** # 37 **************
PokerStars Hand #169407101053:  Hold'em No Limit ($0.01/$0.02 USD) - 20=
17/04/23 3:47:30 CUST [2017/04/22 13:47:30 ET]
Table 'Enif' 9-max Seat #9 is the button
Seat 1: iliyan66 ($1.88 in chips)=20
Seat 2: the_wickstar ($0.85 in chips)=20
Seat 3: sergey347 ($1.74 in chips)=20
Seat 4: RastaBoss777 ($1.36 in chips)=20
Seat 6: Aracidus ($0.98 in chips)=20
Seat 7: yjqian23 ($1.95 in chips)=20
Seat 9: Radom94 ($0.67 in chips)=20
iliyan66: posts small blind $0.01
the_wickstar: posts big blind $0.02
space127: sits out=20
*** HOLE CARDS ***
Dealt to the_wickstar [Qs 7s]
sergey347: folds=20
RastaBoss777: folds=20
Aracidus: folds=20
yjqian23: folds=20
Radom94: folds=20
iliyan66: raises $0.04 to $0.06
the_wickstar: folds=20
Uncalled bet ($0.04) returned to iliyan66
iliyan66 collected $0.04 from pot
iliyan66: doesn't show hand=20
*** SUMMARY ***
Total pot $0.04 | Rake $0=20
Seat 1: iliyan66 (small blind) collected ($0.04)
Seat 2: the_wickstar (big blind) folded before Flop
Seat 3: sergey347 folded before Flop (didn't bet)
Seat 4: RastaBoss777 folded before Flop (didn't bet)
Seat 6: Aracidus folded before Flop (didn't bet)
Seat 7: yjqian23 folded before Flop (didn't bet)
Seat 9: Radom94 (button) folded before Flop (didn't bet)


*********** # 38 **************
PokerStars Hand #169407071107:  Hold'em No Limit ($0.01/$0.02 USD) - 20=
17/04/23 3:46:53 CUST [2017/04/22 13:46:53 ET]
Table 'Enif' 9-max Seat #7 is the button
Seat 1: iliyan66 ($1.90 in chips)=20
Seat 2: the_wickstar ($0.85 in chips)=20
Seat 3: sergey347 ($1.67 in chips)=20
Seat 4: RastaBoss777 ($1.38 in chips)=20
Seat 6: Aracidus ($0.98 in chips)=20
Seat 7: yjqian23 ($1.97 in chips)=20
Seat 9: Radom94 ($0.68 in chips)=20
Radom94: posts small blind $0.01
iliyan66: posts big blind $0.02
space127: sits out=20
*** HOLE CARDS ***
Dealt to the_wickstar [7c 3h]
the_wickstar: folds=20
sergey347: calls $0.02
RastaBoss777: calls $0.02
Aracidus: folds=20
yjqian23: calls $0.02
Radom94: folds=20
iliyan66: checks=20
*** FLOP *** [Qh 2h 9s]
iliyan66: checks=20
sergey347: bets $0.06
RastaBoss777: folds=20
yjqian23: folds=20
iliyan66: folds=20
Uncalled bet ($0.06) returned to sergey347
sergey347 collected $0.09 from pot
sergey347: doesn't show hand=20
*** SUMMARY ***
Total pot $0.09 | Rake $0=20
Board [Qh 2h 9s]
Seat 1: iliyan66 (big blind) folded on the Flop
Seat 2: the_wickstar folded before Flop (didn't bet)
Seat 3: sergey347 collected ($0.09)
Seat 4: RastaBoss777 folded on the Flop
Seat 6: Aracidus folded before Flop (didn't bet)
Seat 7: yjqian23 (button) folded on the Flop
Seat 9: Radom94 (small blind) folded before Flop


*********** # 39 **************
PokerStars Hand #169407068392:  Hold'em No Limit ($0.01/$0.02 USD) - 20=
17/04/23 3:46:50 CUST [2017/04/22 13:46:50 ET]
Table 'Joella' 9-max Seat #4 is the button
Seat 2: the_wickstar ($1.45 in chips)=20
Seat 3: oSkARiLLo85 ($0.13 in chips)=20
Seat 4: enchantressA ($2 in chips)=20
Seat 5: Chernovsky ($2.58 in chips)=20
Seat 6: kiiits82 ($2.31 in chips)=20
Seat 7: michispaw ($3.19 in chips)=20
Seat 8: Natsoviy711 ($1.89 in chips)=20
Seat 9: All IN-Fort ($2.60 in chips)=20
Chernovsky: posts small blind $0.01
kiiits82: posts big blind $0.02
ThaMilkyman: sits out=20
*** HOLE CARDS ***
Dealt to the_wickstar [Js 7c]
michispaw: calls $0.02
Natsoviy711: raises $0.04 to $0.06
All IN-Fort: calls $0.06
the_wickstar: folds=20
oSkARiLLo85: folds=20
enchantressA: folds=20
Chernovsky: calls $0.05
kiiits82: folds=20
michispaw: calls $0.04
*** FLOP *** [3d 9d 4c]
Chernovsky: checks=20
michispaw: checks=20
Natsoviy711: checks=20
All IN-Fort: bets $0.24
Chernovsky: folds=20
michispaw: folds=20
Natsoviy711: folds=20
Uncalled bet ($0.24) returned to All IN-Fort
All IN-Fort collected $0.25 from pot
All IN-Fort: doesn't show hand=20
*** SUMMARY ***
Total pot $0.26 | Rake $0.01=20
Board [3d 9d 4c]
Seat 2: the_wickstar folded before Flop (didn't bet)
Seat 3: oSkARiLLo85 folded before Flop (didn't bet)
Seat 4: enchantressA (button) folded before Flop (didn't bet)
Seat 5: Chernovsky (small blind) folded on the Flop
Seat 6: kiiits82 (big blind) folded before Flop
Seat 7: michispaw folded on the Flop
Seat 8: Natsoviy711 folded on the Flop
Seat 9: All IN-Fort collected ($0.25)


*********** # 40 **************
PokerStars Hand #169407055012:  Hold'em No Limit ($0.01/$0.02 USD) - 20=
17/04/23 3:46:33 CUST [2017/04/22 13:46:33 ET]
Table 'Enif' 9-max Seat #6 is the button
Seat 1: iliyan66 ($1.90 in chips)=20
Seat 2: the_wickstar ($0.85 in chips)=20
Seat 3: sergey347 ($1.67 in chips)=20
Seat 4: RastaBoss777 ($1.38 in chips)=20
Seat 6: Aracidus ($0.98 in chips)=20
Seat 7: yjqian23 ($1.98 in chips)=20
Seat 9: Radom94 ($0.67 in chips)=20
yjqian23: posts small blind $0.01
Radom94: posts big blind $0.02
*** HOLE CARDS ***
Dealt to the_wickstar [Ts 3s]
iliyan66: folds=20
the_wickstar: folds=20
space127 joins the table at seat #5=20
sergey347: folds=20
RastaBoss777: folds=20
Aracidus: folds=20
yjqian23: folds=20
Uncalled bet ($0.01) returned to Radom94
Radom94 collected $0.02 from pot
Radom94: doesn't show hand=20
*** SUMMARY ***
Total pot $0.02 | Rake $0=20
Seat 1: iliyan66 folded before Flop (didn't bet)
Seat 2: the_wickstar folded before Flop (didn't bet)
Seat 3: sergey347 folded before Flop (didn't bet)
Seat 4: RastaBoss777 folded before Flop (didn't bet)
Seat 6: Aracidus (button) folded before Flop (didn't bet)
Seat 7: yjqian23 (small blind) folded before Flop
Seat 9: Radom94 (big blind) collected ($0.02)


*********** # 41 **************
PokerStars Hand #169407026028:  Hold'em No Limit ($0.01/$0.02 USD) - 20=
17/04/23 3:45:58 CUST [2017/04/22 13:45:58 ET]
Table 'Enif' 9-max Seat #5 is the button
Seat 1: iliyan66 ($1.90 in chips)=20
Seat 2: the_wickstar ($0.82 in chips)=20
Seat 3: sergey347 ($1.67 in chips)=20
Seat 4: RastaBoss777 ($1.38 in chips)=20
Seat 5: betao22 ($1.55 in chips)=20
Seat 6: Aracidus ($0.99 in chips)=20
Seat 7: yjqian23 ($2 in chips)=20
Seat 9: Radom94 ($0.67 in chips)=20
Aracidus: posts small blind $0.01
yjqian23: posts big blind $0.02
*** HOLE CARDS ***
Dealt to the_wickstar [Ts Kc]
Radom94: folds=20
iliyan66: folds=20
the_wickstar: raises $0.04 to $0.06
sergey347: folds=20
RastaBoss777: folds=20
betao22: folds=20
Aracidus: folds=20
yjqian23: folds=20
Uncalled bet ($0.04) returned to the_wickstar
betao22 leaves the table
the_wickstar collected $0.05 from pot
*** SUMMARY ***
Total pot $0.05 | Rake $0=20
Seat 1: iliyan66 folded before Flop (didn't bet)
Seat 2: the_wickstar collected ($0.05)
Seat 3: sergey347 folded before Flop (didn't bet)
Seat 4: RastaBoss777 folded before Flop (didn't bet)
Seat 5: betao22 (button) folded before Flop (didn't bet)
Seat 6: Aracidus (small blind) folded before Flop
Seat 7: yjqian23 (big blind) folded before Flop
Seat 9: Radom94 folded before Flop (didn't bet)


*********** # 42 **************
PokerStars Hand #169407020373:  Hold'em No Limit ($0.01/$0.02 USD) - 20=
17/04/23 3:45:51 CUST [2017/04/22 13:45:51 ET]
Table 'Joella' 9-max Seat #3 is the button
Seat 2: the_wickstar ($1.49 in chips)=20
Seat 3: oSkARiLLo85 ($0.28 in chips)=20
Seat 4: enchantressA ($2 in chips)=20
Seat 5: Chernovsky ($2.39 in chips)=20
Seat 6: kiiits82 ($2.31 in chips)=20
Seat 7: michispaw ($3.19 in chips)=20
Seat 8: Natsoviy711 ($1.89 in chips)=20
Seat 9: All IN-Fort ($2.60 in chips)=20
enchantressA: posts small blind $0.01
Chernovsky: posts big blind $0.02
ThaMilkyman: sits out=20
*** HOLE CARDS ***
Dealt to the_wickstar [Ac 9d]
kiiits82: folds=20
michispaw: folds=20
Natsoviy711: folds=20
All IN-Fort: folds=20
the_wickstar: raises $0.02 to $0.04
oSkARiLLo85: calls $0.04
enchantressA: folds=20
Chernovsky: raises $0.11 to $0.15
the_wickstar: folds=20
oSkARiLLo85: calls $0.11
*** FLOP *** [8h 7c 2d]
Chernovsky: bets $0.15
oSkARiLLo85: folds=20
Uncalled bet ($0.15) returned to Chernovsky
Chernovsky collected $0.34 from pot
Chernovsky: doesn't show hand=20
*** SUMMARY ***
Total pot $0.35 | Rake $0.01=20
Board [8h 7c 2d]
Seat 2: the_wickstar folded before Flop
Seat 3: oSkARiLLo85 (button) folded on the Flop
Seat 4: enchantressA (small blind) folded before Flop
Seat 5: Chernovsky (big blind) collected ($0.34)
Seat 6: kiiits82 folded before Flop (didn't bet)
Seat 7: michispaw folded before Flop (didn't bet)
Seat 8: Natsoviy711 folded before Flop (didn't bet)
Seat 9: All IN-Fort folded before Flop (didn't bet)


*********** # 43 **************
PokerStars Hand #169406993688:  Hold'em No Limit ($0.01/$0.02 USD) - 20=
17/04/23 3:45:18 CUST [2017/04/22 13:45:18 ET]
Table 'Joella' 9-max Seat #2 is the button
Seat 1: betao22 ($2.06 in chips)=20
Seat 2: the_wickstar ($1.49 in chips)=20
Seat 3: oSkARiLLo85 ($0.29 in chips)=20
Seat 4: enchantressA ($2 in chips)=20
Seat 5: Chernovsky ($2.39 in chips)=20
Seat 6: kiiits82 ($2.28 in chips)=20
Seat 7: michispaw ($3.19 in chips)=20
Seat 8: Natsoviy711 ($1.89 in chips)=20
Seat 9: All IN-Fort ($2.60 in chips)=20
oSkARiLLo85: posts small blind $0.01
enchantressA: posts big blind $0.02
*** HOLE CARDS ***
Dealt to the_wickstar [7d Th]
Chernovsky: folds=20
kiiits82: raises $0.04 to $0.06
michispaw: folds=20
Natsoviy711: folds=20
All IN-Fort: folds=20
betao22: folds=20
betao22 leaves the table
the_wickstar: folds=20
oSkARiLLo85: folds=20
enchantressA: folds=20
Uncalled bet ($0.04) returned to kiiits82
ThaMilkyman joins the table at seat #1=20
kiiits82 collected $0.05 from pot
kiiits82: doesn't show hand=20
*** SUMMARY ***
Total pot $0.05 | Rake $0=20
Seat 1: betao22 folded before Flop (didn't bet)
Seat 2: the_wickstar (button) folded before Flop (didn't bet)
Seat 3: oSkARiLLo85 (small blind) folded before Flop
Seat 4: enchantressA (big blind) folded before Flop
Seat 5: Chernovsky folded before Flop (didn't bet)
Seat 6: kiiits82 collected ($0.05)
Seat 7: michispaw folded before Flop (didn't bet)
Seat 8: Natsoviy711 folded before Flop (didn't bet)
Seat 9: All IN-Fort folded before Flop (didn't bet)


*********** # 44 **************
PokerStars Hand #169406929921:  Hold'em No Limit ($0.01/$0.02 USD) - 20=
17/04/23 3:44:01 CUST [2017/04/22 13:44:01 ET]
Table 'Joella' 9-max Seat #1 is the button
Seat 1: betao22 ($1.66 in chips)=20
Seat 2: the_wickstar ($1.50 in chips)=20
Seat 3: oSkARiLLo85 ($0.31 in chips)=20
Seat 5: Chernovsky ($2.44 in chips)=20
Seat 6: kiiits82 ($2.28 in chips)=20
Seat 7: michispaw ($3.19 in chips)=20
Seat 8: Natsoviy711 ($1.94 in chips)=20
Seat 9: All IN-Fort ($2.90 in chips)=20
the_wickstar: posts small blind $0.01
oSkARiLLo85: posts big blind $0.02
enchantressA: sits out=20
*** HOLE CARDS ***
Dealt to the_wickstar [Ah 7s]
Chernovsky: raises $0.03 to $0.05
kiiits82: folds=20
michispaw: folds=20
Natsoviy711: calls $0.05
All IN-Fort: calls $0.05
betao22: raises $0.25 to $0.30
the_wickstar: folds=20
oSkARiLLo85: folds=20
Chernovsky: folds=20
Natsoviy711: folds=20
All IN-Fort: calls $0.25
*** FLOP *** [3s 4c 6c]
All IN-Fort: checks=20
betao22: bets $1.36 and is all-in
All IN-Fort: folds=20
Uncalled bet ($1.36) returned to betao22
betao22 collected $0.70 from pot
betao22: doesn't show hand=20
*** SUMMARY ***
Total pot $0.73 | Rake $0.03=20
Board [3s 4c 6c]
Seat 1: betao22 (button) collected ($0.70)
Seat 2: the_wickstar (small blind) folded before Flop
Seat 3: oSkARiLLo85 (big blind) folded before Flop
Seat 5: Chernovsky folded before Flop
Seat 6: kiiits82 folded before Flop (didn't bet)
Seat 7: michispaw folded before Flop (didn't bet)
Seat 8: Natsoviy711 folded before Flop
Seat 9: All IN-Fort folded on the Flop


*********** # 45 **************
PokerStars Hand #169406922777:  Hold'em No Limit ($0.01/$0.02 USD) - 20=
17/04/23 3:43:52 CUST [2017/04/22 13:43:52 ET]
Table 'Enif' 9-max Seat #4 is the button
Seat 1: iliyan66 ($1.90 in chips)=20
Seat 2: the_wickstar ($0.82 in chips)=20
Seat 3: sergey347 ($1.67 in chips)=20
Seat 4: RastaBoss777 ($0.94 in chips)=20
Seat 5: betao22 ($1.56 in chips)=20
Seat 6: Aracidus ($1.01 in chips)=20
Seat 9: Radom94 ($1.11 in chips)=20
betao22: posts small blind $0.01
Aracidus: posts big blind $0.02
yjqian23: sits out=20
*** HOLE CARDS ***
Dealt to the_wickstar [Kh 4c]
Radom94: raises $0.02 to $0.04
iliyan66: folds=20
the_wickstar: folds=20
sergey347: folds=20
RastaBoss777: calls $0.04
betao22: folds=20
Aracidus: folds=20
*** FLOP *** [5s 9s 6s]
Radom94: checks=20
RastaBoss777: bets $0.02
Radom94: calls $0.02
*** TURN *** [5s 9s 6s] [4h]
Radom94: checks=20
RastaBoss777: bets $0.02
Radom94: calls $0.02
*** RIVER *** [5s 9s 6s 4h] [Qs]
Radom94: bets $0.06
RastaBoss777: raises $0.30 to $0.36
Radom94: calls $0.30
*** SHOW DOWN ***
RastaBoss777: shows [As 7h] (a flush, Ace high)
Radom94: mucks hand=20
RastaBoss777 collected $0.88 from pot
*** SUMMARY ***
Total pot $0.91 | Rake $0.03=20
Board [5s 9s 6s 4h Qs]
Seat 1: iliyan66 folded before Flop (didn't bet)
Seat 2: the_wickstar folded before Flop (didn't bet)
Seat 3: sergey347 folded before Flop (didn't bet)
Seat 4: RastaBoss777 (button) showed [As 7h] and won ($0.88) with a flu=
sh, Ace high
Seat 5: betao22 (small blind) folded before Flop
Seat 6: Aracidus (big blind) folded before Flop
Seat 9: Radom94 mucked [Ts Th]


*********** # 46 **************
PokerStars Hand #169406904343:  Hold'em No Limit ($0.01/$0.02 USD) - 20=
17/04/23 3:43:30 CUST [2017/04/22 13:43:30 ET]
Table 'Joella' 9-max Seat #9 is the button
Seat 1: betao22 ($1.68 in chips)=20
Seat 2: the_wickstar ($1.52 in chips)=20
Seat 3: oSkARiLLo85 ($0.31 in chips)=20
Seat 5: Chernovsky ($2.44 in chips)=20
Seat 6: kiiits82 ($2.28 in chips)=20
Seat 7: michispaw ($3.19 in chips)=20
Seat 8: Natsoviy711 ($1.94 in chips)=20
Seat 9: All IN-Fort ($2.86 in chips)=20
betao22: posts small blind $0.01
the_wickstar: posts big blind $0.02
enchantressA: sits out=20
*** HOLE CARDS ***
Dealt to the_wickstar [7d 6h]
oSkARiLLo85: folds=20
Chernovsky: folds=20
kiiits82: folds=20
michispaw: folds=20
Natsoviy711: folds=20
All IN-Fort: calls $0.02
betao22: calls $0.01
the_wickstar: checks=20
*** FLOP *** [5c 9s Qs]
betao22: checks=20
the_wickstar: checks=20
All IN-Fort: bets $0.06
betao22: folds=20
the_wickstar: folds=20
Uncalled bet ($0.06) returned to All IN-Fort
All IN-Fort collected $0.06 from pot
All IN-Fort: doesn't show hand=20
*** SUMMARY ***
Total pot $0.06 | Rake $0=20
Board [5c 9s Qs]
Seat 1: betao22 (small blind) folded on the Flop
Seat 2: the_wickstar (big blind) folded on the Flop
Seat 3: oSkARiLLo85 folded before Flop (didn't bet)
Seat 5: Chernovsky folded before Flop (didn't bet)
Seat 6: kiiits82 folded before Flop (didn't bet)
Seat 7: michispaw folded before Flop (didn't bet)
Seat 8: Natsoviy711 folded before Flop (didn't bet)
Seat 9: All IN-Fort (button) collected ($0.06)


*********** # 47 **************
PokerStars Hand #169406874234:  Hold'em No Limit ($0.01/$0.02 USD) - 20=
17/04/23 3:42:53 CUST [2017/04/22 13:42:53 ET]
Table 'Enif' 9-max Seat #3 is the button
Seat 1: iliyan66 ($1.90 in chips)=20
Seat 2: the_wickstar ($0.82 in chips)=20
Seat 3: sergey347 ($1.67 in chips)=20
Seat 4: RastaBoss777 ($0.96 in chips)=20
Seat 5: betao22 ($1.58 in chips)=20
Seat 6: Aracidus ($1.01 in chips)=20
Seat 9: Radom94 ($1.07 in chips)=20
RastaBoss777: posts small blind $0.01
betao22: posts big blind $0.02
yjqian23: sits out=20
*** HOLE CARDS ***
Dealt to the_wickstar [6d 3d]
Aracidus: folds=20
Radom94: calls $0.02
iliyan66: folds=20
the_wickstar: folds=20
sergey347: folds=20
RastaBoss777: calls $0.01
betao22: checks=20
*** FLOP *** [5s 5h Ah]
RastaBoss777: checks=20
betao22: checks=20
Radom94: checks=20
*** TURN *** [5s 5h Ah] [2h]
RastaBoss777: checks=20
betao22: checks=20
Radom94: bets $0.04
RastaBoss777: folds=20
betao22: folds=20
Uncalled bet ($0.04) returned to Radom94
Radom94 collected $0.06 from pot
Radom94: doesn't show hand=20
*** SUMMARY ***
Total pot $0.06 | Rake $0=20
Board [5s 5h Ah 2h]
Seat 1: iliyan66 folded before Flop (didn't bet)
Seat 2: the_wickstar folded before Flop (didn't bet)
Seat 3: sergey347 (button) folded before Flop (didn't bet)
Seat 4: RastaBoss777 (small blind) folded on the Turn
Seat 5: betao22 (big blind) folded on the Turn
Seat 6: Aracidus folded before Flop (didn't bet)
Seat 9: Radom94 collected ($0.06)


*********** # 48 **************
PokerStars Hand #169406844592:  Hold'em No Limit ($0.01/$0.02 USD) - 20=
17/04/23 3:42:17 CUST [2017/04/22 13:42:17 ET]
Table 'Joella' 9-max Seat #8 is the button
Seat 1: betao22 ($1.70 in chips)=20
Seat 2: the_wickstar ($1.70 in chips)=20
Seat 3: oSkARiLLo85 ($0.37 in chips)=20
Seat 5: Chernovsky ($2.44 in chips)=20
Seat 6: kiiits82 ($2.28 in chips)=20
Seat 7: michispaw ($3.19 in chips)=20
Seat 8: Natsoviy711 ($1.94 in chips)=20
Seat 9: All IN-Fort ($2.62 in chips)=20
All IN-Fort: posts small blind $0.01
betao22: posts big blind $0.02
enchantressA: sits out=20
*** HOLE CARDS ***
Dealt to the_wickstar [Ad Kc]
the_wickstar: raises $0.04 to $0.06
oSkARiLLo85: calls $0.06
Chernovsky: folds=20
kiiits82: folds=20
michispaw: folds=20
Natsoviy711: folds=20
All IN-Fort: calls $0.05
betao22: folds=20
*** FLOP *** [4s 9s Qs]
All IN-Fort: checks=20
the_wickstar: checks=20
oSkARiLLo85: checks=20
*** TURN *** [4s 9s Qs] [4h]
All IN-Fort: checks=20
the_wickstar: bets $0.12
oSkARiLLo85: folds=20
All IN-Fort: calls $0.12
*** RIVER *** [4s 9s Qs 4h] [9c]
All IN-Fort: bets $0.50
the_wickstar: folds=20
Uncalled bet ($0.50) returned to All IN-Fort
All IN-Fort collected $0.42 from pot
All IN-Fort: doesn't show hand=20
*** SUMMARY ***
Total pot $0.44 | Rake $0.02=20
Board [4s 9s Qs 4h 9c]
Seat 1: betao22 (big blind) folded before Flop
Seat 2: the_wickstar folded on the River
Seat 3: oSkARiLLo85 folded on the Turn
Seat 5: Chernovsky folded before Flop (didn't bet)
Seat 6: kiiits82 folded before Flop (didn't bet)
Seat 7: michispaw folded before Flop (didn't bet)
Seat 8: Natsoviy711 (button) folded before Flop (didn't bet)
Seat 9: All IN-Fort (small blind) collected ($0.42)


*********** # 49 **************
PokerStars Hand #169406821347:  Hold'em No Limit ($0.01/$0.02 USD) - 20=
17/04/23 3:41:48 CUST [2017/04/22 13:41:48 ET]
Table 'Enif' 9-max Seat #2 is the button
Seat 1: iliyan66 ($1.90 in chips)=20
Seat 2: the_wickstar ($0.82 in chips)=20
Seat 3: sergey347 ($1.65 in chips)=20
Seat 4: RastaBoss777 ($0.98 in chips)=20
Seat 5: betao22 ($1.58 in chips)=20
Seat 6: Aracidus ($1.01 in chips)=20
Seat 9: Radom94 ($1.07 in chips)=20
sergey347: posts small blind $0.01
RastaBoss777: posts big blind $0.02
yjqian23: sits out=20
*** HOLE CARDS ***
Dealt to the_wickstar [3s Kh]
betao22: folds=20
Aracidus: folds=20
Radom94: folds=20
iliyan66: folds=20
the_wickstar: folds=20
sergey347: calls $0.01
RastaBoss777: checks=20
*** FLOP *** [Qs Ac Tc]
sergey347: checks=20
RastaBoss777: checks=20
*** TURN *** [Qs Ac Tc] [8h]
sergey347: checks=20
RastaBoss777: checks=20
*** RIVER *** [Qs Ac Tc 8h] [4c]
sergey347: bets $0.03
RastaBoss777: folds=20
Uncalled bet ($0.03) returned to sergey347
sergey347 collected $0.04 from pot
sergey347: doesn't show hand=20
*** SUMMARY ***
Total pot $0.04 | Rake $0=20
Board [Qs Ac Tc 8h 4c]
Seat 1: iliyan66 folded before Flop (didn't bet)
Seat 2: the_wickstar (button) folded before Flop (didn't bet)
Seat 3: sergey347 (small blind) collected ($0.04)
Seat 4: RastaBoss777 (big blind) folded on the River
Seat 5: betao22 folded before Flop (didn't bet)
Seat 6: Aracidus folded before Flop (didn't bet)
Seat 9: Radom94 folded before Flop (didn't bet)


*********** # 50 **************
PokerStars Hand #169406793627:  Hold'em No Limit ($0.01/$0.02 USD) - 20=
17/04/23 3:41:15 CUST [2017/04/22 13:41:15 ET]
Table 'Enif' 9-max Seat #1 is the button
Seat 1: iliyan66 ($1.90 in chips)=20
Seat 2: the_wickstar ($0.83 in chips)=20
Seat 3: sergey347 ($1.67 in chips)=20
Seat 4: RastaBoss777 ($0.98 in chips)=20
Seat 5: betao22 ($1.58 in chips)=20
Seat 6: Aracidus ($1.05 in chips)=20
Seat 9: Radom94 ($1 in chips)=20
the_wickstar: posts small blind $0.01
sergey347: posts big blind $0.02
yjqian23: sits out=20
*** HOLE CARDS ***
Dealt to the_wickstar [5s 7h]
RastaBoss777: folds=20
betao22: folds=20
Aracidus: calls $0.02
Radom94: raises $0.02 to $0.04
iliyan66: folds=20
the_wickstar: folds=20
sergey347: folds=20
Aracidus: calls $0.02
*** FLOP *** [5c 2s 2c]
Aracidus: checks=20
Radom94: bets $0.04
Aracidus: folds=20
Uncalled bet ($0.04) returned to Radom94
Radom94 collected $0.11 from pot
Radom94: doesn't show hand=20
*** SUMMARY ***
Total pot $0.11 | Rake $0=20
Board [5c 2s 2c]
Seat 1: iliyan66 (button) folded before Flop (didn't bet)
Seat 2: the_wickstar (small blind) folded before Flop
Seat 3: sergey347 (big blind) folded before Flop
Seat 4: RastaBoss777 folded before Flop (didn't bet)
Seat 5: betao22 folded before Flop (didn't bet)
Seat 6: Aracidus folded on the Flop
Seat 9: Radom94 collected ($0.11)


*********** # 51 **************
PokerStars Hand #169406785488:  Hold'em No Limit ($0.01/$0.02 USD) - 20=
17/04/23 3:41:05 CUST [2017/04/22 13:41:05 ET]
Table 'Joella' 9-max Seat #7 is the button
Seat 1: betao22 ($1.70 in chips)=20
Seat 2: the_wickstar ($1.65 in chips)=20
Seat 3: oSkARiLLo85 ($0.39 in chips)=20
Seat 5: Chernovsky ($2.44 in chips)=20
Seat 6: kiiits82 ($2.28 in chips)=20
Seat 7: michispaw ($3.19 in chips)=20
Seat 8: Natsoviy711 ($1.95 in chips)=20
Seat 9: All IN-Fort ($2.64 in chips)=20
Natsoviy711: posts small blind $0.01
All IN-Fort: posts big blind $0.02
enchantressA: sits out=20
*** HOLE CARDS ***
Dealt to the_wickstar [As 5s]
betao22: folds=20
the_wickstar: calls $0.02
oSkARiLLo85: calls $0.02
Chernovsky: folds=20
kiiits82: folds=20
michispaw: folds=20
Natsoviy711: folds=20
All IN-Fort: checks=20
*** FLOP *** [7d Ks Qh]
All IN-Fort: checks=20
the_wickstar: checks=20
oSkARiLLo85: checks=20
*** TURN *** [7d Ks Qh] [4c]
All IN-Fort: checks=20
the_wickstar: checks=20
oSkARiLLo85: checks=20
*** RIVER *** [7d Ks Qh 4c] [3d]
All IN-Fort: checks=20
the_wickstar: bets $0.05
oSkARiLLo85: folds=20
All IN-Fort: folds=20
Uncalled bet ($0.05) returned to the_wickstar
the_wickstar collected $0.07 from pot
*** SUMMARY ***
Total pot $0.07 | Rake $0=20
Board [7d Ks Qh 4c 3d]
Seat 1: betao22 folded before Flop (didn't bet)
Seat 2: the_wickstar collected ($0.07)
Seat 3: oSkARiLLo85 folded on the River
Seat 5: Chernovsky folded before Flop (didn't bet)
Seat 6: kiiits82 folded before Flop (didn't bet)
Seat 7: michispaw (button) folded before Flop (didn't bet)
Seat 8: Natsoviy711 (small blind) folded before Flop
Seat 9: All IN-Fort (big blind) folded on the River


*********** # 52 **************
PokerStars Hand #169406755101:  Hold'em No Limit ($0.01/$0.02 USD) - 20=
17/04/23 3:40:28 CUST [2017/04/22 13:40:28 ET]
Table 'Joella' 9-max Seat #6 is the button
Seat 1: betao22 ($1.70 in chips)=20
Seat 2: the_wickstar ($1.62 in chips)=20
Seat 3: oSkARiLLo85 ($0.39 in chips)=20
Seat 5: Chernovsky ($2.44 in chips)=20
Seat 6: kiiits82 ($2.28 in chips)=20
Seat 7: michispaw ($3.20 in chips)=20
Seat 8: Natsoviy711 ($1.97 in chips)=20
Seat 9: All IN-Fort ($2.64 in chips)=20
michispaw: posts small blind $0.01
Natsoviy711: posts big blind $0.02
enchantressA: sits out=20
*** HOLE CARDS ***
Dealt to the_wickstar [Kc Td]
All IN-Fort: folds=20
betao22: folds=20
the_wickstar: raises $0.04 to $0.06
oSkARiLLo85: folds=20
Chernovsky: folds=20
kiiits82: folds=20
michispaw: folds=20
Natsoviy711: folds=20
Uncalled bet ($0.04) returned to the_wickstar
the_wickstar collected $0.05 from pot
*** SUMMARY ***
Total pot $0.05 | Rake $0=20
Seat 1: betao22 folded before Flop (didn't bet)
Seat 2: the_wickstar collected ($0.05)
Seat 3: oSkARiLLo85 folded before Flop (didn't bet)
Seat 5: Chernovsky folded before Flop (didn't bet)
Seat 6: kiiits82 (button) folded before Flop (didn't bet)
Seat 7: michispaw (small blind) folded before Flop
Seat 8: Natsoviy711 (big blind) folded before Flop
Seat 9: All IN-Fort folded before Flop (didn't bet)


*********** # 53 **************
PokerStars Hand #169406733835:  Hold'em No Limit ($0.01/$0.02 USD) - 20=
17/04/23 3:40:02 CUST [2017/04/22 13:40:02 ET]
Table 'Enif' 9-max Seat #9 is the button
Seat 1: iliyan66 ($1.90 in chips)=20
Seat 2: the_wickstar ($0.85 in chips)=20
Seat 3: sergey347 ($1.67 in chips)=20
Seat 4: RastaBoss777 ($0.98 in chips)=20
Seat 5: betao22 ($1.59 in chips)=20
Seat 6: Aracidus ($1.05 in chips)=20
Seat 7: ElSchmidtzel ($2.35 in chips)=20
Seat 9: Radom94 ($1 in chips)=20
iliyan66: posts small blind $0.01
the_wickstar: posts big blind $0.02
*** HOLE CARDS ***
Dealt to the_wickstar [3s 8d]
sergey347: folds=20
RastaBoss777: folds=20
betao22: calls $0.02
Aracidus: folds=20
ElSchmidtzel: folds=20
ElSchmidtzel leaves the table
Radom94: folds=20
iliyan66: calls $0.01
the_wickstar: checks=20
*** FLOP *** [5h Qs Js]
yjqian23 joins the table at seat #7=20
iliyan66: bets $0.18
the_wickstar: folds=20
betao22: calls $0.18
*** TURN *** [5h Qs Js] [Jc]
iliyan66: checks=20
betao22: bets $0.21
iliyan66: calls $0.21
*** RIVER *** [5h Qs Js Jc] [7s]
iliyan66: checks=20
betao22: checks=20
*** SHOW DOWN ***
iliyan66: shows [Ah Qc] (two pair, Queens and Jacks)
betao22: shows [Qh Ad] (two pair, Queens and Jacks)
iliyan66 collected $0.41 from pot
betao22 collected $0.40 from pot
*** SUMMARY ***
Total pot $0.84 | Rake $0.03=20
Board [5h Qs Js Jc 7s]
Seat 1: iliyan66 (small blind) showed [Ah Qc] and won ($0.41) with two =
pair, Queens and Jacks
Seat 2: the_wickstar (big blind) folded on the Flop
Seat 3: sergey347 folded before Flop (didn't bet)
Seat 4: RastaBoss777 folded before Flop (didn't bet)
Seat 5: betao22 showed [Qh Ad] and won ($0.40) with two pair, Queens an=
d Jacks
Seat 6: Aracidus folded before Flop (didn't bet)
Seat 7: ElSchmidtzel folded before Flop (didn't bet)
Seat 9: Radom94 (button) folded before Flop (didn't bet)


*********** # 54 **************
PokerStars Hand #169406711050:  Hold'em No Limit ($0.01/$0.02 USD) - 20=
17/04/23 3:39:35 CUST [2017/04/22 13:39:35 ET]
Table 'Joella' 9-max Seat #5 is the button
Seat 1: betao22 ($1.70 in chips)=20
Seat 2: the_wickstar ($1.62 in chips)=20
Seat 3: oSkARiLLo85 ($0.39 in chips)=20
Seat 5: Chernovsky ($2.49 in chips)=20
Seat 6: kiiits82 ($1.92 in chips)=20
Seat 7: michispaw ($3.53 in chips)=20
Seat 8: Natsoviy711 ($1.97 in chips)=20
Seat 9: All IN-Fort ($2.64 in chips)=20
kiiits82: posts small blind $0.01
michispaw: posts big blind $0.02
enchantressA: sits out=20
*** HOLE CARDS ***
Dealt to the_wickstar [4s Th]
Natsoviy711: folds=20
All IN-Fort: folds=20
betao22: folds=20
the_wickstar: folds=20
oSkARiLLo85: folds=20
Chernovsky: raises $0.03 to $0.05
kiiits82: calls $0.04
michispaw: calls $0.03
*** FLOP *** [9c 9s 7c]
kiiits82: bets $0.08
michispaw: calls $0.08
Chernovsky: folds=20
*** TURN *** [9c 9s 7c] [8s]
kiiits82: checks=20
michispaw: checks=20
*** RIVER *** [9c 9s 7c 8s] [5c]
kiiits82: bets $0.20
michispaw: calls $0.20
*** SHOW DOWN ***
kiiits82: shows [5s 5d] (a full house, Fives full of Nines)
michispaw: mucks hand=20
kiiits82 collected $0.69 from pot
*** SUMMARY ***
Total pot $0.71 | Rake $0.02=20
Board [9c 9s 7c 8s 5c]
Seat 1: betao22 folded before Flop (didn't bet)
Seat 2: the_wickstar folded before Flop (didn't bet)
Seat 3: oSkARiLLo85 folded before Flop (didn't bet)
Seat 5: Chernovsky (button) folded on the Flop
Seat 6: kiiits82 (small blind) showed [5s 5d] and won ($0.69) with a fu=
ll house, Fives full of Nines
Seat 7: michispaw (big blind) mucked [Ac 4c]
Seat 8: Natsoviy711 folded before Flop (didn't bet)
Seat 9: All IN-Fort folded before Flop (didn't bet)


*********** # 55 **************
PokerStars Hand #169406701709:  Hold'em No Limit ($0.01/$0.02 USD) - 20=
17/04/23 3:39:24 CUST [2017/04/22 13:39:24 ET]
Table 'Enif' 9-max Seat #7 is the button
Seat 1: iliyan66 ($1.94 in chips)=20
Seat 2: the_wickstar ($0.85 in chips)=20
Seat 3: sergey347 ($1.67 in chips)=20
Seat 4: RastaBoss777 ($0.98 in chips)=20
Seat 5: betao22 ($1.54 in chips)=20
Seat 6: Aracidus ($1.05 in chips)=20
Seat 7: ElSchmidtzel ($2.35 in chips)=20
Seat 9: Radom94 ($1.01 in chips)=20
Radom94: posts small blind $0.01
iliyan66: posts big blind $0.02
*** HOLE CARDS ***
Dealt to the_wickstar [Tc 5d]
the_wickstar: folds=20
sergey347: folds=20
RastaBoss777: folds=20
betao22: calls $0.02
Aracidus: folds=20
ElSchmidtzel: folds=20
Radom94: folds=20
iliyan66: checks=20
*** FLOP *** [5c 8s 8d]
iliyan66: checks=20
betao22: checks=20
*** TURN *** [5c 8s 8d] [3c]
iliyan66: checks=20
betao22: bets $0.02
iliyan66: calls $0.02
*** RIVER *** [5c 8s 8d 3c] [Th]
iliyan66: checks=20
betao22: checks=20
*** SHOW DOWN ***
iliyan66: shows [9h 7d] (a pair of Eights)
betao22: shows [As 9s] (a pair of Eights - Ace kicker)
betao22 collected $0.09 from pot
*** SUMMARY ***
Total pot $0.09 | Rake $0=20
Board [5c 8s 8d 3c Th]
Seat 1: iliyan66 (big blind) showed [9h 7d] and lost with a pair of Eig=
hts
Seat 2: the_wickstar folded before Flop (didn't bet)
Seat 3: sergey347 folded before Flop (didn't bet)
Seat 4: RastaBoss777 folded before Flop (didn't bet)
Seat 5: betao22 showed [As 9s] and won ($0.09) with a pair of Eights
Seat 6: Aracidus folded before Flop (didn't bet)
Seat 7: ElSchmidtzel (button) folded before Flop (didn't bet)
Seat 9: Radom94 (small blind) folded before Flop


*********** # 56 **************
PokerStars Hand #169406657470:  Hold'em No Limit ($0.01/$0.02 USD) - 20=
17/04/23 3:38:31 CUST [2017/04/22 13:38:31 ET]
Table 'Enif' 9-max Seat #6 is the button
Seat 1: iliyan66 ($1.94 in chips)=20
Seat 2: the_wickstar ($0.85 in chips)=20
Seat 3: sergey347 ($1.69 in chips)=20
Seat 4: RastaBoss777 ($0.98 in chips)=20
Seat 5: betao22 ($1.56 in chips)=20
Seat 6: Aracidus ($1.07 in chips)=20
Seat 7: ElSchmidtzel ($2.36 in chips)=20
Seat 9: Radom94 ($0.94 in chips)=20
ElSchmidtzel: posts small blind $0.01
Radom94: posts big blind $0.02
*** HOLE CARDS ***
Dealt to the_wickstar [8c 2c]
iliyan66: folds=20
the_wickstar: folds=20
sergey347: calls $0.02
RastaBoss777: folds=20
betao22: calls $0.02
Aracidus: calls $0.02
ElSchmidtzel: folds=20
Radom94: checks=20
*** FLOP *** [7h Js 2h]
Radom94: checks=20
sergey347: checks=20
betao22: checks=20
Aracidus: checks=20
*** TURN *** [7h Js 2h] [5h]
Radom94: checks=20
sergey347: checks=20
betao22: checks=20
Aracidus: checks=20
*** RIVER *** [7h Js 2h 5h] [2d]
Radom94: bets $0.04
sergey347: folds=20
betao22: folds=20
Aracidus: folds=20
Uncalled bet ($0.04) returned to Radom94
Radom94 collected $0.09 from pot
Radom94: doesn't show hand=20
*** SUMMARY ***
Total pot $0.09 | Rake $0=20
Board [7h Js 2h 5h 2d]
Seat 1: iliyan66 folded before Flop (didn't bet)
Seat 2: the_wickstar folded before Flop (didn't bet)
Seat 3: sergey347 folded on the River
Seat 4: RastaBoss777 folded before Flop (didn't bet)
Seat 5: betao22 folded on the River
Seat 6: Aracidus (button) folded on the River
Seat 7: ElSchmidtzel (small blind) folded before Flop
Seat 9: Radom94 (big blind) collected ($0.09)


*********** # 57 **************
PokerStars Hand #169406638746:  Hold'em No Limit ($0.01/$0.02 USD) - 20=
17/04/23 3:38:08 CUST [2017/04/22 13:38:08 ET]
Table 'Enif' 9-max Seat #5 is the button
Seat 1: iliyan66 ($1.94 in chips)=20
Seat 2: the_wickstar ($0.87 in chips)=20
Seat 3: sergey347 ($1.69 in chips)=20
Seat 4: RastaBoss777 ($0.98 in chips)=20
Seat 5: betao22 ($1.56 in chips)=20
Seat 6: Aracidus ($1.03 in chips)=20
Seat 7: ElSchmidtzel ($2.38 in chips)=20
Seat 9: Radom94 ($0.94 in chips)=20
Aracidus: posts small blind $0.01
ElSchmidtzel: posts big blind $0.02
*** HOLE CARDS ***
Dealt to the_wickstar [Kh 9c]
Radom94: folds=20
iliyan66: folds=20
the_wickstar: calls $0.02
sergey347: folds=20
RastaBoss777: folds=20
betao22: folds=20
Aracidus: raises $0.06 to $0.08
ElSchmidtzel: folds=20
the_wickstar: folds=20
Uncalled bet ($0.06) returned to Aracidus
Aracidus collected $0.06 from pot
*** SUMMARY ***
Total pot $0.06 | Rake $0=20
Seat 1: iliyan66 folded before Flop (didn't bet)
Seat 2: the_wickstar folded before Flop
Seat 3: sergey347 folded before Flop (didn't bet)
Seat 4: RastaBoss777 folded before Flop (didn't bet)
Seat 5: betao22 (button) folded before Flop (didn't bet)
Seat 6: Aracidus (small blind) collected ($0.06)
Seat 7: ElSchmidtzel (big blind) folded before Flop
Seat 9: Radom94 folded before Flop (didn't bet)


*********** # 58 **************
PokerStars Hand #169406618091:  Hold'em No Limit ($0.01/$0.02 USD) - 20=
17/04/23 3:37:44 CUST [2017/04/22 13:37:44 ET]
Table 'Joella' 9-max Seat #3 is the button
Seat 1: betao22 ($1.70 in chips)=20
Seat 2: the_wickstar ($1.70 in chips)=20
Seat 3: oSkARiLLo85 ($0.41 in chips)=20
Seat 5: Chernovsky ($2.50 in chips)=20
Seat 6: kiiits82 ($2 in chips)=20
Seat 7: michispaw ($3.35 in chips)=20
Seat 8: Natsoviy711 ($1.97 in chips)=20
Seat 9: All IN-Fort ($2.64 in chips)=20
Chernovsky: posts small blind $0.01
kiiits82: posts big blind $0.02
*** HOLE CARDS ***
Dealt to the_wickstar [Ah 2s]
michispaw: calls $0.02
Natsoviy711: folds=20
All IN-Fort: folds=20
betao22: folds=20
gogu575 leaves the table
the_wickstar: calls $0.02
enchantressA joins the table at seat #4=20
oSkARiLLo85: calls $0.02
Chernovsky: folds=20
kiiits82: checks=20
*** FLOP *** [Qd 6s Qh]
kiiits82: checks=20
michispaw: checks=20
the_wickstar: checks=20
oSkARiLLo85: checks=20
*** TURN *** [Qd 6s Qh] [5d]
kiiits82: checks=20
michispaw: checks=20
the_wickstar: bets $0.06
oSkARiLLo85: folds=20
kiiits82: calls $0.06
michispaw: calls $0.06
*** RIVER *** [Qd 6s Qh 5d] [2d]
kiiits82: checks=20
michispaw: bets $0.10
the_wickstar: folds=20
kiiits82: folds=20
Uncalled bet ($0.10) returned to michispaw
michispaw collected $0.26 from pot
michispaw: doesn't show hand=20
*** SUMMARY ***
Total pot $0.27 | Rake $0.01=20
Board [Qd 6s Qh 5d 2d]
Seat 1: betao22 folded before Flop (didn't bet)
Seat 2: the_wickstar folded on the River
Seat 3: oSkARiLLo85 (button) folded on the Turn
Seat 5: Chernovsky (small blind) folded before Flop
Seat 6: kiiits82 (big blind) folded on the River
Seat 7: michispaw collected ($0.26)
Seat 8: Natsoviy711 folded before Flop (didn't bet)
Seat 9: All IN-Fort folded before Flop (didn't bet)


*********** # 59 **************
PokerStars Hand #169406576378:  Hold'em No Limit ($0.01/$0.02 USD) - 20=
17/04/23 3:36:53 CUST [2017/04/22 13:36:53 ET]
Table 'Enif' 9-max Seat #4 is the button
Seat 1: iliyan66 ($1.94 in chips)=20
Seat 2: the_wickstar ($0.75 in chips)=20
Seat 3: sergey347 ($1.69 in chips)=20
Seat 4: RastaBoss777 ($0.98 in chips)=20
Seat 5: betao22 ($1.57 in chips)=20
Seat 6: Aracidus ($1.09 in chips)=20
Seat 7: ElSchmidtzel ($2.38 in chips)=20
Seat 9: Radom94 ($1 in chips)=20
betao22: posts small blind $0.01
Aracidus: posts big blind $0.02
*** HOLE CARDS ***
Dealt to the_wickstar [Js Tc]
ElSchmidtzel: folds=20
Radom94: calls $0.02
iliyan66: folds=20
the_wickstar: raises $0.04 to $0.06
sergey347: folds=20
RastaBoss777: folds=20
betao22: folds=20
Aracidus: calls $0.04
Radom94: calls $0.04
*** FLOP *** [3d 9s 7h]
Aracidus: checks=20
Radom94: checks=20
the_wickstar: bets $0.16
Aracidus: folds=20
Radom94: folds=20
Uncalled bet ($0.16) returned to the_wickstar
the_wickstar collected $0.18 from pot
*** SUMMARY ***
Total pot $0.19 | Rake $0.01=20
Board [3d 9s 7h]
Seat 1: iliyan66 folded before Flop (didn't bet)
Seat 2: the_wickstar collected ($0.18)
Seat 3: sergey347 folded before Flop (didn't bet)
Seat 4: RastaBoss777 (button) folded before Flop (didn't bet)
Seat 5: betao22 (small blind) folded before Flop
Seat 6: Aracidus (big blind) folded on the Flop
Seat 7: ElSchmidtzel folded before Flop (didn't bet)
Seat 9: Radom94 folded on the Flop


*********** # 60 **************
PokerStars Hand #169406562932:  Hold'em No Limit ($0.01/$0.02 USD) - 20=
17/04/23 3:36:37 CUST [2017/04/22 13:36:37 ET]
Table 'Joella' 9-max Seat #2 is the button
Seat 1: betao22 ($1.72 in chips)=20
Seat 2: the_wickstar ($1.70 in chips)=20
Seat 3: oSkARiLLo85 ($0.43 in chips)=20
Seat 4: gogu575 ($1.15 in chips)=20
Seat 5: Chernovsky ($2.50 in chips)=20
Seat 7: michispaw ($3.35 in chips)=20
Seat 8: Natsoviy711 ($1.97 in chips)=20
Seat 9: All IN-Fort ($1.53 in chips)=20
oSkARiLLo85: posts small blind $0.01
gogu575: posts big blind $0.02
kiiits82: sits out=20
*** HOLE CARDS ***
Dealt to the_wickstar [Ts 3s]
Chernovsky: folds=20
michispaw: folds=20
Natsoviy711: folds=20
All IN-Fort: calls $0.02
betao22: calls $0.02
the_wickstar: folds=20
oSkARiLLo85: calls $0.01
gogu575: checks=20
*** FLOP *** [4c 5s 2h]
oSkARiLLo85: checks=20
gogu575: checks=20
All IN-Fort: bets $0.04
betao22: folds=20
oSkARiLLo85: folds=20
gogu575: calls $0.04
*** TURN *** [4c 5s 2h] [8d]
gogu575: checks=20
All IN-Fort: bets $0.14
gogu575: calls $0.14
*** RIVER *** [4c 5s 2h 8d] [Th]
gogu575: checks=20
All IN-Fort: bets $1.33 and is all-in
gogu575: calls $0.95 and is all-in
Uncalled bet ($0.38) returned to All IN-Fort
*** SHOW DOWN ***
All IN-Fort: shows [7c 6c] (a straight, Four to Eight)
gogu575: shows [Kh Kd] (a pair of Kings)
All IN-Fort collected $2.26 from pot
*** SUMMARY ***
Total pot $2.34 | Rake $0.08=20
Board [4c 5s 2h 8d Th]
Seat 1: betao22 folded on the Flop
Seat 2: the_wickstar (button) folded before Flop (didn't bet)
Seat 3: oSkARiLLo85 (small blind) folded on the Flop
Seat 4: gogu575 (big blind) showed [Kh Kd] and lost with a pair of Kings
Seat 5: Chernovsky folded before Flop (didn't bet)
Seat 7: michispaw folded before Flop (didn't bet)
Seat 8: Natsoviy711 folded before Flop (didn't bet)
Seat 9: All IN-Fort showed [7c 6c] and won ($2.26) with a straight, Fou=
r to Eight


*********** # 61 **************
PokerStars Hand #169406535917:  Hold'em No Limit ($0.01/$0.02 USD) - 20=
17/04/23 3:36:05 CUST [2017/04/22 13:36:05 ET]
Table 'Joella' 9-max Seat #1 is the button
Seat 1: betao22 ($1.72 in chips)=20
Seat 2: the_wickstar ($1.71 in chips)=20
Seat 3: oSkARiLLo85 ($0.42 in chips)=20
Seat 4: gogu575 ($1.15 in chips)=20
Seat 5: Chernovsky ($2.50 in chips)=20
Seat 7: michispaw ($3.35 in chips)=20
Seat 8: Natsoviy711 ($1.97 in chips)=20
Seat 9: All IN-Fort ($1.53 in chips)=20
the_wickstar: posts small blind $0.01
oSkARiLLo85: posts big blind $0.02
kiiits82: sits out=20
*** HOLE CARDS ***
Dealt to the_wickstar [7s 3c]
gogu575: folds=20
Chernovsky: folds=20
michispaw: folds=20
Natsoviy711: folds=20
All IN-Fort: folds=20
betao22: folds=20
the_wickstar: folds=20
Uncalled bet ($0.01) returned to oSkARiLLo85
oSkARiLLo85 collected $0.02 from pot
oSkARiLLo85: doesn't show hand=20
*** SUMMARY ***
Total pot $0.02 | Rake $0=20
Seat 1: betao22 (button) folded before Flop (didn't bet)
Seat 2: the_wickstar (small blind) folded before Flop
Seat 3: oSkARiLLo85 (big blind) collected ($0.02)
Seat 4: gogu575 folded before Flop (didn't bet)
Seat 5: Chernovsky folded before Flop (didn't bet)
Seat 7: michispaw folded before Flop (didn't bet)
Seat 8: Natsoviy711 folded before Flop (didn't bet)
Seat 9: All IN-Fort folded before Flop (didn't bet)


*********** # 62 **************
PokerStars Hand #169406526613:  Hold'em No Limit ($0.01/$0.02 USD) - 20=
17/04/23 3:35:54 CUST [2017/04/22 13:35:54 ET]
Table 'Enif' 9-max Seat #3 is the button
Seat 1: iliyan66 ($1.94 in chips)=20
Seat 2: the_wickstar ($0.60 in chips)=20
Seat 3: sergey347 ($1.69 in chips)=20
Seat 4: RastaBoss777 ($0.99 in chips)=20
Seat 5: betao22 ($1.59 in chips)=20
Seat 6: Aracidus ($1.22 in chips)=20
Seat 7: ElSchmidtzel ($2.38 in chips)=20
Seat 9: Radom94 ($1 in chips)=20
RastaBoss777: posts small blind $0.01
betao22: posts big blind $0.02
*** HOLE CARDS ***
Dealt to the_wickstar [Ts Js]
Aracidus: raises $0.04 to $0.06
ElSchmidtzel: folds=20
Radom94: folds=20
iliyan66: folds=20
the_wickstar: calls $0.06
sergey347: folds=20
RastaBoss777: folds=20
betao22: folds=20
*** FLOP *** [8h Jh Kc]
Aracidus: bets $0.07
the_wickstar: calls $0.07
*** TURN *** [8h Jh Kc] [8d]
Aracidus: checks=20
the_wickstar: bets $0.28
Aracidus: folds=20
Uncalled bet ($0.28) returned to the_wickstar
the_wickstar collected $0.28 from pot
*** SUMMARY ***
Total pot $0.29 | Rake $0.01=20
Board [8h Jh Kc 8d]
Seat 1: iliyan66 folded before Flop (didn't bet)
Seat 2: the_wickstar collected ($0.28)
Seat 3: sergey347 (button) folded before Flop (didn't bet)
Seat 4: RastaBoss777 (small blind) folded before Flop
Seat 5: betao22 (big blind) folded before Flop
Seat 6: Aracidus folded on the Turn
Seat 7: ElSchmidtzel folded before Flop (didn't bet)
Seat 9: Radom94 folded before Flop (didn't bet)


*********** # 63 **************
PokerStars Hand #169406462745:  Hold'em No Limit ($0.01/$0.02 USD) - 20=
17/04/23 3:34:43 CUST [2017/04/22 13:34:43 ET]
Table 'Joella' 9-max Seat #9 is the button
Seat 1: betao22 ($1.73 in chips)=20
Seat 2: the_wickstar ($1.77 in chips)=20
Seat 3: oSkARiLLo85 ($0.48 in chips)=20
Seat 4: gogu575 ($1.15 in chips)=20
Seat 5: Chernovsky ($2.50 in chips)=20
Seat 7: michispaw ($3.17 in chips)=20
Seat 8: Natsoviy711 ($1.97 in chips)=20
Seat 9: All IN-Fort ($1.59 in chips)=20
betao22: posts small blind $0.01
the_wickstar: posts big blind $0.02
kiiits82: sits out=20
*** HOLE CARDS ***
Dealt to the_wickstar [5h 6h]
oSkARiLLo85: calls $0.02
gogu575: folds=20
Chernovsky: folds=20
michispaw: raises $0.04 to $0.06
Natsoviy711: folds=20
All IN-Fort: calls $0.06
betao22: folds=20
the_wickstar: calls $0.04
oSkARiLLo85: calls $0.04
*** FLOP *** [2d Qd Qc]
the_wickstar: checks=20
oSkARiLLo85: checks=20
michispaw: bets $0.12
All IN-Fort: folds=20
the_wickstar: folds=20
oSkARiLLo85: folds=20
Uncalled bet ($0.12) returned to michispaw
michispaw collected $0.24 from pot
michispaw: doesn't show hand=20
*** SUMMARY ***
Total pot $0.25 | Rake $0.01=20
Board [2d Qd Qc]
Seat 1: betao22 (small blind) folded before Flop
Seat 2: the_wickstar (big blind) folded on the Flop
Seat 3: oSkARiLLo85 folded on the Flop
Seat 4: gogu575 folded before Flop (didn't bet)
Seat 5: Chernovsky folded before Flop (didn't bet)
Seat 7: michispaw collected ($0.24)
Seat 8: Natsoviy711 folded before Flop (didn't bet)
Seat 9: All IN-Fort (button) folded on the Flop


*********** # 64 **************
PokerStars Hand #169406460285:  Hold'em No Limit ($0.01/$0.02 USD) - 20=
17/04/23 3:34:40 CUST [2017/04/22 13:34:40 ET]
Table 'Enif' 9-max Seat #2 is the button
Seat 1: iliyan66 ($1.94 in chips)=20
Seat 2: the_wickstar ($0.79 in chips)=20
Seat 3: sergey347 ($1.70 in chips)=20
Seat 4: RastaBoss777 ($0.80 in chips)=20
Seat 5: betao22 ($1.59 in chips)=20
Seat 6: Aracidus ($1.22 in chips)=20
Seat 7: ElSchmidtzel ($2.38 in chips)=20
Seat 9: Radom94 ($1 in chips)=20
sergey347: posts small blind $0.01
RastaBoss777: posts big blind $0.02
*** HOLE CARDS ***
Dealt to the_wickstar [6c 2s]
betao22: folds=20
Aracidus: folds=20
ElSchmidtzel: folds=20
Radom94: folds=20
iliyan66: folds=20
the_wickstar: raises $0.04 to $0.06
sergey347: folds=20
RastaBoss777: calls $0.04
*** FLOP *** [4c Kh As]
RastaBoss777: checks=20
the_wickstar: bets $0.13
RastaBoss777: calls $0.13
*** TURN *** [4c Kh As] [8d]
RastaBoss777: checks=20
the_wickstar: checks=20
*** RIVER *** [4c Kh As 8d] [8c]
RastaBoss777: bets $0.18
the_wickstar: folds=20
Uncalled bet ($0.18) returned to RastaBoss777
RastaBoss777 collected $0.38 from pot
RastaBoss777: doesn't show hand=20
*** SUMMARY ***
Total pot $0.39 | Rake $0.01=20
Board [4c Kh As 8d 8c]
Seat 1: iliyan66 folded before Flop (didn't bet)
Seat 2: the_wickstar (button) folded on the River
Seat 3: sergey347 (small blind) folded before Flop
Seat 4: RastaBoss777 (big blind) collected ($0.38)
Seat 5: betao22 folded before Flop (didn't bet)
Seat 6: Aracidus folded before Flop (didn't bet)
Seat 7: ElSchmidtzel folded before Flop (didn't bet)
Seat 9: Radom94 folded before Flop (didn't bet)


*********** # 65 **************
PokerStars Hand #169406434878:  Hold'em No Limit ($0.01/$0.02 USD) - 20=
17/04/23 3:34:10 CUST [2017/04/22 13:34:10 ET]
Table 'Joella' 9-max Seat #8 is the button
Seat 1: betao22 ($1.75 in chips)=20
Seat 2: the_wickstar ($1.77 in chips)=20
Seat 3: oSkARiLLo85 ($0.48 in chips)=20
Seat 4: gogu575 ($1.15 in chips)=20
Seat 5: Chernovsky ($2.55 in chips)=20
Seat 7: michispaw ($3.17 in chips)=20
Seat 8: Natsoviy711 ($1.97 in chips)=20
Seat 9: All IN-Fort ($1.52 in chips)=20
All IN-Fort: posts small blind $0.01
betao22: posts big blind $0.02
kiiits82: sits out=20
*** HOLE CARDS ***
Dealt to the_wickstar [7c 8c]
the_wickstar: folds=20
oSkARiLLo85: folds=20
gogu575: folds=20
Chernovsky: raises $0.03 to $0.05
michispaw: folds=20
Natsoviy711: folds=20
All IN-Fort: raises $0.12 to $0.17
betao22: folds=20
Chernovsky: folds=20
Uncalled bet ($0.12) returned to All IN-Fort
All IN-Fort collected $0.12 from pot
All IN-Fort: doesn't show hand=20
*** SUMMARY ***
Total pot $0.12 | Rake $0=20
Seat 1: betao22 (big blind) folded before Flop
Seat 2: the_wickstar folded before Flop (didn't bet)
Seat 3: oSkARiLLo85 folded before Flop (didn't bet)
Seat 4: gogu575 folded before Flop (didn't bet)
Seat 5: Chernovsky folded before Flop
Seat 7: michispaw folded before Flop (didn't bet)
Seat 8: Natsoviy711 (button) folded before Flop (didn't bet)
Seat 9: All IN-Fort (small blind) collected ($0.12)


*********** # 66 **************
PokerStars Hand #169406421958:  Hold'em No Limit ($0.01/$0.02 USD) - 20=
17/04/23 3:33:55 CUST [2017/04/22 13:33:55 ET]
Table 'Enif' 9-max Seat #1 is the button
Seat 1: iliyan66 ($1.94 in chips)=20
Seat 2: the_wickstar ($0.77 in chips)=20
Seat 3: sergey347 ($1.72 in chips)=20
Seat 5: betao22 ($1.59 in chips)=20
Seat 6: Aracidus ($1.22 in chips)=20
Seat 7: ElSchmidtzel ($2.38 in chips)=20
the_wickstar: posts small blind $0.01
sergey347: posts big blind $0.02
RastaBoss777: sits out=20
*** HOLE CARDS ***
Dealt to the_wickstar [Kc Jc]
betao22: folds=20
Aracidus: folds=20
ElSchmidtzel: folds=20
iliyan66: folds=20
the_wickstar: raises $0.04 to $0.06
sergey347: folds=20
Uncalled bet ($0.04) returned to the_wickstar
the_wickstar collected $0.04 from pot
*** SUMMARY ***
Total pot $0.04 | Rake $0=20
Seat 1: iliyan66 (button) folded before Flop (didn't bet)
Seat 2: the_wickstar (small blind) collected ($0.04)
Seat 3: sergey347 (big blind) folded before Flop
Seat 5: betao22 folded before Flop (didn't bet)
Seat 6: Aracidus folded before Flop (didn't bet)
Seat 7: ElSchmidtzel folded before Flop (didn't bet)


*********** # 67 **************
PokerStars Hand #169406404786:  Hold'em No Limit ($0.01/$0.02 USD) - 20=
17/04/23 3:33:34 CUST [2017/04/22 13:33:34 ET]
Table 'Joella' 9-max Seat #7 is the button
Seat 1: betao22 ($1.75 in chips)=20
Seat 2: the_wickstar ($1.79 in chips)=20
Seat 3: oSkARiLLo85 ($0.48 in chips)=20
Seat 4: gogu575 ($1.15 in chips)=20
Seat 5: Chernovsky ($2.55 in chips)=20
Seat 7: michispaw ($3.17 in chips)=20
Seat 8: Natsoviy711 ($1.93 in chips)=20
Seat 9: All IN-Fort ($1.54 in chips)=20
Natsoviy711: posts small blind $0.01
All IN-Fort: posts big blind $0.02
kiiits82: sits out=20
*** HOLE CARDS ***
Dealt to the_wickstar [Qd 4c]
betao22: folds=20
the_wickstar: calls $0.02
oSkARiLLo85: folds=20
gogu575: folds=20
Chernovsky: folds=20
michispaw: folds=20
Natsoviy711: calls $0.01
All IN-Fort: checks=20
*** FLOP *** [6s 4h 3h]
Natsoviy711: bets $0.06
All IN-Fort: folds=20
the_wickstar: folds=20
Uncalled bet ($0.06) returned to Natsoviy711
Natsoviy711 collected $0.06 from pot
*** SUMMARY ***
Total pot $0.06 | Rake $0=20
Board [6s 4h 3h]
Seat 1: betao22 folded before Flop (didn't bet)
Seat 2: the_wickstar folded on the Flop
Seat 3: oSkARiLLo85 folded before Flop (didn't bet)
Seat 4: gogu575 folded before Flop (didn't bet)
Seat 5: Chernovsky folded before Flop (didn't bet)
Seat 7: michispaw (button) folded before Flop (didn't bet)
Seat 8: Natsoviy711 (small blind) collected ($0.06)
Seat 9: All IN-Fort (big blind) folded on the Flop


*********** # 68 **************
PokerStars Hand #169406382314:  Hold'em No Limit ($0.01/$0.02 USD) - 20=
17/04/23 3:33:07 CUST [2017/04/22 13:33:07 ET]
Table 'Enif' 9-max Seat #7 is the button
Seat 1: iliyan66 ($1.96 in chips)=20
Seat 2: the_wickstar ($0.77 in chips)=20
Seat 3: sergey347 ($1.72 in chips)=20
Seat 5: betao22 ($1.59 in chips)=20
Seat 6: Aracidus ($1.28 in chips)=20
Seat 7: ElSchmidtzel ($1.94 in chips)=20
Seat 9: Radom94 ($0.39 in chips)=20
Radom94: posts small blind $0.01
iliyan66: posts big blind $0.02
RastaBoss777: sits out=20
*** HOLE CARDS ***
Dealt to the_wickstar [Qh 2d]
the_wickstar: folds=20
sergey347: folds=20
betao22: folds=20
Aracidus: calls $0.02
ElSchmidtzel: raises $0.04 to $0.06
Radom94: calls $0.05
iliyan66: folds=20
Aracidus: calls $0.04
*** FLOP *** [6h 7s 4s]
Radom94: bets $0.10
Aracidus: folds=20
ElSchmidtzel: calls $0.10
*** TURN *** [6h 7s 4s] [5s]
Radom94: bets $0.23 and is all-in
ElSchmidtzel: calls $0.23
*** RIVER *** [6h 7s 4s 5s] [Jd]
*** SHOW DOWN ***
Radom94: shows [Kd Ac] (high card Ace)
ElSchmidtzel: shows [8s Ts] (a flush, Ten high)
ElSchmidtzel collected $0.83 from pot
*** SUMMARY ***
Total pot $0.86 | Rake $0.03=20
Board [6h 7s 4s 5s Jd]
Seat 1: iliyan66 (big blind) folded before Flop
Seat 2: the_wickstar folded before Flop (didn't bet)
Seat 3: sergey347 folded before Flop (didn't bet)
Seat 5: betao22 folded before Flop (didn't bet)
Seat 6: Aracidus folded on the Flop
Seat 7: ElSchmidtzel (button) showed [8s Ts] and won ($0.83) with a flu=
sh, Ten high
Seat 9: Radom94 (small blind) showed [Kd Ac] and lost with high card Ace


*********** # 69 **************
PokerStars Hand #169406345327:  Hold'em No Limit ($0.01/$0.02 USD) - 20=
17/04/23 3:32:23 CUST [2017/04/22 13:32:23 ET]
Table 'Enif' 9-max Seat #6 is the button
Seat 1: iliyan66 ($1.96 in chips)=20
Seat 2: the_wickstar ($0.70 in chips)=20
Seat 3: sergey347 ($1.74 in chips)=20
Seat 4: Hirnibirni ($3.11 in chips)=20
Seat 5: betao22 ($1.59 in chips)=20
Seat 6: Aracidus ($1.30 in chips)=20
Seat 7: ElSchmidtzel ($1.95 in chips)=20
Seat 9: Radom94 ($0.41 in chips)=20
ElSchmidtzel: posts small blind $0.01
Radom94: posts big blind $0.02
*** HOLE CARDS ***
Dealt to the_wickstar [Ad 9d]
iliyan66: folds=20
the_wickstar: calls $0.02
sergey347: calls $0.02
Hirnibirni: folds=20
betao22: folds=20
Aracidus: calls $0.02
ElSchmidtzel: folds=20
Radom94: checks=20
*** FLOP *** [Jd 5s 2s]
Radom94: checks=20
the_wickstar: checks=20
sergey347: checks=20
Aracidus: checks=20
*** TURN *** [Jd 5s 2s] [7s]
Radom94: checks=20
Hirnibirni leaves the table
the_wickstar: bets $0.09
RastaBoss777 joins the table at seat #4=20
sergey347: folds=20
Aracidus: folds=20
Radom94: folds=20
Uncalled bet ($0.09) returned to the_wickstar
the_wickstar collected $0.09 from pot
*** SUMMARY ***
Total pot $0.09 | Rake $0=20
Board [Jd 5s 2s 7s]
Seat 1: iliyan66 folded before Flop (didn't bet)
Seat 2: the_wickstar collected ($0.09)
Seat 3: sergey347 folded on the Turn
Seat 4: Hirnibirni folded before Flop (didn't bet)
Seat 5: betao22 folded before Flop (didn't bet)
Seat 6: Aracidus (button) folded on the Turn
Seat 7: ElSchmidtzel (small blind) folded before Flop
Seat 9: Radom94 (big blind) folded on the Turn


*********** # 70 **************
PokerStars Hand #169406340734:  Hold'em No Limit ($0.01/$0.02 USD) - 20=
17/04/23 3:32:17 CUST [2017/04/22 13:32:17 ET]
Table 'Joella' 9-max Seat #5 is the button
Seat 1: betao22 ($1.75 in chips)=20
Seat 2: the_wickstar ($1.79 in chips)=20
Seat 3: oSkARiLLo85 ($0.66 in chips)=20
Seat 4: gogu575 ($1.15 in chips)=20
Seat 5: Chernovsky ($2.55 in chips)=20
Seat 7: michispaw ($2.98 in chips)=20
Seat 8: Natsoviy711 ($1.95 in chips)=20
Seat 9: All IN-Fort ($1.54 in chips)=20
kiiits82 will be allowed to play after the button
michispaw: posts small blind $0.01
Natsoviy711: posts big blind $0.02
*** HOLE CARDS ***
Dealt to the_wickstar [6h 4h]
All IN-Fort: folds=20
betao22: folds=20
the_wickstar: folds=20
oSkARiLLo85: calls $0.02
gogu575: folds=20
Chernovsky: folds=20
michispaw: raises $0.06 to $0.08
Natsoviy711: folds=20
oSkARiLLo85: calls $0.06
*** FLOP *** [Ad 9h 8h]
michispaw: bets $0.10
oSkARiLLo85: calls $0.10
*** TURN *** [Ad 9h 8h] [2d]
michispaw: checks=20
oSkARiLLo85: checks=20
*** RIVER *** [Ad 9h 8h 2d] [Ah]
michispaw: bets $0.16
oSkARiLLo85: folds=20
Uncalled bet ($0.16) returned to michispaw
michispaw collected $0.37 from pot
michispaw: doesn't show hand=20
*** SUMMARY ***
Total pot $0.38 | Rake $0.01=20
Board [Ad 9h 8h 2d Ah]
Seat 1: betao22 folded before Flop (didn't bet)
Seat 2: the_wickstar folded before Flop (didn't bet)
Seat 3: oSkARiLLo85 folded on the River
Seat 4: gogu575 folded before Flop (didn't bet)
Seat 5: Chernovsky (button) folded before Flop (didn't bet)
Seat 7: michispaw (small blind) collected ($0.37)
Seat 8: Natsoviy711 (big blind) folded before Flop
Seat 9: All IN-Fort folded before Flop (didn't bet)


*********** # 71 **************
PokerStars Hand #169406290190:  Hold'em No Limit ($0.01/$0.02 USD) - 20=
17/04/23 3:31:17 CUST [2017/04/22 13:31:17 ET]
Table 'Enif' 9-max Seat #5 is the button
Seat 1: iliyan66 ($1.96 in chips)=20
Seat 2: the_wickstar ($0.72 in chips)=20
Seat 3: sergey347 ($1.74 in chips)=20
Seat 4: Hirnibirni ($3.11 in chips)=20
Seat 5: betao22 ($1.59 in chips)=20
Seat 6: Aracidus ($1.31 in chips)=20
Seat 7: ElSchmidtzel ($1.92 in chips)=20
Seat 9: Radom94 ($0.41 in chips)=20
Aracidus: posts small blind $0.01
ElSchmidtzel: posts big blind $0.02
*** HOLE CARDS ***
Dealt to the_wickstar [2c Ah]
Radom94: folds=20
iliyan66: folds=20
the_wickstar: calls $0.02
sergey347: folds=20
Hirnibirni: folds=20
betao22: folds=20
Aracidus: folds=20
ElSchmidtzel: raises $0.06 to $0.08
the_wickstar: folds=20
Uncalled bet ($0.06) returned to ElSchmidtzel
ElSchmidtzel collected $0.05 from pot
ElSchmidtzel: doesn't show hand=20
*** SUMMARY ***
Total pot $0.05 | Rake $0=20
Seat 1: iliyan66 folded before Flop (didn't bet)
Seat 2: the_wickstar folded before Flop
Seat 3: sergey347 folded before Flop (didn't bet)
Seat 4: Hirnibirni folded before Flop (didn't bet)
Seat 5: betao22 (button) folded before Flop (didn't bet)
Seat 6: Aracidus (small blind) folded before Flop
Seat 7: ElSchmidtzel (big blind) collected ($0.05)
Seat 9: Radom94 folded before Flop (didn't bet)


*********** # 72 **************
PokerStars Hand #169406261236:  Hold'em No Limit ($0.01/$0.02 USD) - 20=
17/04/23 3:30:42 CUST [2017/04/22 13:30:42 ET]
Table 'Joella' 9-max Seat #4 is the button
Seat 1: betao22 ($1.77 in chips)=20
Seat 2: the_wickstar ($1.65 in chips)=20
Seat 3: oSkARiLLo85 ($0.70 in chips)=20
Seat 4: gogu575 ($1.19 in chips)=20
Seat 5: Chernovsky ($2.56 in chips)=20
Seat 7: michispaw ($3.02 in chips)=20
Seat 8: Natsoviy711 ($1.95 in chips)=20
Seat 9: All IN-Fort ($1.54 in chips)=20
Chernovsky: posts small blind $0.01
No1da: is sitting out=20
michispaw: posts big blind $0.02
*** HOLE CARDS ***
Dealt to the_wickstar [8d Qh]
Natsoviy711: folds=20
No1da leaves the table
All IN-Fort: folds=20
kiiits82 joins the table at seat #6=20
betao22: calls $0.02
the_wickstar: calls $0.02
oSkARiLLo85: calls $0.02
gogu575: calls $0.02
Chernovsky: folds=20
michispaw: checks=20
*** FLOP *** [5d 5s 3c]
michispaw: checks=20
betao22: checks=20
the_wickstar: checks=20
oSkARiLLo85: bets $0.02
gogu575: calls $0.02
michispaw: calls $0.02
betao22: folds=20
the_wickstar: calls $0.02
*** TURN *** [5d 5s 3c] [8h]
michispaw: checks=20
the_wickstar: checks=20
oSkARiLLo85: checks=20
gogu575: checks=20
*** RIVER *** [5d 5s 3c 8h] [Td]
michispaw: checks=20
the_wickstar: checks=20
oSkARiLLo85: checks=20
gogu575: checks=20
*** SHOW DOWN ***
michispaw: shows [2h Ad] (a pair of Fives)
the_wickstar: shows [8d Qh] (two pair, Eights and Fives)
oSkARiLLo85: mucks hand=20
gogu575: mucks hand=20
the_wickstar collected $0.18 from pot
*** SUMMARY ***
Total pot $0.19 | Rake $0.01=20
Board [5d 5s 3c 8h Td]
Seat 1: betao22 folded on the Flop
Seat 2: the_wickstar showed [8d Qh] and won ($0.18) with two pair, Eigh=
ts and Fives
Seat 3: oSkARiLLo85 mucked [Ac 3h]
Seat 4: gogu575 (button) mucked [As 7d]
Seat 5: Chernovsky (small blind) folded before Flop
Seat 7: michispaw (big blind) showed [2h Ad] and lost with a pair of Fi=
ves
Seat 8: Natsoviy711 folded before Flop (didn't bet)
Seat 9: All IN-Fort folded before Flop (didn't bet)


*********** # 73 **************
PokerStars Hand #169406260290:  Hold'em No Limit ($0.01/$0.02 USD) - 20=
17/04/23 3:30:41 CUST [2017/04/22 13:30:41 ET]
Table 'Enif' 9-max Seat #4 is the button
Seat 1: iliyan66 ($1.93 in chips)=20
Seat 2: the_wickstar ($0.72 in chips)=20
Seat 3: sergey347 ($1.74 in chips)=20
Seat 4: Hirnibirni ($3.11 in chips)=20
Seat 5: betao22 ($1.60 in chips)=20
Seat 6: Aracidus ($1.33 in chips)=20
Seat 7: ElSchmidtzel ($1.92 in chips)=20
Seat 9: Radom94 ($0.41 in chips)=20
betao22: posts small blind $0.01
Aracidus: posts big blind $0.02
*** HOLE CARDS ***
Dealt to the_wickstar [3d 2h]
ElSchmidtzel: folds=20
Radom94: folds=20
iliyan66: raises $0.06 to $0.08
the_wickstar: folds=20
sergey347: folds=20
Hirnibirni: folds=20
betao22: folds=20
Aracidus: folds=20
Uncalled bet ($0.06) returned to iliyan66
iliyan66 collected $0.05 from pot
iliyan66: doesn't show hand=20
*** SUMMARY ***
Total pot $0.05 | Rake $0=20
Seat 1: iliyan66 collected ($0.05)
Seat 2: the_wickstar folded before Flop (didn't bet)
Seat 3: sergey347 folded before Flop (didn't bet)
Seat 4: Hirnibirni (button) folded before Flop (didn't bet)
Seat 5: betao22 (small blind) folded before Flop
Seat 6: Aracidus (big blind) folded before Flop
Seat 7: ElSchmidtzel folded before Flop (didn't bet)
Seat 9: Radom94 folded before Flop (didn't bet)


*********** # 74 **************
PokerStars Hand #169406213206:  Hold'em No Limit ($0.01/$0.02 USD) - 20=
17/04/23 3:29:45 CUST [2017/04/22 13:29:45 ET]
Table 'Enif' 9-max Seat #3 is the button
Seat 1: iliyan66 ($1.90 in chips)=20
Seat 2: the_wickstar ($0.72 in chips)=20
Seat 3: sergey347 ($1.74 in chips)=20
Seat 4: Hirnibirni ($3.12 in chips)=20
Seat 5: betao22 ($1.62 in chips)=20
Seat 6: Aracidus ($1.33 in chips)=20
Seat 7: ElSchmidtzel ($1.92 in chips)=20
Seat 9: Radom94 ($0.41 in chips)=20
Hirnibirni: posts small blind $0.01
betao22: posts big blind $0.02
*** HOLE CARDS ***
Dealt to the_wickstar [5s 9h]
Aracidus: folds=20
ElSchmidtzel: folds=20
Radom94: folds=20
iliyan66: raises $0.04 to $0.06
the_wickstar: folds=20
sergey347: folds=20
Hirnibirni: folds=20
betao22: folds=20
Uncalled bet ($0.04) returned to iliyan66
iliyan66 collected $0.05 from pot
iliyan66: doesn't show hand=20
*** SUMMARY ***
Total pot $0.05 | Rake $0=20
Seat 1: iliyan66 collected ($0.05)
Seat 2: the_wickstar folded before Flop (didn't bet)
Seat 3: sergey347 (button) folded before Flop (didn't bet)
Seat 4: Hirnibirni (small blind) folded before Flop
Seat 5: betao22 (big blind) folded before Flop
Seat 6: Aracidus folded before Flop (didn't bet)
Seat 7: ElSchmidtzel folded before Flop (didn't bet)
Seat 9: Radom94 folded before Flop (didn't bet)


*********** # 75 **************
PokerStars Hand #169406185273:  Hold'em No Limit ($0.01/$0.02 USD) - 20=
17/04/23 3:29:11 CUST [2017/04/22 13:29:11 ET]
Table 'Joella' 9-max Seat #3 is the button
Seat 1: betao22 ($1.77 in chips)=20
Seat 2: the_wickstar ($1.65 in chips)=20
Seat 3: oSkARiLLo85 ($0.70 in chips)=20
Seat 4: gogu575 ($1.20 in chips)=20
Seat 5: Chernovsky ($2 in chips)=20
Seat 6: No1da ($2.53 in chips)=20
Seat 7: michispaw ($3.02 in chips)=20
Seat 8: Natsoviy711 ($2.24 in chips)=20
Seat 9: All IN-Fort ($1.54 in chips)=20
gogu575: posts small blind $0.01
Chernovsky: posts big blind $0.02
*** HOLE CARDS ***
Dealt to the_wickstar [6h 7c]
No1da: raises $0.04 to $0.06
michispaw: folds=20
Natsoviy711: calls $0.06
All IN-Fort: folds=20
betao22: folds=20
the_wickstar: folds=20
oSkARiLLo85: folds=20
gogu575: folds=20
Chernovsky: calls $0.04
*** FLOP *** [3s 3d 8d]
Chernovsky: checks=20
No1da: bets $0.09
Natsoviy711: calls $0.09
Chernovsky: calls $0.09
*** TURN *** [3s 3d 8d] [As]
Chernovsky: checks=20
No1da: checks=20
Natsoviy711: bets $0.14
Chernovsky: calls $0.14
No1da: calls $0.14
*** RIVER *** [3s 3d 8d As] [2d]
Chernovsky: bets $0.55
No1da: folds=20
Natsoviy711: folds=20
Uncalled bet ($0.55) returned to Chernovsky
Chernovsky collected $0.85 from pot
Chernovsky: doesn't show hand=20
*** SUMMARY ***
Total pot $0.88 | Rake $0.03=20
Board [3s 3d 8d As 2d]
Seat 1: betao22 folded before Flop (didn't bet)
Seat 2: the_wickstar folded before Flop (didn't bet)
Seat 3: oSkARiLLo85 (button) folded before Flop (didn't bet)
Seat 4: gogu575 (small blind) folded before Flop
Seat 5: Chernovsky (big blind) collected ($0.85)
Seat 6: No1da folded on the River
Seat 7: michispaw folded before Flop (didn't bet)
Seat 8: Natsoviy711 folded on the River
Seat 9: All IN-Fort folded before Flop (didn't bet)


*********** # 76 **************
PokerStars Hand #169406142144:  Hold'em No Limit ($0.01/$0.02 USD) - 20=
17/04/23 3:28:19 CUST [2017/04/22 13:28:19 ET]
Table 'Enif' 9-max Seat #2 is the button
Seat 1: iliyan66 ($1.78 in chips)=20
Seat 2: the_wickstar ($0.82 in chips)=20
Seat 3: sergey347 ($1.75 in chips)=20
Seat 4: Hirnibirni ($3.14 in chips)=20
Seat 5: betao22 ($1.62 in chips)=20
Seat 6: Aracidus ($1.33 in chips)=20
Seat 7: ElSchmidtzel ($1.92 in chips)=20
Seat 9: Radom94 ($0.41 in chips)=20
sergey347: posts small blind $0.01
Hirnibirni: posts big blind $0.02
*** HOLE CARDS ***
Dealt to the_wickstar [3d 4s]
betao22: folds=20
Aracidus: folds=20
ElSchmidtzel: folds=20
Radom94: folds=20
iliyan66: calls $0.02
the_wickstar: calls $0.02
sergey347: folds=20
Hirnibirni: checks=20
*** FLOP *** [3h 9s 9h]
Hirnibirni: checks=20
iliyan66: checks=20
the_wickstar: bets $0.02
Hirnibirni: folds=20
iliyan66: calls $0.02
*** TURN *** [3h 9s 9h] [Th]
iliyan66: checks=20
the_wickstar: checks=20
*** RIVER *** [3h 9s 9h Th] [Qc]
iliyan66: bets $0.06
the_wickstar: calls $0.06
*** SHOW DOWN ***
iliyan66: shows [Kc Jc] (a straight, Nine to King)
the_wickstar: mucks hand=20
iliyan66 collected $0.22 from pot
*** SUMMARY ***
Total pot $0.23 | Rake $0.01=20
Board [3h 9s 9h Th Qc]
Seat 1: iliyan66 showed [Kc Jc] and won ($0.22) with a straight, Nine t=
o King
Seat 2: the_wickstar (button) mucked [3d 4s]
Seat 3: sergey347 (small blind) folded before Flop
Seat 4: Hirnibirni (big blind) folded on the Flop
Seat 5: betao22 folded before Flop (didn't bet)
Seat 6: Aracidus folded before Flop (didn't bet)
Seat 7: ElSchmidtzel folded before Flop (didn't bet)
Seat 9: Radom94 folded before Flop (didn't bet)


*********** # 77 **************
PokerStars Hand #169406136382:  Hold'em No Limit ($0.01/$0.02 USD) - 20=
17/04/23 3:28:12 CUST [2017/04/22 13:28:12 ET]
Table 'Joella' 9-max Seat #2 is the button
Seat 1: betao22 ($1.77 in chips)=20
Seat 2: the_wickstar ($1.57 in chips)=20
Seat 3: oSkARiLLo85 ($0.76 in chips)=20
Seat 4: gogu575 ($1.22 in chips)=20
Seat 6: No1da ($2.53 in chips)=20
Seat 7: michispaw ($3.02 in chips)=20
Seat 8: Natsoviy711 ($2.24 in chips)=20
Seat 9: All IN-Fort ($1.54 in chips)=20
oSkARiLLo85: posts small blind $0.01
gogu575: posts big blind $0.02
*** HOLE CARDS ***
Dealt to the_wickstar [Ac 3c]
No1da: folds=20
michispaw: folds=20
Natsoviy711: folds=20
All IN-Fort: folds=20
betao22: folds=20
the_wickstar: raises $0.04 to $0.06
oSkARiLLo85: calls $0.05
gogu575: folds=20
*** FLOP *** [7d 7s Ah]
oSkARiLLo85: checks=20
the_wickstar: bets $0.10
oSkARiLLo85: folds=20
Uncalled bet ($0.10) returned to the_wickstar
the_wickstar collected $0.14 from pot
*** SUMMARY ***
Total pot $0.14 | Rake $0=20
Board [7d 7s Ah]
Seat 1: betao22 folded before Flop (didn't bet)
Seat 2: the_wickstar (button) collected ($0.14)
Seat 3: oSkARiLLo85 (small blind) folded on the Flop
Seat 4: gogu575 (big blind) folded before Flop
Seat 6: No1da folded before Flop (didn't bet)
Seat 7: michispaw folded before Flop (didn't bet)
Seat 8: Natsoviy711 folded before Flop (didn't bet)
Seat 9: All IN-Fort folded before Flop (didn't bet)


*********** # 78 **************
PokerStars Hand #169406121233:  Hold'em No Limit ($0.01/$0.02 USD) - 20=
17/04/23 3:27:55 CUST [2017/04/22 13:27:55 ET]
Table 'Enif' 9-max Seat #1 is the button
Seat 1: iliyan66 ($1.78 in chips)=20
Seat 2: the_wickstar ($0.83 in chips)=20
Seat 3: sergey347 ($1.77 in chips)=20
Seat 4: Hirnibirni ($3.11 in chips)=20
Seat 5: betao22 ($1.62 in chips)=20
Seat 6: Aracidus ($1.33 in chips)=20
Seat 7: ElSchmidtzel ($1.92 in chips)=20
Seat 9: Radom94 ($0.41 in chips)=20
the_wickstar: posts small blind $0.01
sergey347: posts big blind $0.02
*** HOLE CARDS ***
Dealt to the_wickstar [Tc 4s]
Hirnibirni: raises $0.02 to $0.04
betao22: folds=20
Aracidus: folds=20
ElSchmidtzel: folds=20
Radom94: folds=20
iliyan66: folds=20
the_wickstar: folds=20
sergey347: folds=20
Uncalled bet ($0.02) returned to Hirnibirni
Hirnibirni collected $0.05 from pot
Hirnibirni: doesn't show hand=20
*** SUMMARY ***
Total pot $0.05 | Rake $0=20
Seat 1: iliyan66 (button) folded before Flop (didn't bet)
Seat 2: the_wickstar (small blind) folded before Flop
Seat 3: sergey347 (big blind) folded before Flop
Seat 4: Hirnibirni collected ($0.05)
Seat 5: betao22 folded before Flop (didn't bet)
Seat 6: Aracidus folded before Flop (didn't bet)
Seat 7: ElSchmidtzel folded before Flop (didn't bet)
Seat 9: Radom94 folded before Flop (didn't bet)


*********** # 79 **************
PokerStars Hand #169406116664:  Hold'em No Limit ($0.01/$0.02 USD) - 20=
17/04/23 3:27:49 CUST [2017/04/22 13:27:49 ET]
Table 'Joella' 9-max Seat #1 is the button
Seat 1: betao22 ($1.77 in chips)=20
Seat 2: the_wickstar ($1.58 in chips)=20
Seat 3: oSkARiLLo85 ($0.75 in chips)=20
Seat 4: gogu575 ($1.22 in chips)=20
Seat 6: No1da ($2.53 in chips)=20
Seat 7: michispaw ($3.02 in chips)=20
Seat 8: Natsoviy711 ($2.24 in chips)=20
Seat 9: All IN-Fort ($1.54 in chips)=20
the_wickstar: posts small blind $0.01
oSkARiLLo85: posts big blind $0.02
*** HOLE CARDS ***
Dealt to the_wickstar [8d 4s]
gogu575: folds=20
No1da: folds=20
michispaw: folds=20
Natsoviy711: folds=20
All IN-Fort: folds=20
betao22: folds=20
the_wickstar: folds=20
Uncalled bet ($0.01) returned to oSkARiLLo85
oSkARiLLo85 collected $0.02 from pot
oSkARiLLo85: doesn't show hand=20
*** SUMMARY ***
Total pot $0.02 | Rake $0=20
Seat 1: betao22 (button) folded before Flop (didn't bet)
Seat 2: the_wickstar (small blind) folded before Flop
Seat 3: oSkARiLLo85 (big blind) collected ($0.02)
Seat 4: gogu575 folded before Flop (didn't bet)
Seat 6: No1da folded before Flop (didn't bet)
Seat 7: michispaw folded before Flop (didn't bet)
Seat 8: Natsoviy711 folded before Flop (didn't bet)
Seat 9: All IN-Fort folded before Flop (didn't bet)


*********** # 80 **************
PokerStars Hand #169406103421:  Hold'em No Limit ($0.01/$0.02 USD) - 20=
17/04/23 3:27:33 CUST [2017/04/22 13:27:33 ET]
Table 'Enif' 9-max Seat #9 is the button
Seat 1: iliyan66 ($1.79 in chips)=20
Seat 2: the_wickstar ($0.82 in chips)=20
Seat 3: sergey347 ($1.77 in chips)=20
Seat 4: Hirnibirni ($3.11 in chips)=20
Seat 5: betao22 ($1.62 in chips)=20
Seat 6: Aracidus ($1.33 in chips)=20
Seat 7: ElSchmidtzel ($1.92 in chips)=20
Seat 9: Radom94 ($0.41 in chips)=20
iliyan66: posts small blind $0.01
the_wickstar: posts big blind $0.02
*** HOLE CARDS ***
Dealt to the_wickstar [3d 5d]
sergey347: folds=20
Hirnibirni: folds=20
betao22: folds=20
Aracidus: folds=20
ElSchmidtzel: folds=20
Radom94: folds=20
iliyan66: folds=20
Uncalled bet ($0.01) returned to the_wickstar
the_wickstar collected $0.02 from pot
*** SUMMARY ***
Total pot $0.02 | Rake $0=20
Seat 1: iliyan66 (small blind) folded before Flop
Seat 2: the_wickstar (big blind) collected ($0.02)
Seat 3: sergey347 folded before Flop (didn't bet)
Seat 4: Hirnibirni folded before Flop (didn't bet)
Seat 5: betao22 folded before Flop (didn't bet)
Seat 6: Aracidus folded before Flop (didn't bet)
Seat 7: ElSchmidtzel folded before Flop (didn't bet)
Seat 9: Radom94 (button) folded before Flop (didn't bet)


*********** # 81 **************
PokerStars Hand #169406058435:  Hold'em No Limit ($0.01/$0.02 USD) - 20=
17/04/23 3:26:39 CUST [2017/04/22 13:26:39 ET]
Table 'Joella' 9-max Seat #9 is the button
Seat 1: betao22 ($1.79 in chips)=20
Seat 2: the_wickstar ($1.45 in chips)=20
Seat 3: oSkARiLLo85 ($0.83 in chips)=20
Seat 4: gogu575 ($1.24 in chips)=20
Seat 6: No1da ($2.53 in chips)=20
Seat 7: michispaw ($3.02 in chips)=20
Seat 8: Natsoviy711 ($2.26 in chips)=20
Seat 9: All IN-Fort ($1.54 in chips)=20
betao22: posts small blind $0.01
the_wickstar: posts big blind $0.02
*** HOLE CARDS ***
Dealt to the_wickstar [Ks Ad]
oSkARiLLo85: calls $0.02
gogu575: calls $0.02
No1da: folds=20
michispaw: folds=20
Natsoviy711: calls $0.02
All IN-Fort: folds=20
betao22: calls $0.01
the_wickstar: raises $0.06 to $0.08
oSkARiLLo85: calls $0.06
gogu575: folds=20
Natsoviy711: folds=20
betao22: folds=20
*** FLOP *** [Jh 9h Qc]
the_wickstar: checks=20
oSkARiLLo85: checks=20
*** TURN *** [Jh 9h Qc] [2s]
the_wickstar: checks=20
oSkARiLLo85: checks=20
*** RIVER *** [Jh 9h Qc 2s] [Js]
the_wickstar: bets $0.21
oSkARiLLo85: folds=20
Uncalled bet ($0.21) returned to the_wickstar
the_wickstar collected $0.21 from pot
*** SUMMARY ***
Total pot $0.22 | Rake $0.01=20
Board [Jh 9h Qc 2s Js]
Seat 1: betao22 (small blind) folded before Flop
Seat 2: the_wickstar (big blind) collected ($0.21)
Seat 3: oSkARiLLo85 folded on the River
Seat 4: gogu575 folded before Flop
Seat 6: No1da folded before Flop (didn't bet)
Seat 7: michispaw folded before Flop (didn't bet)
Seat 8: Natsoviy711 folded before Flop
Seat 9: All IN-Fort (button) folded before Flop (didn't bet)


*********** # 82 **************
PokerStars Hand #169406045362:  Hold'em No Limit ($0.01/$0.02 USD) - 20=
17/04/23 3:26:24 CUST [2017/04/22 13:26:24 ET]
Table 'Enif' 9-max Seat #7 is the button
Seat 1: iliyan66 ($1.81 in chips)=20
Seat 2: the_wickstar ($0.69 in chips)=20
Seat 3: sergey347 ($1.77 in chips)=20
Seat 4: Hirnibirni ($3.11 in chips)=20
Seat 5: betao22 ($1.62 in chips)=20
Seat 6: Aracidus ($1.33 in chips)=20
Seat 7: ElSchmidtzel ($1.98 in chips)=20
Seat 9: Radom94 ($0.47 in chips)=20
Radom94: posts small blind $0.01
iliyan66: posts big blind $0.02
*** HOLE CARDS ***
Dealt to the_wickstar [Ah Jc]
the_wickstar: raises $0.04 to $0.06
sergey347: folds=20
Hirnibirni: folds=20
betao22: folds=20
Aracidus: folds=20
ElSchmidtzel: calls $0.06
Radom94: calls $0.05
iliyan66: folds=20
*** FLOP *** [8d 2c Qc]
Radom94: checks=20
the_wickstar: checks=20
ElSchmidtzel: checks=20
*** TURN *** [8d 2c Qc] [Ts]
Radom94: checks=20
the_wickstar: bets $0.14
ElSchmidtzel: folds=20
Radom94: folds=20
Uncalled bet ($0.14) returned to the_wickstar
the_wickstar collected $0.19 from pot
*** SUMMARY ***
Total pot $0.20 | Rake $0.01=20
Board [8d 2c Qc Ts]
Seat 1: iliyan66 (big blind) folded before Flop
Seat 2: the_wickstar collected ($0.19)
Seat 3: sergey347 folded before Flop (didn't bet)
Seat 4: Hirnibirni folded before Flop (didn't bet)
Seat 5: betao22 folded before Flop (didn't bet)
Seat 6: Aracidus folded before Flop (didn't bet)
Seat 7: ElSchmidtzel (button) folded on the Turn
Seat 9: Radom94 (small blind) folded on the Turn


*********** # 83 **************
PokerStars Hand #169406018246:  Hold'em No Limit ($0.01/$0.02 USD) - 20=
17/04/23 3:25:51 CUST [2017/04/22 13:25:51 ET]
Table 'Joella' 9-max Seat #8 is the button
Seat 1: betao22 ($1.73 in chips)=20
Seat 2: the_wickstar ($1.45 in chips)=20
Seat 3: oSkARiLLo85 ($0.85 in chips)=20
Seat 4: gogu575 ($1.26 in chips)=20
Seat 6: No1da ($2.53 in chips)=20
Seat 7: michispaw ($3.02 in chips)=20
Seat 8: Natsoviy711 ($2.26 in chips)=20
Seat 9: All IN-Fort ($1.56 in chips)=20
All IN-Fort: posts small blind $0.01
betao22: posts big blind $0.02
*** HOLE CARDS ***
Dealt to the_wickstar [9c 4s]
the_wickstar: folds=20
oSkARiLLo85: calls $0.02
gogu575: calls $0.02
No1da: folds=20
michispaw: folds=20
Natsoviy711: folds=20
All IN-Fort: calls $0.01
betao22: checks=20
*** FLOP *** [Jd 2c Ah]
All IN-Fort: checks=20
betao22: bets $0.02
oSkARiLLo85: folds=20
gogu575: folds=20
All IN-Fort: folds=20
Uncalled bet ($0.02) returned to betao22
betao22 collected $0.08 from pot
betao22: doesn't show hand=20
*** SUMMARY ***
Total pot $0.08 | Rake $0=20
Board [Jd 2c Ah]
Seat 1: betao22 (big blind) collected ($0.08)
Seat 2: the_wickstar folded before Flop (didn't bet)
Seat 3: oSkARiLLo85 folded on the Flop
Seat 4: gogu575 folded on the Flop
Seat 6: No1da folded before Flop (didn't bet)
Seat 7: michispaw folded before Flop (didn't bet)
Seat 8: Natsoviy711 (button) folded before Flop (didn't bet)
Seat 9: All IN-Fort (small blind) folded on the Flop


*********** # 84 **************
PokerStars Hand #169405973725:  Hold'em No Limit ($0.01/$0.02 USD) - 20=
17/04/23 3:24:59 CUST [2017/04/22 13:24:59 ET]
Table 'Joella' 9-max Seat #7 is the button
Seat 1: betao22 ($1.73 in chips)=20
Seat 2: the_wickstar ($1.41 in chips)=20
Seat 3: oSkARiLLo85 ($0.85 in chips)=20
Seat 4: gogu575 ($1.26 in chips)=20
Seat 6: No1da ($2.53 in chips)=20
Seat 7: michispaw ($3.02 in chips)=20
Seat 8: Natsoviy711 ($2.28 in chips)=20
Seat 9: All IN-Fort ($1.58 in chips)=20
Natsoviy711: posts small blind $0.01
All IN-Fort: posts big blind $0.02
*** HOLE CARDS ***
Dealt to the_wickstar [Kc Qd]
betao22: folds=20
the_wickstar: calls $0.02
oSkARiLLo85: folds=20
gogu575: folds=20
No1da: folds=20
michispaw: folds=20
Natsoviy711: calls $0.01
All IN-Fort: checks=20
*** FLOP *** [4c Tc As]
Natsoviy711: checks=20
All IN-Fort: checks=20
the_wickstar: checks=20
*** TURN *** [4c Tc As] [6h]
Natsoviy711: checks=20
All IN-Fort: checks=20
the_wickstar: checks=20
*** RIVER *** [4c Tc As 6h] [9h]
Natsoviy711: checks=20
All IN-Fort: checks=20
the_wickstar: checks=20
*** SHOW DOWN ***
Natsoviy711: shows [5s Qs] (high card Ace)
All IN-Fort: mucks hand=20
the_wickstar: shows [Kc Qd] (high card Ace - King kicker)
the_wickstar collected $0.06 from pot
*** SUMMARY ***
Total pot $0.06 | Rake $0=20
Board [4c Tc As 6h 9h]
Seat 1: betao22 folded before Flop (didn't bet)
Seat 2: the_wickstar showed [Kc Qd] and won ($0.06) with high card Ace
Seat 3: oSkARiLLo85 folded before Flop (didn't bet)
Seat 4: gogu575 folded before Flop (didn't bet)
Seat 6: No1da folded before Flop (didn't bet)
Seat 7: michispaw (button) folded before Flop (didn't bet)
Seat 8: Natsoviy711 (small blind) showed [5s Qs] and lost with high car=
d Ace
Seat 9: All IN-Fort (big blind) mucked [2c 5d]


*********** # 85 **************
PokerStars Hand #169405951377:  Hold'em No Limit ($0.01/$0.02 USD) - 20=
17/04/23 3:24:32 CUST [2017/04/22 13:24:32 ET]
Table 'Enif' 9-max Seat #6 is the button
Seat 1: iliyan66 ($1.81 in chips)=20
Seat 2: the_wickstar ($0.87 in chips)=20
Seat 3: sergey347 ($1.77 in chips)=20
Seat 4: Hirnibirni ($3.11 in chips)=20
Seat 5: betao22 ($1.62 in chips)=20
Seat 6: Aracidus ($0.51 in chips)=20
Seat 7: ElSchmidtzel ($2.16 in chips)=20
Seat 9: Radom94 ($0.98 in chips)=20
ElSchmidtzel: posts small blind $0.01
Radom94: posts big blind $0.02
*** HOLE CARDS ***
Dealt to the_wickstar [Qh Qc]
iliyan66: folds=20
the_wickstar: raises $0.04 to $0.06
sergey347: folds=20
Hirnibirni: folds=20
betao22: folds=20
Aracidus: calls $0.06
ElSchmidtzel: calls $0.05
Radom94: calls $0.04
*** FLOP *** [Jd 6d Ah]
ElSchmidtzel: bets $0.12
Radom94: calls $0.12
the_wickstar: calls $0.12
Aracidus: calls $0.12
*** TURN *** [Jd 6d Ah] [Js]
ElSchmidtzel: checks=20
Radom94: bets $0.16
the_wickstar: folds=20
Aracidus: calls $0.16
ElSchmidtzel: folds=20
*** RIVER *** [Jd 6d Ah Js] [4d]
Radom94: bets $0.64 and is all-in
Aracidus: calls $0.17 and is all-in
Uncalled bet ($0.47) returned to Radom94
*** SHOW DOWN ***
Radom94: shows [9s Ac] (two pair, Aces and Jacks)
Aracidus: shows [Tc Ad] (two pair, Aces and Jacks - Ten kicker)
Aracidus collected $1.33 from pot
*** SUMMARY ***
Total pot $1.38 | Rake $0.05=20
Board [Jd 6d Ah Js 4d]
Seat 1: iliyan66 folded before Flop (didn't bet)
Seat 2: the_wickstar folded on the Turn
Seat 3: sergey347 folded before Flop (didn't bet)
Seat 4: Hirnibirni folded before Flop (didn't bet)
Seat 5: betao22 folded before Flop (didn't bet)
Seat 6: Aracidus (button) showed [Tc Ad] and won ($1.33) with two pair,=
 Aces and Jacks
Seat 7: ElSchmidtzel (small blind) folded on the Turn
Seat 9: Radom94 (big blind) showed [9s Ac] and lost with two pair, Aces=
 and Jacks


*********** # 86 **************
PokerStars Hand #169405937262:  Hold'em No Limit ($0.01/$0.02 USD) - 20=
17/04/23 3:24:16 CUST [2017/04/22 13:24:16 ET]
Table 'Joella' 9-max Seat #6 is the button
Seat 1: betao22 ($1.73 in chips)=20
Seat 2: the_wickstar ($1.41 in chips)=20
Seat 3: oSkARiLLo85 ($0.80 in chips)=20
Seat 4: gogu575 ($1.28 in chips)=20
Seat 6: No1da ($2.53 in chips)=20
Seat 7: michispaw ($3.03 in chips)=20
Seat 8: Natsoviy711 ($2.30 in chips)=20
Seat 9: All IN-Fort ($1.58 in chips)=20
michispaw: posts small blind $0.01
Natsoviy711: posts big blind $0.02
*** HOLE CARDS ***
Dealt to the_wickstar [6s Th]
All IN-Fort: folds=20
betao22: folds=20
the_wickstar: folds=20
oSkARiLLo85: calls $0.02
gogu575: calls $0.02
No1da: folds=20
michispaw: folds=20
Natsoviy711: checks=20
*** FLOP *** [6h 7d Ac]
Natsoviy711: checks=20
oSkARiLLo85: checks=20
gogu575: checks=20
*** TURN *** [6h 7d Ac] [Qd]
Natsoviy711: checks=20
oSkARiLLo85: bets $0.02
gogu575: folds=20
Natsoviy711: folds=20
Uncalled bet ($0.02) returned to oSkARiLLo85
oSkARiLLo85 collected $0.07 from pot
oSkARiLLo85: doesn't show hand=20
*** SUMMARY ***
Total pot $0.07 | Rake $0=20
Board [6h 7d Ac Qd]
Seat 1: betao22 folded before Flop (didn't bet)
Seat 2: the_wickstar folded before Flop (didn't bet)
Seat 3: oSkARiLLo85 collected ($0.07)
Seat 4: gogu575 folded on the Turn
Seat 6: No1da (button) folded before Flop (didn't bet)
Seat 7: michispaw (small blind) folded before Flop
Seat 8: Natsoviy711 (big blind) folded on the Turn
Seat 9: All IN-Fort folded before Flop (didn't bet)


*********** # 87 **************
PokerStars Hand #169405932104:  Hold'em No Limit ($0.01/$0.02 USD) - 20=
17/04/23 3:24:10 CUST [2017/04/22 13:24:10 ET]
Table 'Enif' 9-max Seat #5 is the button
Seat 1: iliyan66 ($1.81 in chips)=20
Seat 2: the_wickstar ($0.87 in chips)=20
Seat 3: sergey347 ($1.77 in chips)=20
Seat 4: Hirnibirni ($3.11 in chips)=20
Seat 5: betao22 ($1.62 in chips)=20
Seat 6: Aracidus ($0.52 in chips)=20
Seat 7: ElSchmidtzel ($2.15 in chips)=20
Seat 9: Radom94 ($0.98 in chips)=20
Aracidus: posts small blind $0.01
ElSchmidtzel: posts big blind $0.02
*** HOLE CARDS ***
Dealt to the_wickstar [4d 6s]
Radom94: folds=20
iliyan66: folds=20
the_wickstar: folds=20
sergey347: folds=20
Hirnibirni: folds=20
betao22: folds=20
Aracidus: folds=20
Uncalled bet ($0.01) returned to ElSchmidtzel
ElSchmidtzel collected $0.02 from pot
ElSchmidtzel: doesn't show hand=20
*** SUMMARY ***
Total pot $0.02 | Rake $0=20
Seat 1: iliyan66 folded before Flop (didn't bet)
Seat 2: the_wickstar folded before Flop (didn't bet)
Seat 3: sergey347 folded before Flop (didn't bet)
Seat 4: Hirnibirni folded before Flop (didn't bet)
Seat 5: betao22 (button) folded before Flop (didn't bet)
Seat 6: Aracidus (small blind) folded before Flop
Seat 7: ElSchmidtzel (big blind) collected ($0.02)
Seat 9: Radom94 folded before Flop (didn't bet)


*********** # 88 **************
PokerStars Hand #169405871455:  Hold'em No Limit ($0.01/$0.02 USD) - 20=
17/04/23 3:22:59 CUST [2017/04/22 13:22:59 ET]
Table 'Enif' 9-max Seat #4 is the button
Seat 1: iliyan66 ($1.81 in chips)=20
Seat 2: the_wickstar ($1.03 in chips)=20
Seat 3: sergey347 ($1.77 in chips)=20
Seat 4: Hirnibirni ($3.11 in chips)=20
Seat 5: betao22 ($1.63 in chips)=20
Seat 6: Aracidus ($0.54 in chips)=20
Seat 7: ElSchmidtzel ($1.97 in chips)=20
Seat 8: Tom13333 ($2.14 in chips)=20
Seat 9: Radom94 ($0.98 in chips)=20
betao22: posts small blind $0.01
Aracidus: posts big blind $0.02
*** HOLE CARDS ***
Dealt to the_wickstar [2d As]
ElSchmidtzel: raises $0.04 to $0.06
Tom13333: folds=20
Radom94: folds=20
iliyan66: folds=20
the_wickstar: calls $0.06
sergey347: folds=20
Hirnibirni: folds=20
betao22: folds=20
Aracidus: folds=20
*** FLOP *** [6c 4c Qh]
ElSchmidtzel: checks=20
the_wickstar: bets $0.10
ElSchmidtzel: calls $0.10
*** TURN *** [6c 4c Qh] [7d]
ElSchmidtzel: bets $0.22
the_wickstar: folds=20
Uncalled bet ($0.22) returned to ElSchmidtzel
ElSchmidtzel collected $0.34 from pot
ElSchmidtzel: doesn't show hand=20
*** SUMMARY ***
Total pot $0.35 | Rake $0.01=20
Board [6c 4c Qh 7d]
Seat 1: iliyan66 folded before Flop (didn't bet)
Seat 2: the_wickstar folded on the Turn
Seat 3: sergey347 folded before Flop (didn't bet)
Seat 4: Hirnibirni (button) folded before Flop (didn't bet)
Seat 5: betao22 (small blind) folded before Flop
Seat 6: Aracidus (big blind) folded before Flop
Seat 7: ElSchmidtzel collected ($0.34)
Seat 8: Tom13333 folded before Flop (didn't bet)
Seat 9: Radom94 folded before Flop (didn't bet)


*********** # 89 **************
PokerStars Hand #169405868820:  Hold'em No Limit ($0.01/$0.02 USD) - 20=
17/04/23 3:22:56 CUST [2017/04/22 13:22:56 ET]
Table 'Joella' 9-max Seat #4 is the button
Seat 1: betao22 ($1.73 in chips)=20
Seat 2: the_wickstar ($1.41 in chips)=20
Seat 3: oSkARiLLo85 ($1.72 in chips)=20
Seat 4: gogu575 ($1.36 in chips)=20
Seat 6: No1da ($2.67 in chips)=20
Seat 7: michispaw ($1.94 in chips)=20
Seat 8: Natsoviy711 ($2.30 in chips)=20
Seat 9: All IN-Fort ($1.60 in chips)=20
No1da: posts small blind $0.01
michispaw: posts big blind $0.02
All IN-Fort: posts big blind $0.02
*** HOLE CARDS ***
Dealt to the_wickstar [6s 2s]
Natsoviy711: folds=20
All IN-Fort: checks=20
betao22: folds=20
the_wickstar: folds=20
oSkARiLLo85: calls $0.02
gogu575: calls $0.02
No1da: calls $0.01
michispaw: raises $0.06 to $0.08
All IN-Fort: folds=20
oSkARiLLo85: calls $0.06
gogu575: calls $0.06
No1da: calls $0.06
*** FLOP *** [As Kd 3h]
No1da: checks=20
michispaw: bets $0.06
oSkARiLLo85: calls $0.06
gogu575: folds=20
No1da: calls $0.06
*** TURN *** [As Kd 3h] [8s]
No1da: checks=20
michispaw: bets $0.20
oSkARiLLo85: calls $0.20
No1da: folds=20
*** RIVER *** [As Kd 3h 8s] [2h]
michispaw: bets $0.58
oSkARiLLo85: calls $0.58
*** SHOW DOWN ***
michispaw: shows [Ad Ah] (three of a kind, Aces)
oSkARiLLo85: mucks hand=20
michispaw collected $2.01 from pot
*** SUMMARY ***
Total pot $2.08 | Rake $0.07=20
Board [As Kd 3h 8s 2h]
Seat 1: betao22 folded before Flop (didn't bet)
Seat 2: the_wickstar folded before Flop (didn't bet)
Seat 3: oSkARiLLo85 mucked [Th Ks]
Seat 4: gogu575 (button) folded on the Flop
Seat 6: No1da (small blind) folded on the Turn
Seat 7: michispaw (big blind) showed [Ad Ah] and won ($2.01) with three=
 of a kind, Aces
Seat 8: Natsoviy711 folded before Flop (didn't bet)
Seat 9: All IN-Fort folded before Flop


*********** # 90 **************
PokerStars Hand #169405825291:  Hold'em No Limit ($0.01/$0.02 USD) - 20=
17/04/23 3:22:04 CUST [2017/04/22 13:22:04 ET]
Table 'Joella' 9-max Seat #3 is the button
Seat 1: betao22 ($1.75 in chips)=20
Seat 2: the_wickstar ($1.33 in chips)=20
Seat 3: oSkARiLLo85 ($1.74 in chips)=20
Seat 4: gogu575 ($1.38 in chips)=20
Seat 6: No1da ($2.69 in chips)=20
Seat 7: michispaw ($1.94 in chips)=20
Seat 8: Natsoviy711 ($2.30 in chips)=20
gogu575: posts small blind $0.01
No1da: posts big blind $0.02
*** HOLE CARDS ***
Dealt to the_wickstar [9c Kh]
michispaw: folds=20
Natsoviy711: folds=20
All IN-Fort joins the table at seat #9=20
betao22: calls $0.02
the_wickstar: calls $0.02
oSkARiLLo85: calls $0.02
gogu575: calls $0.01
No1da: checks=20
*** FLOP *** [2d Kc 9h]
gogu575: checks=20
No1da: checks=20
betao22: checks=20
the_wickstar: bets $0.10
oSkARiLLo85: folds=20
gogu575: folds=20
No1da: folds=20
betao22: folds=20
Uncalled bet ($0.10) returned to the_wickstar
the_wickstar collected $0.10 from pot
*** SUMMARY ***
Total pot $0.10 | Rake $0=20
Board [2d Kc 9h]
Seat 1: betao22 folded on the Flop
Seat 2: the_wickstar collected ($0.10)
Seat 3: oSkARiLLo85 (button) folded on the Flop
Seat 4: gogu575 (small blind) folded on the Flop
Seat 6: No1da (big blind) folded on the Flop
Seat 7: michispaw folded before Flop (didn't bet)
Seat 8: Natsoviy711 folded before Flop (didn't bet)


*********** # 91 **************
PokerStars Hand #169405820784:  Hold'em No Limit ($0.01/$0.02 USD) - 20=
17/04/23 3:21:59 CUST [2017/04/22 13:21:59 ET]
Table 'Enif' 9-max Seat #3 is the button
Seat 1: iliyan66 ($1.81 in chips)=20
Seat 2: the_wickstar ($1.03 in chips)=20
Seat 3: sergey347 ($1.77 in chips)=20
Seat 4: Hirnibirni ($3.15 in chips)=20
Seat 5: betao22 ($1.65 in chips)=20
Seat 6: Aracidus ($0.54 in chips)=20
Seat 7: ElSchmidtzel ($1.97 in chips)=20
Seat 8: Tom13333 ($2.14 in chips)=20
Seat 9: Radom94 ($0.92 in chips)=20
Hirnibirni: posts small blind $0.01
betao22: posts big blind $0.02
*** HOLE CARDS ***
Dealt to the_wickstar [4c 3d]
Aracidus: folds=20
ElSchmidtzel: folds=20
Tom13333: folds=20
Radom94: raises $0.02 to $0.04
iliyan66: folds=20
the_wickstar: folds=20
sergey347: folds=20
Hirnibirni: calls $0.03
betao22: folds=20
*** FLOP *** [3s 3c 5d]
Hirnibirni: checks=20
Radom94: checks=20
*** TURN *** [3s 3c 5d] [Tc]
Hirnibirni: checks=20
Radom94: bets $0.06
Hirnibirni: folds=20
Uncalled bet ($0.06) returned to Radom94
Radom94 collected $0.10 from pot
Radom94: doesn't show hand=20
*** SUMMARY ***
Total pot $0.10 | Rake $0=20
Board [3s 3c 5d Tc]
Seat 1: iliyan66 folded before Flop (didn't bet)
Seat 2: the_wickstar folded before Flop (didn't bet)
Seat 3: sergey347 (button) folded before Flop (didn't bet)
Seat 4: Hirnibirni (small blind) folded on the Turn
Seat 5: betao22 (big blind) folded before Flop
Seat 6: Aracidus folded before Flop (didn't bet)
Seat 7: ElSchmidtzel folded before Flop (didn't bet)
Seat 8: Tom13333 folded before Flop (didn't bet)
Seat 9: Radom94 collected ($0.10)


*********** # 92 **************
PokerStars Hand #169405754441:  Hold'em No Limit ($0.01/$0.02 USD) - 20=
17/04/23 3:20:41 CUST [2017/04/22 13:20:41 ET]
Table 'Joella' 9-max Seat #2 is the button
Seat 1: betao22 ($1.77 in chips)=20
Seat 2: the_wickstar ($1.33 in chips)=20
Seat 3: oSkARiLLo85 ($1.25 in chips)=20
Seat 4: gogu575 ($1.56 in chips)=20
Seat 6: No1da ($2.69 in chips)=20
Seat 7: michispaw ($1.94 in chips)=20
Seat 8: Natsoviy711 ($2.62 in chips)=20
Seat 9: HokageVIP ($2 in chips)=20
oSkARiLLo85: posts small blind $0.01
gogu575: posts big blind $0.02
*** HOLE CARDS ***
Dealt to the_wickstar [4c 9c]
No1da: folds=20
michispaw: folds=20
Natsoviy711: calls $0.02
HokageVIP: folds=20
HokageVIP leaves the table
betao22: calls $0.02
the_wickstar: folds=20
oSkARiLLo85: calls $0.01
gogu575: checks=20
*** FLOP *** [7h 8c 8h]
oSkARiLLo85: bets $0.04
gogu575: calls $0.04
Natsoviy711: calls $0.04
betao22: folds=20
*** TURN *** [7h 8c 8h] [Ac]
oSkARiLLo85: bets $0.06
gogu575: calls $0.06
Natsoviy711: raises $0.06 to $0.12
oSkARiLLo85: calls $0.06
gogu575: calls $0.06
*** RIVER *** [7h 8c 8h Ac] [2d]
oSkARiLLo85: bets $0.14
gogu575: folds=20
Natsoviy711: calls $0.14
*** SHOW DOWN ***
oSkARiLLo85: shows [4s 8s] (three of a kind, Eights)
Natsoviy711: mucks hand=20
oSkARiLLo85 collected $0.81 from pot
*** SUMMARY ***
Total pot $0.84 | Rake $0.03=20
Board [7h 8c 8h Ac 2d]
Seat 1: betao22 folded on the Flop
Seat 2: the_wickstar (button) folded before Flop (didn't bet)
Seat 3: oSkARiLLo85 (small blind) showed [4s 8s] and won ($0.81) with t=
hree of a kind, Eights
Seat 4: gogu575 (big blind) folded on the River
Seat 6: No1da folded before Flop (didn't bet)
Seat 7: michispaw folded before Flop (didn't bet)
Seat 8: Natsoviy711 mucked [Ah Js]
Seat 9: HokageVIP folded before Flop (didn't bet)


*********** # 93 **************
PokerStars Hand #169405751861:  Hold'em No Limit ($0.01/$0.02 USD) - 20=
17/04/23 3:20:38 CUST [2017/04/22 13:20:38 ET]
Table 'Enif' 9-max Seat #2 is the button
Seat 1: iliyan66 ($1.97 in chips)=20
Seat 2: the_wickstar ($1.03 in chips)=20
Seat 3: sergey347 ($1.78 in chips)=20
Seat 4: Hirnibirni ($3.17 in chips)=20
Seat 5: betao22 ($1.65 in chips)=20
Seat 6: Aracidus ($0.54 in chips)=20
Seat 7: ElSchmidtzel ($1.97 in chips)=20
Seat 8: Tom13333 ($2.14 in chips)=20
Seat 9: Radom94 ($0.74 in chips)=20
sergey347: posts small blind $0.01
Hirnibirni: posts big blind $0.02
*** HOLE CARDS ***
Dealt to the_wickstar [Ah 3c]
betao22: folds=20
Aracidus: folds=20
ElSchmidtzel: folds=20
Tom13333: folds=20
Radom94: calls $0.02
iliyan66: raises $0.06 to $0.08
the_wickstar: folds=20
sergey347: folds=20
Hirnibirni: folds=20
Radom94: calls $0.06
*** FLOP *** [5h 8s 7d]
Radom94: bets $0.08
iliyan66: calls $0.08
*** TURN *** [5h 8s 7d] [Ts]
Radom94: checks=20
iliyan66: checks=20
*** RIVER *** [5h 8s 7d Ts] [Kd]
Radom94: bets $0.12
iliyan66: folds=20
Uncalled bet ($0.12) returned to Radom94
Radom94 collected $0.34 from pot
Radom94: doesn't show hand=20
*** SUMMARY ***
Total pot $0.35 | Rake $0.01=20
Board [5h 8s 7d Ts Kd]
Seat 1: iliyan66 folded on the River
Seat 2: the_wickstar (button) folded before Flop (didn't bet)
Seat 3: sergey347 (small blind) folded before Flop
Seat 4: Hirnibirni (big blind) folded before Flop
Seat 5: betao22 folded before Flop (didn't bet)
Seat 6: Aracidus folded before Flop (didn't bet)
Seat 7: ElSchmidtzel folded before Flop (didn't bet)
Seat 8: Tom13333 folded before Flop (didn't bet)
Seat 9: Radom94 collected ($0.34)


*********** # 94 **************
PokerStars Hand #169405723849:  Hold'em No Limit ($0.01/$0.02 USD) - 20=
17/04/23 3:20:06 CUST [2017/04/22 13:20:06 ET]
Table 'Enif' 9-max Seat #1 is the button
Seat 1: iliyan66 ($1.97 in chips)=20
Seat 2: the_wickstar ($1.04 in chips)=20
Seat 3: sergey347 ($1.77 in chips)=20
Seat 4: Hirnibirni ($3.17 in chips)=20
Seat 5: betao22 ($1.65 in chips)=20
Seat 6: Aracidus ($0.54 in chips)=20
Seat 7: ElSchmidtzel ($1.97 in chips)=20
Seat 8: Tom13333 ($2.14 in chips)=20
Seat 9: Radom94 ($0.74 in chips)=20
the_wickstar: posts small blind $0.01
sergey347: posts big blind $0.02
*** HOLE CARDS ***
Dealt to the_wickstar [Kh 5h]
Hirnibirni: folds=20
betao22: folds=20
Aracidus: folds=20
ElSchmidtzel: folds=20
Tom13333: folds=20
Radom94: folds=20
iliyan66: folds=20
the_wickstar: folds=20
Uncalled bet ($0.01) returned to sergey347
sergey347 collected $0.02 from pot
sergey347: doesn't show hand=20
*** SUMMARY ***
Total pot $0.02 | Rake $0=20
Seat 1: iliyan66 (button) folded before Flop (didn't bet)
Seat 2: the_wickstar (small blind) folded before Flop
Seat 3: sergey347 (big blind) collected ($0.02)
Seat 4: Hirnibirni folded before Flop (didn't bet)
Seat 5: betao22 folded before Flop (didn't bet)
Seat 6: Aracidus folded before Flop (didn't bet)
Seat 7: ElSchmidtzel folded before Flop (didn't bet)
Seat 8: Tom13333 folded before Flop (didn't bet)
Seat 9: Radom94 folded before Flop (didn't bet)


*********** # 95 **************
PokerStars Hand #169405693706:  Hold'em No Limit ($0.01/$0.02 USD) - 20=
17/04/23 3:19:31 CUST [2017/04/22 13:19:31 ET]
Table 'Enif' 9-max Seat #9 is the button
Seat 1: iliyan66 ($1.95 in chips)=20
Seat 2: the_wickstar ($1.06 in chips)=20
Seat 3: sergey347 ($1.77 in chips)=20
Seat 4: Hirnibirni ($3.17 in chips)=20
Seat 5: betao22 ($1.65 in chips)=20
Seat 6: Aracidus ($0.54 in chips)=20
Seat 7: ElSchmidtzel ($1.97 in chips)=20
Seat 8: Tom13333 ($2.14 in chips)=20
Seat 9: Radom94 ($0.74 in chips)=20
iliyan66: posts small blind $0.01
the_wickstar: posts big blind $0.02
*** HOLE CARDS ***
Dealt to the_wickstar [Js 8h]
sergey347: folds=20
Hirnibirni: folds=20
betao22: folds=20
Aracidus: folds=20
ElSchmidtzel: folds=20
Tom13333: folds=20
Radom94: folds=20
iliyan66: raises $0.04 to $0.06
the_wickstar: folds=20
Uncalled bet ($0.04) returned to iliyan66
iliyan66 collected $0.04 from pot
iliyan66: doesn't show hand=20
*** SUMMARY ***
Total pot $0.04 | Rake $0=20
Seat 1: iliyan66 (small blind) collected ($0.04)
Seat 2: the_wickstar (big blind) folded before Flop
Seat 3: sergey347 folded before Flop (didn't bet)
Seat 4: Hirnibirni folded before Flop (didn't bet)
Seat 5: betao22 folded before Flop (didn't bet)
Seat 6: Aracidus folded before Flop (didn't bet)
Seat 7: ElSchmidtzel folded before Flop (didn't bet)
Seat 8: Tom13333 folded before Flop (didn't bet)
Seat 9: Radom94 (button) folded before Flop (didn't bet)


*********** # 96 **************
PokerStars Hand #169405685747:  Hold'em No Limit ($0.01/$0.02 USD) - 20=
17/04/23 3:19:22 CUST [2017/04/22 13:19:22 ET]
Table 'Joella' 9-max Seat #1 is the button
Seat 1: betao22 ($1.77 in chips)=20
Seat 2: the_wickstar ($0.82 in chips)=20
Seat 3: oSkARiLLo85 ($1.76 in chips)=20
Seat 4: gogu575 ($1.56 in chips)=20
Seat 6: No1da ($2.69 in chips)=20
Seat 7: michispaw ($1.94 in chips)=20
Seat 8: Natsoviy711 ($2.62 in chips)=20
Seat 9: HokageVIP ($2 in chips)=20
the_wickstar: posts small blind $0.01
oSkARiLLo85: posts big blind $0.02
*** HOLE CARDS ***
Dealt to the_wickstar [3h Qh]
gogu575: folds=20
No1da: folds=20
michispaw: folds=20
Natsoviy711: folds=20
HokageVIP: calls $0.02
betao22: folds=20
the_wickstar: calls $0.01
oSkARiLLo85: checks=20
*** FLOP *** [3s 5s 7c]
the_wickstar: checks=20
oSkARiLLo85: bets $0.02
HokageVIP: calls $0.02
the_wickstar: calls $0.02
*** TURN *** [3s 5s 7c] [3d]
the_wickstar: bets $0.12
oSkARiLLo85: calls $0.12
HokageVIP: folds=20
*** RIVER *** [3s 5s 7c 3d] [8s]
the_wickstar: checks=20
oSkARiLLo85: bets $0.02
the_wickstar: raises $0.33 to $0.35
oSkARiLLo85: calls $0.33
*** SHOW DOWN ***
the_wickstar: shows [3h Qh] (three of a kind, Threes)
oSkARiLLo85: mucks hand=20
the_wickstar collected $1.02 from pot
*** SUMMARY ***
Total pot $1.06 | Rake $0.04=20
Board [3s 5s 7c 3d 8s]
Seat 1: betao22 (button) folded before Flop (didn't bet)
Seat 2: the_wickstar (small blind) showed [3h Qh] and won ($1.02) with =
three of a kind, Threes
Seat 3: oSkARiLLo85 (big blind) mucked [9h 7d]
Seat 4: gogu575 folded before Flop (didn't bet)
Seat 6: No1da folded before Flop (didn't bet)
Seat 7: michispaw folded before Flop (didn't bet)
Seat 8: Natsoviy711 folded before Flop (didn't bet)
Seat 9: HokageVIP folded on the Turn


*********** # 97 **************
PokerStars Hand #169405668397:  Hold'em No Limit ($0.01/$0.02 USD) - 20=
17/04/23 3:19:01 CUST [2017/04/22 13:19:01 ET]
Table 'Joella' 9-max Seat #9 is the button
Seat 1: betao22 ($1.78 in chips)=20
Seat 2: the_wickstar ($0.84 in chips)=20
Seat 3: oSkARiLLo85 ($1.73 in chips)=20
Seat 4: gogu575 ($1.56 in chips)=20
Seat 6: No1da ($2.69 in chips)=20
Seat 7: michispaw ($1.94 in chips)=20
Seat 8: Natsoviy711 ($2.62 in chips)=20
Seat 9: HokageVIP ($2 in chips)=20
betao22: posts small blind $0.01
the_wickstar: posts big blind $0.02
*** HOLE CARDS ***
Dealt to the_wickstar [5h 4s]
oSkARiLLo85: raises $0.02 to $0.04
gogu575: folds=20
No1da: folds=20
michispaw: folds=20
Natsoviy711: folds=20
HokageVIP: folds=20
betao22: folds=20
the_wickstar: folds=20
Uncalled bet ($0.02) returned to oSkARiLLo85
oSkARiLLo85 collected $0.05 from pot
oSkARiLLo85: doesn't show hand=20
*** SUMMARY ***
Total pot $0.05 | Rake $0=20
Seat 1: betao22 (small blind) folded before Flop
Seat 2: the_wickstar (big blind) folded before Flop
Seat 3: oSkARiLLo85 collected ($0.05)
Seat 4: gogu575 folded before Flop (didn't bet)
Seat 6: No1da folded before Flop (didn't bet)
Seat 7: michispaw folded before Flop (didn't bet)
Seat 8: Natsoviy711 folded before Flop (didn't bet)
Seat 9: HokageVIP (button) folded before Flop (didn't bet)


*********** # 98 **************
PokerStars Hand #169405666222:  Hold'em No Limit ($0.01/$0.02 USD) - 20=
17/04/23 3:18:59 CUST [2017/04/22 13:18:59 ET]
Table 'Enif' 9-max Seat #8 is the button
Seat 1: iliyan66 ($1.97 in chips)=20
Seat 2: the_wickstar ($1.06 in chips)=20
Seat 3: sergey347 ($1.77 in chips)=20
Seat 4: Hirnibirni ($3.17 in chips)=20
Seat 5: betao22 ($1.65 in chips)=20
Seat 6: Aracidus ($0.54 in chips)=20
Seat 7: ElSchmidtzel ($1.94 in chips)=20
Seat 8: Tom13333 ($2.14 in chips)=20
Seat 9: Radom94 ($0.75 in chips)=20
Radom94: posts small blind $0.01
iliyan66: posts big blind $0.02
*** HOLE CARDS ***
Dealt to the_wickstar [7h Qh]
the_wickstar: folds=20
sergey347: folds=20
Hirnibirni: folds=20
betao22: folds=20
Aracidus: folds=20
ElSchmidtzel: raises $0.04 to $0.06
Tom13333: folds=20
Radom94: folds=20
iliyan66: folds=20
Uncalled bet ($0.04) returned to ElSchmidtzel
ElSchmidtzel collected $0.05 from pot
ElSchmidtzel: doesn't show hand=20
*** SUMMARY ***
Total pot $0.05 | Rake $0=20
Seat 1: iliyan66 (big blind) folded before Flop
Seat 2: the_wickstar folded before Flop (didn't bet)
Seat 3: sergey347 folded before Flop (didn't bet)
Seat 4: Hirnibirni folded before Flop (didn't bet)
Seat 5: betao22 folded before Flop (didn't bet)
Seat 6: Aracidus folded before Flop (didn't bet)
Seat 7: ElSchmidtzel collected ($0.05)
Seat 8: Tom13333 (button) folded before Flop (didn't bet)
Seat 9: Radom94 (small blind) folded before Flop


*********** # 99 **************
PokerStars Hand #169405631283:  Hold'em No Limit ($0.01/$0.02 USD) - 20=
17/04/23 3:18:18 CUST [2017/04/22 13:18:18 ET]
Table 'Enif' 9-max Seat #7 is the button
Seat 1: iliyan66 ($1.97 in chips)=20
Seat 2: the_wickstar ($1.06 in chips)=20
Seat 3: sergey347 ($1.74 in chips)=20
Seat 4: Hirnibirni ($3.17 in chips)=20
Seat 5: betao22 ($1.65 in chips)=20
Seat 6: Aracidus ($0.54 in chips)=20
Seat 7: ElSchmidtzel ($1.94 in chips)=20
Seat 8: Tom13333 ($2.15 in chips)=20
Seat 9: Radom94 ($0.77 in chips)=20
Tom13333: posts small blind $0.01
Radom94: posts big blind $0.02
*** HOLE CARDS ***
Dealt to the_wickstar [Jc 2d]
iliyan66: folds=20
the_wickstar: folds=20
sergey347: raises $0.10 to $0.12
Hirnibirni: folds=20
betao22: folds=20
Aracidus: folds=20
ElSchmidtzel: folds=20
Tom13333: folds=20
Radom94: folds=20
Uncalled bet ($0.10) returned to sergey347
sergey347 collected $0.05 from pot
sergey347: doesn't show hand=20
*** SUMMARY ***
Total pot $0.05 | Rake $0=20
Seat 1: iliyan66 folded before Flop (didn't bet)
Seat 2: the_wickstar folded before Flop (didn't bet)
Seat 3: sergey347 collected ($0.05)
Seat 4: Hirnibirni folded before Flop (didn't bet)
Seat 5: betao22 folded before Flop (didn't bet)
Seat 6: Aracidus folded before Flop (didn't bet)
Seat 7: ElSchmidtzel (button) folded before Flop (didn't bet)
Seat 8: Tom13333 (small blind) folded before Flop
Seat 9: Radom94 (big blind) folded before Flop


*********** # 100 **************
PokerStars Hand #169405626790:  Hold'em No Limit ($0.01/$0.02 USD) - 20=
17/04/23 3:18:13 CUST [2017/04/22 13:18:13 ET]
Table 'Joella' 9-max Seat #8 is the button
Seat 1: betao22 ($1.80 in chips)=20
Seat 2: the_wickstar ($0.76 in chips)=20
Seat 3: oSkARiLLo85 ($1.79 in chips)=20
Seat 4: gogu575 ($1.56 in chips)=20
Seat 6: No1da ($2.69 in chips)=20
Seat 7: michispaw ($1.94 in chips)=20
Seat 8: Natsoviy711 ($2.62 in chips)=20
Seat 9: HokageVIP ($2 in chips)=20
HokageVIP: posts small blind $0.01
betao22: posts big blind $0.02
*** HOLE CARDS ***
Dealt to the_wickstar [Js Ah]
the_wickstar: raises $0.04 to $0.06
oSkARiLLo85: calls $0.06
gogu575: folds=20
No1da: folds=20
michispaw: folds=20
Natsoviy711: folds=20
HokageVIP: folds=20
betao22: folds=20
*** FLOP *** [7s 7d Kc]
the_wickstar: checks=20
oSkARiLLo85: checks=20
*** TURN *** [7s 7d Kc] [Th]
the_wickstar: checks=20
oSkARiLLo85: checks=20
*** RIVER *** [7s 7d Kc Th] [3s]
the_wickstar: checks=20
oSkARiLLo85: checks=20
*** SHOW DOWN ***
the_wickstar: shows [Js Ah] (a pair of Sevens)
oSkARiLLo85: mucks hand=20
the_wickstar collected $0.14 from pot
*** SUMMARY ***
Total pot $0.15 | Rake $0.01=20
Board [7s 7d Kc Th 3s]
Seat 1: betao22 (big blind) folded before Flop
Seat 2: the_wickstar showed [Js Ah] and won ($0.14) with a pair of Seve=
ns
Seat 3: oSkARiLLo85 mucked [9c 8d]
Seat 4: gogu575 folded before Flop (didn't bet)
Seat 6: No1da folded before Flop (didn't bet)
Seat 7: michispaw folded before Flop (didn't bet)
Seat 8: Natsoviy711 (button) folded before Flop (didn't bet)
Seat 9: HokageVIP (small blind) folded before Flop


*********** # 101 **************
PokerStars Hand #169405610226:  Hold'em No Limit ($0.01/$0.02 USD) - 20=
17/04/23 3:17:53 CUST [2017/04/22 13:17:53 ET]
Table 'Joella' 9-max Seat #7 is the button
Seat 1: betao22 ($1.80 in chips)=20
Seat 2: the_wickstar ($0.76 in chips)=20
Seat 3: oSkARiLLo85 ($1.79 in chips)=20
Seat 4: gogu575 ($1.56 in chips)=20
Seat 6: No1da ($2.69 in chips)=20
Seat 7: michispaw ($1.91 in chips)=20
Seat 8: Natsoviy711 ($2.63 in chips)=20
Seat 9: HokageVIP ($2 in chips)=20
Natsoviy711: posts small blind $0.01
HokageVIP: posts big blind $0.02
*** HOLE CARDS ***
Dealt to the_wickstar [3c 4d]
betao22: folds=20
the_wickstar: folds=20
oSkARiLLo85: folds=20
gogu575: folds=20
No1da: folds=20
michispaw: raises $0.04 to $0.06
Natsoviy711: folds=20
HokageVIP: folds=20
Uncalled bet ($0.04) returned to michispaw
michispaw collected $0.05 from pot
michispaw: doesn't show hand=20
*** SUMMARY ***
Total pot $0.05 | Rake $0=20
Seat 1: betao22 folded before Flop (didn't bet)
Seat 2: the_wickstar folded before Flop (didn't bet)
Seat 3: oSkARiLLo85 folded before Flop (didn't bet)
Seat 4: gogu575 folded before Flop (didn't bet)
Seat 6: No1da folded before Flop (didn't bet)
Seat 7: michispaw (button) collected ($0.05)
Seat 8: Natsoviy711 (small blind) folded before Flop
Seat 9: HokageVIP (big blind) folded before Flop


*********** # 102 **************
PokerStars Hand #169405571367:  Hold'em No Limit ($0.01/$0.02 USD) - 20=
17/04/23 3:17:07 CUST [2017/04/22 13:17:07 ET]
Table 'Enif' 9-max Seat #6 is the button
Seat 1: iliyan66 ($1.97 in chips)=20
Seat 2: the_wickstar ($0.94 in chips)=20
Seat 3: sergey347 ($1.74 in chips)=20
Seat 4: Hirnibirni ($3.17 in chips)=20
Seat 5: betao22 ($1.65 in chips)=20
Seat 6: Aracidus ($0.54 in chips)=20
Seat 7: ElSchmidtzel ($1.95 in chips)=20
Seat 8: Tom13333 ($2.17 in chips)=20
Seat 9: Radom94 ($0.87 in chips)=20
ElSchmidtzel: posts small blind $0.01
Tom13333: posts big blind $0.02
*** HOLE CARDS ***
Dealt to the_wickstar [Js Jh]
Radom94: raises $0.04 to $0.06
iliyan66: folds=20
the_wickstar: raises $0.04 to $0.10
sergey347: folds=20
Hirnibirni: folds=20
betao22: folds=20
Aracidus: folds=20
ElSchmidtzel: folds=20
Tom13333: folds=20
Radom94: calls $0.04
*** FLOP *** [8h 3c Ts]
Radom94: checks=20
the_wickstar: bets $0.22
Radom94: folds=20
Uncalled bet ($0.22) returned to the_wickstar
the_wickstar collected $0.22 from pot
*** SUMMARY ***
Total pot $0.23 | Rake $0.01=20
Board [8h 3c Ts]
Seat 1: iliyan66 folded before Flop (didn't bet)
Seat 2: the_wickstar collected ($0.22)
Seat 3: sergey347 folded before Flop (didn't bet)
Seat 4: Hirnibirni folded before Flop (didn't bet)
Seat 5: betao22 folded before Flop (didn't bet)
Seat 6: Aracidus (button) folded before Flop (didn't bet)
Seat 7: ElSchmidtzel (small blind) folded before Flop
Seat 8: Tom13333 (big blind) folded before Flop
Seat 9: Radom94 folded on the Flop


*********** # 103 **************
PokerStars Hand #169405526177:  Hold'em No Limit ($0.01/$0.02 USD) - 20=
17/04/23 3:16:14 CUST [2017/04/22 13:16:14 ET]
Table 'Enif' 9-max Seat #5 is the button
Seat 1: iliyan66 ($1.97 in chips)=20
Seat 2: the_wickstar ($0.94 in chips)=20
Seat 3: sergey347 ($1.74 in chips)=20
Seat 4: Hirnibirni ($3.17 in chips)=20
Seat 5: betao22 ($1.65 in chips)=20
Seat 6: Aracidus ($0.72 in chips)=20
Seat 7: ElSchmidtzel ($1.97 in chips)=20
Seat 8: Tom13333 ($1.98 in chips)=20
Seat 9: Radom94 ($0.87 in chips)=20
Aracidus: posts small blind $0.01
ElSchmidtzel: posts big blind $0.02
*** HOLE CARDS ***
Dealt to the_wickstar [9s 4h]
Tom13333: calls $0.02
Radom94: folds=20
iliyan66: folds=20
the_wickstar: folds=20
sergey347: folds=20
Hirnibirni: folds=20
betao22: folds=20
Aracidus: raises $0.04 to $0.06
ElSchmidtzel: folds=20
Tom13333: calls $0.04
*** FLOP *** [Td Qd 7s]
Aracidus: checks=20
Tom13333: bets $0.12
Aracidus: calls $0.12
*** TURN *** [Td Qd 7s] [7h]
Aracidus: checks=20
Tom13333: checks=20
*** RIVER *** [Td Qd 7s 7h] [5s]
Aracidus: checks=20
Tom13333: checks=20
*** SHOW DOWN ***
Aracidus: shows [As Jd] (a pair of Sevens)
Tom13333: shows [6d 6s] (two pair, Sevens and Sixes)
Tom13333 collected $0.37 from pot
*** SUMMARY ***
Total pot $0.38 | Rake $0.01=20
Board [Td Qd 7s 7h 5s]
Seat 1: iliyan66 folded before Flop (didn't bet)
Seat 2: the_wickstar folded before Flop (didn't bet)
Seat 3: sergey347 folded before Flop (didn't bet)
Seat 4: Hirnibirni folded before Flop (didn't bet)
Seat 5: betao22 (button) folded before Flop (didn't bet)
Seat 6: Aracidus (small blind) showed [As Jd] and lost with a pair of S=
evens
Seat 7: ElSchmidtzel (big blind) folded before Flop
Seat 8: Tom13333 showed [6d 6s] and won ($0.37) with two pair, Sevens a=
nd Sixes
Seat 9: Radom94 folded before Flop (didn't bet)


*********** # 104 **************
PokerStars Hand #169405518787:  Hold'em No Limit ($0.01/$0.02 USD) - 20=
17/04/23 3:16:06 CUST [2017/04/22 13:16:06 ET]
Table 'Joella' 9-max Seat #6 is the button
Seat 1: betao22 ($1.80 in chips)=20
Seat 2: the_wickstar ($0.53 in chips)=20
Seat 3: oSkARiLLo85 ($2 in chips)=20
Seat 4: gogu575 ($1.56 in chips)=20
Seat 6: No1da ($2.69 in chips)=20
Seat 7: michispaw ($1.93 in chips)=20
Seat 8: Natsoviy711 ($2.65 in chips)=20
Seat 9: HokageVIP ($2 in chips)=20
michispaw: posts small blind $0.01
Natsoviy711: posts big blind $0.02
oSkARiLLo85: posts big blind $0.02
*** HOLE CARDS ***
Dealt to the_wickstar [Jh 8d]
HokageVIP: folds=20
betao22: folds=20
the_wickstar: calls $0.02
oSkARiLLo85: checks=20
gogu575: folds=20
No1da: folds=20
michispaw: calls $0.01
Natsoviy711: checks=20
*** FLOP *** [Th Qs 7c]
michispaw: checks=20
Natsoviy711: checks=20
the_wickstar: bets $0.07
oSkARiLLo85: calls $0.07
michispaw: folds=20
Natsoviy711: folds=20
*** TURN *** [Th Qs 7c] [9c]
the_wickstar: bets $0.12
oSkARiLLo85: calls $0.12
*** RIVER *** [Th Qs 7c 9c] [5h]
the_wickstar: bets $0.32 and is all-in
oSkARiLLo85: folds=20
Uncalled bet ($0.32) returned to the_wickstar
the_wickstar collected $0.44 from pot
*** SUMMARY ***
Total pot $0.46 | Rake $0.02=20
Board [Th Qs 7c 9c 5h]
Seat 1: betao22 folded before Flop (didn't bet)
Seat 2: the_wickstar collected ($0.44)
Seat 3: oSkARiLLo85 folded on the River
Seat 4: gogu575 folded before Flop (didn't bet)
Seat 6: No1da (button) folded before Flop (didn't bet)
Seat 7: michispaw (small blind) folded on the Flop
Seat 8: Natsoviy711 (big blind) folded on the Flop
Seat 9: HokageVIP folded before Flop (didn't bet)


*********** # 105 **************
PokerStars Hand #169405508455:  Hold'em No Limit ($0.01/$0.02 USD) - 20=
17/04/23 3:15:53 CUST [2017/04/22 13:15:53 ET]
Table 'Joella' 9-max Seat #4 is the button
Seat 1: betao22 ($1.80 in chips)=20
Seat 2: the_wickstar ($0.53 in chips)=20
Seat 4: gogu575 ($1.56 in chips)=20
Seat 6: No1da ($2.70 in chips)=20
Seat 7: michispaw ($1.92 in chips)=20
Seat 8: Natsoviy711 ($2.65 in chips)=20
Seat 9: HokageVIP ($2 in chips)=20
No1da: posts small blind $0.01
michispaw: posts big blind $0.02
oSkARiLLo85: sits out=20
*** HOLE CARDS ***
Dealt to the_wickstar [2h 7s]
Natsoviy711: folds=20
HokageVIP: folds=20
betao22: folds=20
the_wickstar: folds=20
gogu575: folds=20
No1da: folds=20
Uncalled bet ($0.01) returned to michispaw
michispaw collected $0.02 from pot
michispaw: doesn't show hand=20
*** SUMMARY ***
Total pot $0.02 | Rake $0=20
Seat 1: betao22 folded before Flop (didn't bet)
Seat 2: the_wickstar folded before Flop (didn't bet)
Seat 4: gogu575 (button) folded before Flop (didn't bet)
Seat 6: No1da (small blind) folded before Flop
Seat 7: michispaw (big blind) collected ($0.02)
Seat 8: Natsoviy711 folded before Flop (didn't bet)
Seat 9: HokageVIP folded before Flop (didn't bet)


*********** # 106 **************
PokerStars Hand #169405489573:  Hold'em No Limit ($0.01/$0.02 USD) - 20=
17/04/23 3:15:32 CUST [2017/04/22 13:15:32 ET]
Table 'Joella' 9-max Seat #2 is the button
Seat 1: betao22 ($1.80 in chips)=20
Seat 2: the_wickstar ($0.50 in chips)=20
Seat 4: gogu575 ($1.57 in chips)=20
Seat 6: No1da ($2.72 in chips)=20
Seat 7: michispaw ($1.92 in chips)=20
Seat 8: Natsoviy711 ($2.65 in chips)=20
Seat 9: HokageVIP ($2 in chips)=20
gogu575: posts small blind $0.01
No1da: posts big blind $0.02
*** HOLE CARDS ***
Dealt to the_wickstar [Kc Kh]
michispaw: folds=20
Natsoviy711: folds=20
HokageVIP: folds=20
betao22: folds=20
oSkARiLLo85 joins the table at seat #3=20
the_wickstar: raises $0.06 to $0.08
gogu575: folds=20
No1da: folds=20
Uncalled bet ($0.06) returned to the_wickstar
the_wickstar collected $0.05 from pot
*** SUMMARY ***
Total pot $0.05 | Rake $0=20
Seat 1: betao22 folded before Flop (didn't bet)
Seat 2: the_wickstar (button) collected ($0.05)
Seat 4: gogu575 (small blind) folded before Flop
Seat 6: No1da (big blind) folded before Flop
Seat 7: michispaw folded before Flop (didn't bet)
Seat 8: Natsoviy711 folded before Flop (didn't bet)
Seat 9: HokageVIP folded before Flop (didn't bet)


*********** # 107 **************
PokerStars Hand #169405476222:  Hold'em No Limit ($0.01/$0.02 USD) - 20=
17/04/23 3:15:16 CUST [2017/04/22 13:15:16 ET]
Table 'Joella' 9-max Seat #1 is the button
Seat 1: betao22 ($1.80 in chips)=20
Seat 2: the_wickstar ($0.51 in chips)=20
Seat 4: gogu575 ($1.56 in chips)=20
Seat 6: No1da ($2.72 in chips)=20
Seat 7: michispaw ($1.92 in chips)=20
Seat 8: Natsoviy711 ($2.65 in chips)=20
Seat 9: HokageVIP ($2 in chips)=20
the_wickstar: posts small blind $0.01
ciusen was removed from the table for failing to post
gogu575: posts big blind $0.02
*** HOLE CARDS ***
Dealt to the_wickstar [Ks 8h]
No1da: folds=20
michispaw: folds=20
Natsoviy711: folds=20
HokageVIP: folds=20
betao22: folds=20
the_wickstar: folds=20
Uncalled bet ($0.01) returned to gogu575
gogu575 collected $0.02 from pot
gogu575: doesn't show hand=20
*** SUMMARY ***
Total pot $0.02 | Rake $0=20
Seat 1: betao22 (button) folded before Flop (didn't bet)
Seat 2: the_wickstar (small blind) folded before Flop
Seat 4: gogu575 (big blind) collected ($0.02)
Seat 6: No1da folded before Flop (didn't bet)
Seat 7: michispaw folded before Flop (didn't bet)
Seat 8: Natsoviy711 folded before Flop (didn't bet)
Seat 9: HokageVIP folded before Flop (didn't bet)


*********** # 108 **************
PokerStars Hand #169405448413:  Hold'em No Limit ($0.01/$0.02 USD) - 20=
17/04/23 3:14:44 CUST [2017/04/22 13:14:44 ET]
Table 'Enif' 9-max Seat #4 is the button
Seat 1: iliyan66 ($1.97 in chips)=20
Seat 2: the_wickstar ($0.94 in chips)=20
Seat 3: sergey347 ($1.51 in chips)=20
Seat 4: Hirnibirni ($3.17 in chips)=20
Seat 5: betao22 ($1.66 in chips)=20
Seat 6: Aracidus ($0.96 in chips)=20
Seat 7: ElSchmidtzel ($1.97 in chips)=20
Seat 8: Tom13333 ($1.98 in chips)=20
Seat 9: Radom94 ($0.87 in chips)=20
betao22: posts small blind $0.01
Aracidus: posts big blind $0.02
*** HOLE CARDS ***
Dealt to the_wickstar [9s 7h]
ElSchmidtzel: folds=20
Tom13333: folds=20
Radom94: folds=20
iliyan66: folds=20
the_wickstar: folds=20
sergey347: raises $0.10 to $0.12
Hirnibirni: folds=20
betao22: folds=20
Aracidus: calls $0.10
*** FLOP *** [2d Td Qs]
Aracidus: checks=20
sergey347: checks=20
*** TURN *** [2d Td Qs] [Kh]
Aracidus: checks=20
sergey347: checks=20
*** RIVER *** [2d Td Qs Kh] [As]
Aracidus: checks=20
sergey347: bets $0.12
Aracidus: calls $0.12
*** SHOW DOWN ***
sergey347: shows [Jh Jd] (a straight, Ten to Ace)
Aracidus: mucks hand=20
sergey347 collected $0.47 from pot
*** SUMMARY ***
Total pot $0.49 | Rake $0.02=20
Board [2d Td Qs Kh As]
Seat 1: iliyan66 folded before Flop (didn't bet)
Seat 2: the_wickstar folded before Flop (didn't bet)
Seat 3: sergey347 showed [Jh Jd] and won ($0.47) with a straight, Ten t=
o Ace
Seat 4: Hirnibirni (button) folded before Flop (didn't bet)
Seat 5: betao22 (small blind) folded before Flop
Seat 6: Aracidus (big blind) mucked [9d Ad]
Seat 7: ElSchmidtzel folded before Flop (didn't bet)
Seat 8: Tom13333 folded before Flop (didn't bet)
Seat 9: Radom94 folded before Flop (didn't bet)


*********** # 109 **************
PokerStars Hand #169405443558:  Hold'em No Limit ($0.01/$0.02 USD) - 20=
17/04/23 3:14:38 CUST [2017/04/22 13:14:38 ET]
Table 'Joella' 9-max Seat #9 is the button
Seat 1: betao22 ($1.81 in chips)=20
Seat 2: the_wickstar ($0.46 in chips)=20
Seat 4: gogu575 ($1.60 in chips)=20
Seat 6: No1da ($2.72 in chips)=20
Seat 7: michispaw ($1.92 in chips)=20
Seat 8: Natsoviy711 ($2.65 in chips)=20
Seat 9: HokageVIP ($2 in chips)=20
betao22: posts small blind $0.01
the_wickstar: posts big blind $0.02
*** HOLE CARDS ***
Dealt to the_wickstar [3s Ks]
gogu575: calls $0.02
No1da: folds=20
michispaw: folds=20
Natsoviy711: folds=20
HokageVIP: folds=20
betao22: folds=20
the_wickstar: checks=20
*** FLOP *** [5h 2h Jd]
the_wickstar: checks=20
gogu575: checks=20
*** TURN *** [5h 2h Jd] [Kc]
the_wickstar: checks=20
gogu575: checks=20
*** RIVER *** [5h 2h Jd Kc] [9h]
the_wickstar: bets $0.02
gogu575: calls $0.02
*** SHOW DOWN ***
the_wickstar: shows [3s Ks] (a pair of Kings)
gogu575: mucks hand=20
the_wickstar collected $0.09 from pot
*** SUMMARY ***
Total pot $0.09 | Rake $0=20
Board [5h 2h Jd Kc 9h]
Seat 1: betao22 (small blind) folded before Flop
Seat 2: the_wickstar (big blind) showed [3s Ks] and won ($0.09) with a =
pair of Kings
Seat 4: gogu575 mucked [Ac Qh]
Seat 6: No1da folded before Flop (didn't bet)
Seat 7: michispaw folded before Flop (didn't bet)
Seat 8: Natsoviy711 folded before Flop (didn't bet)
Seat 9: HokageVIP (button) folded before Flop (didn't bet)


*********** # 110 **************
PokerStars Hand #169405414150:  Hold'em No Limit ($0.01/$0.02 USD) - 20=
17/04/23 3:14:04 CUST [2017/04/22 13:14:04 ET]
Table 'Joella' 9-max Seat #8 is the button
Seat 1: betao22 ($1.83 in chips)=20
Seat 2: the_wickstar ($0.46 in chips)=20
Seat 4: gogu575 ($1.60 in chips)=20
Seat 5: Chernovsky ($2 in chips)=20
Seat 6: No1da ($2.72 in chips)=20
Seat 7: michispaw ($1.92 in chips)=20
Seat 8: Natsoviy711 ($2.62 in chips)=20
Seat 9: HokageVIP ($2.01 in chips)=20
HokageVIP: posts small blind $0.01
betao22: posts big blind $0.02
*** HOLE CARDS ***
Dealt to the_wickstar [6c Jc]
the_wickstar: folds=20
gogu575: folds=20
Chernovsky: folds=20
No1da: folds=20
michispaw: folds=20
Natsoviy711: raises $0.04 to $0.06
HokageVIP: folds=20
betao22: folds=20
Uncalled bet ($0.04) returned to Natsoviy711
Natsoviy711 collected $0.05 from pot
*** SUMMARY ***
Total pot $0.05 | Rake $0=20
Seat 1: betao22 (big blind) folded before Flop
Seat 2: the_wickstar folded before Flop (didn't bet)
Seat 4: gogu575 folded before Flop (didn't bet)
Seat 5: Chernovsky folded before Flop (didn't bet)
Seat 6: No1da folded before Flop (didn't bet)
Seat 7: michispaw folded before Flop (didn't bet)
Seat 8: Natsoviy711 (button) collected ($0.05)
Seat 9: HokageVIP (small blind) folded before Flop


*********** # 111 **************
PokerStars Hand #169405404061:  Hold'em No Limit ($0.01/$0.02 USD) - 20=
17/04/23 3:13:52 CUST [2017/04/22 13:13:52 ET]
Table 'Enif' 9-max Seat #3 is the button
Seat 1: iliyan66 ($1.97 in chips)=20
Seat 2: the_wickstar ($0.90 in chips)=20
Seat 3: sergey347 ($1.51 in chips)=20
Seat 4: Hirnibirni ($3.19 in chips)=20
Seat 5: betao22 ($1.68 in chips)=20
Seat 6: Aracidus ($0.96 in chips)=20
Seat 7: ElSchmidtzel ($1.97 in chips)=20
Seat 8: Tom13333 ($1.98 in chips)=20
Seat 9: Radom94 ($0.87 in chips)=20
Hirnibirni: posts small blind $0.01
betao22: posts big blind $0.02
*** HOLE CARDS ***
Dealt to the_wickstar [9s 9h]
Aracidus: folds=20
ElSchmidtzel: folds=20
Tom13333: folds=20
Radom94: folds=20
iliyan66: folds=20
the_wickstar: calls $0.02
sergey347: folds=20
Hirnibirni: calls $0.01
betao22: checks=20
*** FLOP *** [2s 5s 9d]
Hirnibirni: checks=20
betao22: checks=20
the_wickstar: bets $0.04
Hirnibirni: folds=20
betao22: folds=20
Uncalled bet ($0.04) returned to the_wickstar
the_wickstar collected $0.06 from pot
*** SUMMARY ***
Total pot $0.06 | Rake $0=20
Board [2s 5s 9d]
Seat 1: iliyan66 folded before Flop (didn't bet)
Seat 2: the_wickstar collected ($0.06)
Seat 3: sergey347 (button) folded before Flop (didn't bet)
Seat 4: Hirnibirni (small blind) folded on the Flop
Seat 5: betao22 (big blind) folded on the Flop
Seat 6: Aracidus folded before Flop (didn't bet)
Seat 7: ElSchmidtzel folded before Flop (didn't bet)
Seat 8: Tom13333 folded before Flop (didn't bet)
Seat 9: Radom94 folded before Flop (didn't bet)


*********** # 112 **************
PokerStars Hand #169405381970:  Hold'em No Limit ($0.01/$0.02 USD) - 20=
17/04/23 3:13:26 CUST [2017/04/22 13:13:26 ET]
Table 'Joella' 9-max Seat #7 is the button
Seat 1: betao22 ($1.83 in chips)=20
Seat 2: the_wickstar ($0.46 in chips)=20
Seat 4: gogu575 ($1.60 in chips)=20
Seat 5: Chernovsky ($2 in chips)=20
Seat 6: No1da ($2.72 in chips)=20
Seat 7: michispaw ($1.92 in chips)=20
Seat 8: Natsoviy711 ($2.39 in chips)=20
Seat 9: HokageVIP ($2.03 in chips)=20
Natsoviy711: posts small blind $0.01
HokageVIP: posts big blind $0.02
*** HOLE CARDS ***
Dealt to the_wickstar [Jh 6s]
betao22: folds=20
the_wickstar: folds=20
gogu575: folds=20
Chernovsky: raises $0.03 to $0.05
No1da: folds=20
michispaw: folds=20
Natsoviy711: calls $0.04
HokageVIP: folds=20
*** FLOP *** [Ts 4h 9h]
Natsoviy711: bets $0.06
Chernovsky: calls $0.06
*** TURN *** [Ts 4h 9h] [Tc]
Natsoviy711: bets $0.12
Chernovsky: calls $0.12
*** RIVER *** [Ts 4h 9h Tc] [3s]
Natsoviy711: checks=20
Chernovsky: checks=20
*** SHOW DOWN ***
Natsoviy711: shows [9d As] (two pair, Tens and Nines)
Chernovsky: mucks hand=20
Natsoviy711 collected $0.46 from pot
*** SUMMARY ***
Total pot $0.48 | Rake $0.02=20
Board [Ts 4h 9h Tc 3s]
Seat 1: betao22 folded before Flop (didn't bet)
Seat 2: the_wickstar folded before Flop (didn't bet)
Seat 4: gogu575 folded before Flop (didn't bet)
Seat 5: Chernovsky mucked [8h 7c]
Seat 6: No1da folded before Flop (didn't bet)
Seat 7: michispaw (button) folded before Flop (didn't bet)
Seat 8: Natsoviy711 (small blind) showed [9d As] and won ($0.46) with t=
wo pair, Tens and Nines
Seat 9: HokageVIP (big blind) folded before Flop


*********** # 113 **************
PokerStars Hand #169405373213:  Hold'em No Limit ($0.01/$0.02 USD) - 20=
17/04/23 3:13:15 CUST [2017/04/22 13:13:15 ET]
Table 'Enif' 9-max Seat #2 is the button
Seat 1: iliyan66 ($1.97 in chips)=20
Seat 2: the_wickstar ($0.87 in chips)=20
Seat 3: sergey347 ($1.52 in chips)=20
Seat 4: Hirnibirni ($3.21 in chips)=20
Seat 5: betao22 ($1.68 in chips)=20
Seat 6: Aracidus ($0.96 in chips)=20
Seat 7: ElSchmidtzel ($1.97 in chips)=20
Seat 8: Tom13333 ($1.98 in chips)=20
Seat 9: Radom94 ($0.87 in chips)=20
sergey347: posts small blind $0.01
Hirnibirni: posts big blind $0.02
*** HOLE CARDS ***
Dealt to the_wickstar [Kc 8h]
betao22: folds=20
Aracidus: folds=20
ElSchmidtzel: folds=20
Tom13333: folds=20
Radom94: folds=20
iliyan66: folds=20
the_wickstar: raises $0.04 to $0.06
sergey347: folds=20
Hirnibirni: folds=20
Uncalled bet ($0.04) returned to the_wickstar
the_wickstar collected $0.05 from pot
*** SUMMARY ***
Total pot $0.05 | Rake $0=20
Seat 1: iliyan66 folded before Flop (didn't bet)
Seat 2: the_wickstar (button) collected ($0.05)
Seat 3: sergey347 (small blind) folded before Flop
Seat 4: Hirnibirni (big blind) folded before Flop
Seat 5: betao22 folded before Flop (didn't bet)
Seat 6: Aracidus folded before Flop (didn't bet)
Seat 7: ElSchmidtzel folded before Flop (didn't bet)
Seat 8: Tom13333 folded before Flop (didn't bet)
Seat 9: Radom94 folded before Flop (didn't bet)


*********** # 114 **************
PokerStars Hand #169405369393:  Hold'em No Limit ($0.01/$0.02 USD) - 20=
17/04/23 3:13:11 CUST [2017/04/22 13:13:11 ET]
Table 'Joella' 9-max Seat #6 is the button
Seat 1: betao22 ($1.83 in chips)=20
Seat 2: the_wickstar ($0.46 in chips)=20
Seat 4: gogu575 ($1.60 in chips)=20
Seat 5: Chernovsky ($2 in chips)=20
Seat 6: No1da ($2.72 in chips)=20
Seat 7: michispaw ($1.93 in chips)=20
Seat 8: Natsoviy711 ($2.38 in chips)=20
Seat 9: HokageVIP ($2.03 in chips)=20
michispaw: posts small blind $0.01
Natsoviy711: posts big blind $0.02
*** HOLE CARDS ***
Dealt to the_wickstar [9d 2d]
HokageVIP: folds=20
betao22: folds=20
the_wickstar: folds=20
gogu575: folds=20
Chernovsky: folds=20
No1da: folds=20
michispaw: folds=20
Uncalled bet ($0.01) returned to Natsoviy711
Natsoviy711 collected $0.02 from pot
*** SUMMARY ***
Total pot $0.02 | Rake $0=20
Seat 1: betao22 folded before Flop (didn't bet)
Seat 2: the_wickstar folded before Flop (didn't bet)
Seat 4: gogu575 folded before Flop (didn't bet)
Seat 5: Chernovsky folded before Flop (didn't bet)
Seat 6: No1da (button) folded before Flop (didn't bet)
Seat 7: michispaw (small blind) folded before Flop
Seat 8: Natsoviy711 (big blind) collected ($0.02)
Seat 9: HokageVIP folded before Flop (didn't bet)


*********** # 115 **************
PokerStars Hand #169405353851:  Hold'em No Limit ($0.01/$0.02 USD) - 20=
17/04/23 3:12:53 CUST [2017/04/22 13:12:53 ET]
Table 'Enif' 9-max Seat #1 is the button
Seat 1: iliyan66 ($1.97 in chips)=20
Seat 2: the_wickstar ($0.88 in chips)=20
Seat 3: sergey347 ($1.54 in chips)=20
Seat 4: Hirnibirni ($3.21 in chips)=20
Seat 5: betao22 ($1.68 in chips)=20
Seat 6: Aracidus ($0.96 in chips)=20
Seat 7: ElSchmidtzel ($1.97 in chips)=20
Seat 8: Tom13333 ($1.98 in chips)=20
Seat 9: Radom94 ($0.84 in chips)=20
the_wickstar: posts small blind $0.01
sergey347: posts big blind $0.02
*** HOLE CARDS ***
Dealt to the_wickstar [Ac 8c]
Hirnibirni: folds=20
betao22: folds=20
Aracidus: folds=20
ElSchmidtzel: folds=20
Tom13333: folds=20
Radom94: raises $0.04 to $0.06
iliyan66: folds=20
the_wickstar: folds=20
sergey347: folds=20
Uncalled bet ($0.04) returned to Radom94
Radom94 collected $0.05 from pot
Radom94: doesn't show hand=20
*** SUMMARY ***
Total pot $0.05 | Rake $0=20
Seat 1: iliyan66 (button) folded before Flop (didn't bet)
Seat 2: the_wickstar (small blind) folded before Flop
Seat 3: sergey347 (big blind) folded before Flop
Seat 4: Hirnibirni folded before Flop (didn't bet)
Seat 5: betao22 folded before Flop (didn't bet)
Seat 6: Aracidus folded before Flop (didn't bet)
Seat 7: ElSchmidtzel folded before Flop (didn't bet)
Seat 8: Tom13333 folded before Flop (didn't bet)
Seat 9: Radom94 collected ($0.05)


*********** # 116 **************
PokerStars Hand #169405352520:  Hold'em No Limit ($0.01/$0.02 USD) - 20=
17/04/23 3:12:51 CUST [2017/04/22 13:12:51 ET]
Table 'Joella' 9-max Seat #5 is the button
Seat 1: betao22 ($1.83 in chips)=20
Seat 2: the_wickstar ($0.46 in chips)=20
Seat 4: gogu575 ($1.60 in chips)=20
Seat 5: Chernovsky ($2 in chips)=20
Seat 6: No1da ($2.73 in chips)=20
Seat 7: michispaw ($1.95 in chips)=20
Seat 8: Natsoviy711 ($2.38 in chips)=20
Seat 9: HokageVIP ($2 in chips)=20
No1da: posts small blind $0.01
michispaw: posts big blind $0.02
*** HOLE CARDS ***
Dealt to the_wickstar [Th 4d]
Natsoviy711: folds=20
HokageVIP: raises $0.02 to $0.04
betao22: folds=20
the_wickstar: folds=20
gogu575: folds=20
Chernovsky: folds=20
No1da: folds=20
michispaw: folds=20
Uncalled bet ($0.02) returned to HokageVIP
HokageVIP collected $0.05 from pot
HokageVIP: doesn't show hand=20
*** SUMMARY ***
Total pot $0.05 | Rake $0=20
Seat 1: betao22 folded before Flop (didn't bet)
Seat 2: the_wickstar folded before Flop (didn't bet)
Seat 4: gogu575 folded before Flop (didn't bet)
Seat 5: Chernovsky (button) folded before Flop (didn't bet)
Seat 6: No1da (small blind) folded before Flop
Seat 7: michispaw (big blind) folded before Flop
Seat 8: Natsoviy711 folded before Flop (didn't bet)
Seat 9: HokageVIP collected ($0.05)


*********** # 117 **************
PokerStars Hand #169405327198:  Hold'em No Limit ($0.01/$0.02 USD) - 20=
17/04/23 3:12:22 CUST [2017/04/22 13:12:22 ET]
Table 'Joella' 9-max Seat #4 is the button
Seat 1: betao22 ($1.83 in chips)=20
Seat 2: the_wickstar ($0.46 in chips)=20
Seat 4: gogu575 ($1.57 in chips)=20
Seat 5: Chernovsky ($2 in chips)=20
Seat 6: No1da ($2.75 in chips)=20
Seat 7: michispaw ($1.95 in chips)=20
Seat 8: Natsoviy711 ($2.38 in chips)=20
Seat 9: HokageVIP ($2 in chips)=20
Chernovsky: posts small blind $0.01
No1da: posts big blind $0.02
*** HOLE CARDS ***
Dealt to the_wickstar [2s 9h]
michispaw: folds=20
Natsoviy711: folds=20
HokageVIP: folds=20
betao22: folds=20
the_wickstar: folds=20
gogu575: calls $0.02
Chernovsky: folds=20
No1da: checks=20
*** FLOP *** [Kd 4h 4d]
No1da: checks=20
gogu575: bets $0.02
No1da: folds=20
Uncalled bet ($0.02) returned to gogu575
gogu575 collected $0.05 from pot
gogu575: doesn't show hand=20
*** SUMMARY ***
Total pot $0.05 | Rake $0=20
Board [Kd 4h 4d]
Seat 1: betao22 folded before Flop (didn't bet)
Seat 2: the_wickstar folded before Flop (didn't bet)
Seat 4: gogu575 (button) collected ($0.05)
Seat 5: Chernovsky (small blind) folded before Flop
Seat 6: No1da (big blind) folded on the Flop
Seat 7: michispaw folded before Flop (didn't bet)
Seat 8: Natsoviy711 folded before Flop (didn't bet)
Seat 9: HokageVIP folded before Flop (didn't bet)


*********** # 118 **************
PokerStars Hand #169405295927:  Hold'em No Limit ($0.01/$0.02 USD) - 20=
17/04/23 3:11:46 CUST [2017/04/22 13:11:46 ET]
Table 'Joella' 9-max Seat #2 is the button
Seat 1: betao22 ($1.85 in chips)=20
Seat 2: the_wickstar ($0.39 in chips)=20
Seat 4: gogu575 ($1.58 in chips)=20
Seat 5: Chernovsky ($2 in chips)=20
Seat 6: No1da ($2.75 in chips)=20
Seat 7: michispaw ($1.95 in chips)=20
Seat 8: Natsoviy711 ($2.38 in chips)=20
Seat 9: HokageVIP ($2 in chips)=20
gogu575: posts small blind $0.01
Chernovsky: posts big blind $0.02
*** HOLE CARDS ***
Dealt to the_wickstar [Qs Kd]
No1da: folds=20
michispaw: folds=20
Natsoviy711: folds=20
HokageVIP: calls $0.02
betao22: calls $0.02
the_wickstar: raises $0.06 to $0.08
gogu575: folds=20
Chernovsky: folds=20
HokageVIP: folds=20
betao22: folds=20
Uncalled bet ($0.06) returned to the_wickstar
the_wickstar collected $0.09 from pot
*** SUMMARY ***
Total pot $0.09 | Rake $0=20
Seat 1: betao22 folded before Flop
Seat 2: the_wickstar (button) collected ($0.09)
Seat 4: gogu575 (small blind) folded before Flop
Seat 5: Chernovsky (big blind) folded before Flop
Seat 6: No1da folded before Flop (didn't bet)
Seat 7: michispaw folded before Flop (didn't bet)
Seat 8: Natsoviy711 folded before Flop (didn't bet)
Seat 9: HokageVIP folded before Flop


*********** # 119 **************
PokerStars Hand #169405277263:  Hold'em No Limit ($0.01/$0.02 USD) - 20=
17/04/23 3:11:24 CUST [2017/04/22 13:11:24 ET]
Table 'Enif' 9-max Seat #9 is the button
Seat 1: iliyan66 ($1.98 in chips)=20
Seat 2: the_wickstar ($0.96 in chips)=20
Seat 3: sergey347 ($1.54 in chips)=20
Seat 4: Hirnibirni ($3.21 in chips)=20
Seat 5: betao22 ($1.56 in chips)=20
Seat 6: Aracidus ($0.98 in chips)=20
Seat 7: ElSchmidtzel ($1.97 in chips)=20
Seat 8: Tom13333 ($2 in chips)=20
Seat 9: Radom94 ($0.84 in chips)=20
iliyan66: posts small blind $0.01
the_wickstar: posts big blind $0.02
*** HOLE CARDS ***
Dealt to the_wickstar [Ad 2c]
sergey347: folds=20
Hirnibirni: folds=20
betao22: calls $0.02
Aracidus: calls $0.02
ElSchmidtzel: folds=20
Tom13333: calls $0.02
Radom94: folds=20
iliyan66: folds=20
the_wickstar: checks=20
*** FLOP *** [3h 6s 4h]
the_wickstar: checks=20
betao22: bets $0.02
Aracidus: folds=20
Tom13333: folds=20
the_wickstar: calls $0.02
*** TURN *** [3h 6s 4h] [9d]
the_wickstar: checks=20
betao22: bets $0.04
the_wickstar: calls $0.04
*** RIVER *** [3h 6s 4h 9d] [9c]
the_wickstar: checks=20
betao22: checks=20
*** SHOW DOWN ***
the_wickstar: shows [Ad 2c] (a pair of Nines)
betao22: shows [8d 8c] (two pair, Nines and Eights)
betao22 collected $0.20 from pot
*** SUMMARY ***
Total pot $0.21 | Rake $0.01=20
Board [3h 6s 4h 9d 9c]
Seat 1: iliyan66 (small blind) folded before Flop
Seat 2: the_wickstar (big blind) showed [Ad 2c] and lost with a pair of=
 Nines
Seat 3: sergey347 folded before Flop (didn't bet)
Seat 4: Hirnibirni folded before Flop (didn't bet)
Seat 5: betao22 showed [8d 8c] and won ($0.20) with two pair, Nines and=
 Eights
Seat 6: Aracidus folded on the Flop
Seat 7: ElSchmidtzel folded before Flop (didn't bet)
Seat 8: Tom13333 folded on the Flop
Seat 9: Radom94 (button) folded before Flop (didn't bet)


*********** # 120 **************
PokerStars Hand #169405262960:  Hold'em No Limit ($0.01/$0.02 USD) - 20=
17/04/23 3:11:08 CUST [2017/04/22 13:11:08 ET]
Table 'Joella' 9-max Seat #1 is the button
Seat 1: betao22 ($1.85 in chips)=20
Seat 2: the_wickstar ($0.40 in chips)=20
Seat 4: gogu575 ($1.60 in chips)=20
Seat 6: No1da ($2.75 in chips)=20
Seat 7: michispaw ($1.95 in chips)=20
Seat 8: Natsoviy711 ($2.26 in chips)=20
Seat 9: HokageVIP ($2 in chips)=20
the_wickstar: posts small blind $0.01
gogu575: posts big blind $0.02
Chernovsky: sits out=20
*** HOLE CARDS ***
Dealt to the_wickstar [8c Jd]
No1da: folds=20
michispaw: folds=20
Natsoviy711: calls $0.02
HokageVIP: raises $0.08 to $0.10
betao22: folds=20
the_wickstar: folds=20
gogu575: folds=20
Natsoviy711: calls $0.08
*** FLOP *** [6c 3d 6s]
Natsoviy711: bets $0.11
HokageVIP: folds=20
Uncalled bet ($0.11) returned to Natsoviy711
Natsoviy711 collected $0.22 from pot
*** SUMMARY ***
Total pot $0.23 | Rake $0.01=20
Board [6c 3d 6s]
Seat 1: betao22 (button) folded before Flop (didn't bet)
Seat 2: the_wickstar (small blind) folded before Flop
Seat 4: gogu575 (big blind) folded before Flop
Seat 6: No1da folded before Flop (didn't bet)
Seat 7: michispaw folded before Flop (didn't bet)
Seat 8: Natsoviy711 collected ($0.22)
Seat 9: HokageVIP folded on the Flop


*********** # 121 **************
PokerStars Hand #169405217338:  Hold'em No Limit ($0.01/$0.02 USD) - 20=
17/04/23 3:10:14 CUST [2017/04/22 13:10:14 ET]
Table 'Enif' 9-max Seat #8 is the button
Seat 1: iliyan66 ($2 in chips)=20
Seat 2: the_wickstar ($0.96 in chips)=20
Seat 3: sergey347 ($1.54 in chips)=20
Seat 4: Hirnibirni ($3.27 in chips)=20
Seat 5: betao22 ($1.56 in chips)=20
Seat 6: Aracidus ($0.85 in chips)=20
Seat 7: ElSchmidtzel ($1.97 in chips)=20
Seat 8: Tom13333 ($2 in chips)=20
Seat 9: Radom94 ($0.90 in chips)=20
Radom94: posts small blind $0.01
iliyan66: posts big blind $0.02
*** HOLE CARDS ***
Dealt to the_wickstar [3d 7s]
the_wickstar: folds=20
sergey347: folds=20
Hirnibirni: calls $0.02
betao22: folds=20
Aracidus: calls $0.02
ElSchmidtzel: folds=20
Tom13333: folds=20
Radom94: raises $0.04 to $0.06
iliyan66: folds=20
Hirnibirni: calls $0.04
Aracidus: calls $0.04
*** FLOP *** [8c 6c 9c]
Radom94: checks=20
Hirnibirni: checks=20
Aracidus: checks=20
*** TURN *** [8c 6c 9c] [Qc]
Radom94: checks=20
Hirnibirni: checks=20
Aracidus: checks=20
*** RIVER *** [8c 6c 9c Qc] [4c]
Radom94: checks=20
Hirnibirni: checks=20
Aracidus: checks=20
*** SHOW DOWN ***
Radom94: shows [7d Ad] (a flush, Queen high)
Hirnibirni: shows [8s As] (a flush, Queen high)
Aracidus: shows [Tc Kd] (a flush, Queen high - Ten higher)
Aracidus collected $0.19 from pot
*** SUMMARY ***
Total pot $0.20 | Rake $0.01=20
Board [8c 6c 9c Qc 4c]
Seat 1: iliyan66 (big blind) folded before Flop
Seat 2: the_wickstar folded before Flop (didn't bet)
Seat 3: sergey347 folded before Flop (didn't bet)
Seat 4: Hirnibirni showed [8s As] and lost with a flush, Queen high
Seat 5: betao22 folded before Flop (didn't bet)
Seat 6: Aracidus showed [Tc Kd] and won ($0.19) with a flush, Queen high
Seat 7: ElSchmidtzel folded before Flop (didn't bet)
Seat 8: Tom13333 (button) folded before Flop (didn't bet)
Seat 9: Radom94 (small blind) showed [7d Ad] and lost with a flush, Que=
en high


*********** # 122 **************
PokerStars Hand #169405214903:  Hold'em No Limit ($0.01/$0.02 USD) - 20=
17/04/23 3:10:11 CUST [2017/04/22 13:10:11 ET]
Table 'Joella' 9-max Seat #9 is the button
Seat 1: betao22 ($1.86 in chips)=20
Seat 2: the_wickstar ($0.56 in chips)=20
Seat 4: gogu575 ($1.60 in chips)=20
Seat 6: No1da ($2.59 in chips)=20
Seat 7: michispaw ($1.95 in chips)=20
Seat 8: Natsoviy711 ($2.26 in chips)=20
Seat 9: HokageVIP ($2 in chips)=20
betao22: posts small blind $0.01
the_wickstar: posts big blind $0.02
Chernovsky: sits out=20
*** HOLE CARDS ***
Dealt to the_wickstar [5h 5d]
gogu575: folds=20
No1da: raises $0.04 to $0.06
michispaw: folds=20
Natsoviy711: folds=20
HokageVIP: folds=20
betao22: folds=20
the_wickstar: calls $0.04
*** FLOP *** [7c 8h 2s]
the_wickstar: checks=20
No1da: checks=20
*** TURN *** [7c 8h 2s] [Jh]
the_wickstar: bets $0.10
No1da: calls $0.10
*** RIVER *** [7c 8h 2s Jh] [Ks]
the_wickstar: checks=20
No1da: bets $0.32
the_wickstar: folds=20
Uncalled bet ($0.32) returned to No1da
No1da collected $0.32 from pot
No1da: doesn't show hand=20
*** SUMMARY ***
Total pot $0.33 | Rake $0.01=20
Board [7c 8h 2s Jh Ks]
Seat 1: betao22 (small blind) folded before Flop
Seat 2: the_wickstar (big blind) folded on the River
Seat 4: gogu575 folded before Flop (didn't bet)
Seat 6: No1da collected ($0.32)
Seat 7: michispaw folded before Flop (didn't bet)
Seat 8: Natsoviy711 folded before Flop (didn't bet)
Seat 9: HokageVIP (button) folded before Flop (didn't bet)


*********** # 123 **************
PokerStars Hand #169405191763:  Hold'em No Limit ($0.01/$0.02 USD) - 20=
17/04/23 3:09:44 CUST [2017/04/22 13:09:44 ET]
Table 'Joella' 9-max Seat #8 is the button
Seat 1: betao22 ($1.85 in chips)=20
Seat 2: the_wickstar ($0.56 in chips)=20
Seat 4: gogu575 ($1.60 in chips)=20
Seat 5: oxxay ($1.98 in chips)=20
Seat 6: No1da ($2.59 in chips)=20
Seat 7: michispaw ($1.95 in chips)=20
Seat 8: Natsoviy711 ($2.26 in chips)=20
Seat 9: HokageVIP ($2 in chips)=20
HokageVIP: posts small blind $0.01
betao22: posts big blind $0.02
*** HOLE CARDS ***
Dealt to the_wickstar [5s 3h]
the_wickstar: folds=20
gogu575: folds=20
oxxay: folds=20
No1da: folds=20
oxxay leaves the table
Chernovsky joins the table at seat #5=20
michispaw: folds=20
Natsoviy711: folds=20
HokageVIP: folds=20
Uncalled bet ($0.01) returned to betao22
betao22 collected $0.02 from pot
betao22: doesn't show hand=20
*** SUMMARY ***
Total pot $0.02 | Rake $0=20
Seat 1: betao22 (big blind) collected ($0.02)
Seat 2: the_wickstar folded before Flop (didn't bet)
Seat 4: gogu575 folded before Flop (didn't bet)
Seat 5: oxxay folded before Flop (didn't bet)
Seat 6: No1da folded before Flop (didn't bet)
Seat 7: michispaw folded before Flop (didn't bet)
Seat 8: Natsoviy711 (button) folded before Flop (didn't bet)
Seat 9: HokageVIP (small blind) folded before Flop


*********** # 124 **************
PokerStars Hand #169405160694:  Hold'em No Limit ($0.01/$0.02 USD) - 20=
17/04/23 3:09:08 CUST [2017/04/22 13:09:08 ET]
Table 'Enif' 9-max Seat #7 is the button
Seat 1: iliyan66 ($2 in chips)=20
Seat 2: the_wickstar ($0.76 in chips)=20
Seat 3: sergey347 ($1.54 in chips)=20
Seat 4: Hirnibirni ($3.27 in chips)=20
Seat 5: betao22 ($1.66 in chips)=20
Seat 6: Aracidus ($0.85 in chips)=20
Seat 7: ElSchmidtzel ($1.97 in chips)=20
Seat 8: Tom13333 ($2.01 in chips)=20
Seat 9: Radom94 ($1 in chips)=20
Tom13333: posts small blind $0.01
Radom94: posts big blind $0.02
*** HOLE CARDS ***
Dealt to the_wickstar [Qs Th]
iliyan66: folds=20
the_wickstar: raises $0.04 to $0.06
sergey347: folds=20
Hirnibirni: folds=20
betao22: calls $0.06
Aracidus: folds=20
ElSchmidtzel: folds=20
Tom13333: folds=20
Radom94: calls $0.04
*** FLOP *** [7s 3c Kh]
Radom94: checks=20
the_wickstar: checks=20
betao22: bets $0.04
Radom94: calls $0.04
the_wickstar: raises $0.14 to $0.18
betao22: folds=20
Radom94: folds=20
Uncalled bet ($0.14) returned to the_wickstar
the_wickstar collected $0.30 from pot
*** SUMMARY ***
Total pot $0.31 | Rake $0.01=20
Board [7s 3c Kh]
Seat 1: iliyan66 folded before Flop (didn't bet)
Seat 2: the_wickstar collected ($0.30)
Seat 3: sergey347 folded before Flop (didn't bet)
Seat 4: Hirnibirni folded before Flop (didn't bet)
Seat 5: betao22 folded on the Flop
Seat 6: Aracidus folded before Flop (didn't bet)
Seat 7: ElSchmidtzel (button) folded before Flop (didn't bet)
Seat 8: Tom13333 (small blind) folded before Flop
Seat 9: Radom94 (big blind) folded on the Flop


*********** # 125 **************
PokerStars Hand #169405145453:  Hold'em No Limit ($0.01/$0.02 USD) - 20=
17/04/23 3:08:50 CUST [2017/04/22 13:08:50 ET]
Table 'Enif' 9-max Seat #6 is the button
Seat 1: iliyan66 ($2 in chips)=20
Seat 2: the_wickstar ($0.76 in chips)=20
Seat 3: sergey347 ($1.54 in chips)=20
Seat 4: Hirnibirni ($3.27 in chips)=20
Seat 5: betao22 ($1.66 in chips)=20
Seat 6: Aracidus ($0.85 in chips)=20
Seat 7: ElSchmidtzel ($1.98 in chips)=20
Seat 8: Tom13333 ($2 in chips)=20
ElSchmidtzel: posts small blind $0.01
Tom13333: posts big blind $0.02
Radom94: sits out=20
*** HOLE CARDS ***
Dealt to the_wickstar [7c 3d]
iliyan66: folds=20
the_wickstar: folds=20
sergey347: folds=20
Hirnibirni: folds=20
betao22: folds=20
Aracidus: folds=20
ElSchmidtzel: folds=20
Uncalled bet ($0.01) returned to Tom13333
Tom13333 collected $0.02 from pot
Tom13333: doesn't show hand=20
*** SUMMARY ***
Total pot $0.02 | Rake $0=20
Seat 1: iliyan66 folded before Flop (didn't bet)
Seat 2: the_wickstar folded before Flop (didn't bet)
Seat 3: sergey347 folded before Flop (didn't bet)
Seat 4: Hirnibirni folded before Flop (didn't bet)
Seat 5: betao22 folded before Flop (didn't bet)
Seat 6: Aracidus (button) folded before Flop (didn't bet)
Seat 7: ElSchmidtzel (small blind) folded before Flop
Seat 8: Tom13333 (big blind) collected ($0.02)


*********** # 126 **************
PokerStars Hand #169405144399:  Hold'em No Limit ($0.01/$0.02 USD) - 20=
17/04/23 3:08:49 CUST [2017/04/22 13:08:49 ET]
Table 'Joella' 9-max Seat #7 is the button
Seat 1: betao22 ($1.87 in chips)=20
Seat 2: the_wickstar ($0.58 in chips)=20
Seat 4: gogu575 ($1.60 in chips)=20
Seat 5: oxxay ($1.88 in chips)=20
Seat 6: No1da ($2.59 in chips)=20
Seat 7: michispaw ($1.95 in chips)=20
Seat 8: Natsoviy711 ($2.28 in chips)=20
Seat 9: HokageVIP ($2 in chips)=20
Natsoviy711: posts small blind $0.01
HokageVIP: posts big blind $0.02
*** HOLE CARDS ***
Dealt to the_wickstar [5s 6h]
betao22: calls $0.02
the_wickstar: calls $0.02
gogu575: folds=20
oxxay: calls $0.02
No1da: folds=20
michispaw: folds=20
Natsoviy711: calls $0.01
HokageVIP: checks=20
*** FLOP *** [3c 9s 3s]
Natsoviy711: checks=20
HokageVIP: bets $0.02
betao22: folds=20
the_wickstar: folds=20
oxxay: calls $0.02
Natsoviy711: folds=20
*** TURN *** [3c 9s 3s] [Ac]
HokageVIP: checks=20
oxxay: bets $0.04
HokageVIP: folds=20
Uncalled bet ($0.04) returned to oxxay
oxxay collected $0.14 from pot
oxxay: doesn't show hand=20
*** SUMMARY ***
Total pot $0.14 | Rake $0=20
Board [3c 9s 3s Ac]
Seat 1: betao22 folded on the Flop
Seat 2: the_wickstar folded on the Flop
Seat 4: gogu575 folded before Flop (didn't bet)
Seat 5: oxxay collected ($0.14)
Seat 6: No1da folded before Flop (didn't bet)
Seat 7: michispaw (button) folded before Flop (didn't bet)
Seat 8: Natsoviy711 (small blind) folded on the Flop
Seat 9: HokageVIP (big blind) folded on the Turn


*********** # 127 **************
PokerStars Hand #169405097395:  Hold'em No Limit ($0.01/$0.02 USD) - 20=
17/04/23 3:07:54 CUST [2017/04/22 13:07:54 ET]
Table 'Joella' 9-max Seat #6 is the button
Seat 1: betao22 ($1.87 in chips)=20
Seat 2: the_wickstar ($0.64 in chips)=20
Seat 4: gogu575 ($1.60 in chips)=20
Seat 5: oxxay ($1.88 in chips)=20
Seat 6: No1da ($2.59 in chips)=20
Seat 7: michispaw ($1.96 in chips)=20
Seat 8: Natsoviy711 ($2.21 in chips)=20
Seat 9: HokageVIP ($2 in chips)=20
michispaw: posts small blind $0.01
Natsoviy711: posts big blind $0.02
*** HOLE CARDS ***
Dealt to the_wickstar [Js Ks]
HokageVIP: folds=20
betao22: folds=20
the_wickstar: raises $0.04 to $0.06
gogu575: folds=20
oxxay: folds=20
No1da: folds=20
michispaw: folds=20
Natsoviy711: calls $0.04
*** FLOP *** [As 6c 2h]
Natsoviy711: bets $0.07
the_wickstar: folds=20
Uncalled bet ($0.07) returned to Natsoviy711
Natsoviy711 collected $0.13 from pot
*** SUMMARY ***
Total pot $0.13 | Rake $0=20
Board [As 6c 2h]
Seat 1: betao22 folded before Flop (didn't bet)
Seat 2: the_wickstar folded on the Flop
Seat 4: gogu575 folded before Flop (didn't bet)
Seat 5: oxxay folded before Flop (didn't bet)
Seat 6: No1da (button) folded before Flop (didn't bet)
Seat 7: michispaw (small blind) folded before Flop
Seat 8: Natsoviy711 (big blind) collected ($0.13)
Seat 9: HokageVIP folded before Flop (didn't bet)


*********** # 128 **************
PokerStars Hand #169405052499:  Hold'em No Limit ($0.01/$0.02 USD) - 20=
17/04/23 3:07:02 CUST [2017/04/22 13:07:02 ET]
Table 'Enif' 9-max Seat #5 is the button
Seat 1: iliyan66 ($2 in chips)=20
Seat 2: the_wickstar ($1.12 in chips)=20
Seat 3: sergey347 ($1.54 in chips)=20
Seat 4: Hirnibirni ($1.50 in chips)=20
Seat 5: betao22 ($1.66 in chips)=20
Seat 6: Aracidus ($0.86 in chips)=20
Seat 7: ElSchmidtzel ($2 in chips)=20
Seat 8: Tom13333 ($1.99 in chips)=20
Aracidus: posts small blind $0.01
ElSchmidtzel: posts big blind $0.02
Radom94: sits out=20
*** HOLE CARDS ***
Dealt to the_wickstar [Qh As]
Tom13333: raises $0.10 to $0.12
iliyan66: folds=20
the_wickstar: calls $0.12
sergey347: folds=20
Hirnibirni: raises $0.24 to $0.36
betao22: folds=20
Aracidus: folds=20
ElSchmidtzel: folds=20
Tom13333: calls $0.24
the_wickstar: calls $0.24
*** FLOP *** [Td Kh 5s]
Tom13333: checks=20
the_wickstar: checks=20
Hirnibirni: bets $0.50
Tom13333: raises $1.13 to $1.63 and is all-in
the_wickstar: folds=20
Hirnibirni: calls $0.64 and is all-in
Uncalled bet ($0.49) returned to Tom13333
*** TURN *** [Td Kh 5s] [8d]
*** RIVER *** [Td Kh 5s 8d] [8h]
*** SHOW DOWN ***
Tom13333: shows [Kc Ad] (two pair, Kings and Eights)
Hirnibirni: shows [Ah Ac] (two pair, Aces and Eights)
Hirnibirni collected $3.27 from pot
*** SUMMARY ***
Total pot $3.39 | Rake $0.12=20
Board [Td Kh 5s 8d 8h]
Seat 1: iliyan66 folded before Flop (didn't bet)
Seat 2: the_wickstar folded on the Flop
Seat 3: sergey347 folded before Flop (didn't bet)
Seat 4: Hirnibirni showed [Ah Ac] and won ($3.27) with two pair, Aces a=
nd Eights
Seat 5: betao22 (button) folded before Flop (didn't bet)
Seat 6: Aracidus (small blind) folded before Flop
Seat 7: ElSchmidtzel (big blind) folded before Flop
Seat 8: Tom13333 showed [Kc Ad] and lost with two pair, Kings and Eights


*********** # 129 **************
PokerStars Hand #169405047509:  Hold'em No Limit ($0.01/$0.02 USD) - 20=
17/04/23 3:06:56 CUST [2017/04/22 13:06:56 ET]
Table 'Joella' 9-max Seat #5 is the button
Seat 1: betao22 ($1.87 in chips)=20
Seat 2: the_wickstar ($0.64 in chips)=20
Seat 4: gogu575 ($1.60 in chips)=20
Seat 5: oxxay ($2.46 in chips)=20
Seat 6: No1da ($2.03 in chips)=20
Seat 7: michispaw ($1.98 in chips)=20
Seat 8: Natsoviy711 ($2.21 in chips)=20
Seat 9: HokageVIP ($2 in chips)=20
No1da: posts small blind $0.01
michispaw: posts big blind $0.02
*** HOLE CARDS ***
Dealt to the_wickstar [Jd 8s]
Natsoviy711: folds=20
HokageVIP: folds=20
betao22: folds=20
the_wickstar: folds=20
gogu575: folds=20
oxxay: raises $0.02 to $0.04
No1da: raises $0.10 to $0.14
michispaw: folds=20
oxxay: calls $0.10
*** FLOP *** [6d Kc Jc]
No1da: bets $0.15
oxxay: calls $0.15
*** TURN *** [6d Kc Jc] [3h]
No1da: bets $0.29
oxxay: calls $0.29
*** RIVER *** [6d Kc Jc 3h] [Th]
No1da: checks=20
oxxay: checks=20
*** SHOW DOWN ***
No1da: shows [Ad Ks] (a pair of Kings)
oxxay: mucks hand=20
No1da collected $1.14 from pot
*** SUMMARY ***
Total pot $1.18 | Rake $0.04=20
Board [6d Kc Jc 3h Th]
Seat 1: betao22 folded before Flop (didn't bet)
Seat 2: the_wickstar folded before Flop (didn't bet)
Seat 4: gogu575 folded before Flop (didn't bet)
Seat 5: oxxay (button) mucked [9d Kd]
Seat 6: No1da (small blind) showed [Ad Ks] and won ($1.14) with a pair =
of Kings
Seat 7: michispaw (big blind) folded before Flop
Seat 8: Natsoviy711 folded before Flop (didn't bet)
Seat 9: HokageVIP folded before Flop (didn't bet)


*********** # 130 **************
PokerStars Hand #169405025948:  Hold'em No Limit ($0.01/$0.02 USD) - 20=
17/04/23 3:06:31 CUST [2017/04/22 13:06:31 ET]
Table 'Enif' 9-max Seat #4 is the button
Seat 1: iliyan66 ($2 in chips)=20
Seat 2: the_wickstar ($1.04 in chips)=20
Seat 3: sergey347 ($1.54 in chips)=20
Seat 4: Hirnibirni ($1.56 in chips)=20
Seat 5: betao22 ($1.67 in chips)=20
Seat 6: Aracidus ($0.88 in chips)=20
Seat 8: Tom13333 ($1.99 in chips)=20
betao22: posts small blind $0.01
Aracidus: posts big blind $0.02
Radom94: sits out=20
*** HOLE CARDS ***
Dealt to the_wickstar [Ks 7c]
ElSchmidtzel joins the table at seat #7=20
Tom13333: folds=20
iliyan66: folds=20
the_wickstar: raises $0.04 to $0.06
sergey347: folds=20
Hirnibirni: calls $0.06
betao22: folds=20
Aracidus: folds=20
*** FLOP *** [As 5h Ad]
the_wickstar: bets $0.14
Hirnibirni: folds=20
Uncalled bet ($0.14) returned to the_wickstar
the_wickstar collected $0.14 from pot
*** SUMMARY ***
Total pot $0.15 | Rake $0.01=20
Board [As 5h Ad]
Seat 1: iliyan66 folded before Flop (didn't bet)
Seat 2: the_wickstar collected ($0.14)
Seat 3: sergey347 folded before Flop (didn't bet)
Seat 4: Hirnibirni (button) folded on the Flop
Seat 5: betao22 (small blind) folded before Flop
Seat 6: Aracidus (big blind) folded before Flop
Seat 8: Tom13333 folded before Flop (didn't bet)


*********** # 131 **************
PokerStars Hand #169405021628:  Hold'em No Limit ($0.01/$0.02 USD) - 20=
17/04/23 3:06:26 CUST [2017/04/22 13:06:26 ET]
Table 'Joella' 9-max Seat #4 is the button
Seat 1: betao22 ($1.87 in chips)=20
Seat 2: the_wickstar ($0.64 in chips)=20
Seat 4: gogu575 ($1.62 in chips)=20
Seat 5: oxxay ($2.47 in chips)=20
Seat 6: No1da ($2 in chips)=20
Seat 7: michispaw ($1.98 in chips)=20
Seat 8: Natsoviy711 ($2.21 in chips)=20
Seat 9: HokageVIP ($2 in chips)=20
oxxay: posts small blind $0.01
No1da: posts big blind $0.02
*** HOLE CARDS ***
Dealt to the_wickstar [6d 3d]
michispaw: folds=20
Natsoviy711: folds=20
HokageVIP: folds=20
betao22: folds=20
the_wickstar: folds=20
gogu575: calls $0.02
oxxay: folds=20
No1da: raises $0.05 to $0.07
gogu575: folds=20
Uncalled bet ($0.05) returned to No1da
No1da collected $0.05 from pot
No1da: doesn't show hand=20
*** SUMMARY ***
Total pot $0.05 | Rake $0=20
Seat 1: betao22 folded before Flop (didn't bet)
Seat 2: the_wickstar folded before Flop (didn't bet)
Seat 4: gogu575 (button) folded before Flop
Seat 5: oxxay (small blind) folded before Flop
Seat 6: No1da (big blind) collected ($0.05)
Seat 7: michispaw folded before Flop (didn't bet)
Seat 8: Natsoviy711 folded before Flop (didn't bet)
Seat 9: HokageVIP folded before Flop (didn't bet)


*********** # 132 **************
PokerStars Hand #169404983100:  Hold'em No Limit ($0.01/$0.02 USD) - 20=
17/04/23 3:05:41 CUST [2017/04/22 13:05:41 ET]
Table 'Joella' 9-max Seat #2 is the button
Seat 1: betao22 ($1.87 in chips)=20
Seat 2: the_wickstar ($0.54 in chips)=20
Seat 4: gogu575 ($1.63 in chips)=20
Seat 5: oxxay ($2.49 in chips)=20
Seat 6: No1da ($2 in chips)=20
Seat 7: michispaw ($1.98 in chips)=20
Seat 8: Natsoviy711 ($2.29 in chips)=20
Seat 9: HokageVIP ($2 in chips)=20
gogu575: posts small blind $0.01
oxxay: posts big blind $0.02
*** HOLE CARDS ***
Dealt to the_wickstar [Jc As]
No1da: folds=20
michispaw: folds=20
Natsoviy711: calls $0.02
HokageVIP: folds=20
betao22: folds=20
the_wickstar: raises $0.06 to $0.08
gogu575: folds=20
oxxay: folds=20
Natsoviy711: calls $0.06
*** FLOP *** [3d 8h 9d]
Natsoviy711: checks=20
the_wickstar: bets $0.18
Natsoviy711: folds=20
Uncalled bet ($0.18) returned to the_wickstar
the_wickstar collected $0.18 from pot
*** SUMMARY ***
Total pot $0.19 | Rake $0.01=20
Board [3d 8h 9d]
Seat 1: betao22 folded before Flop (didn't bet)
Seat 2: the_wickstar (button) collected ($0.18)
Seat 4: gogu575 (small blind) folded before Flop
Seat 5: oxxay (big blind) folded before Flop
Seat 6: No1da folded before Flop (didn't bet)
Seat 7: michispaw folded before Flop (didn't bet)
Seat 8: Natsoviy711 folded on the Flop
Seat 9: HokageVIP folded before Flop (didn't bet)


*********** # 133 **************
PokerStars Hand #169404958677:  Hold'em No Limit ($0.01/$0.02 USD) - 20=
17/04/23 3:05:12 CUST [2017/04/22 13:05:12 ET]
Table 'Enif' 9-max Seat #3 is the button
Seat 1: iliyan66 ($2 in chips)=20
Seat 2: the_wickstar ($1.04 in chips)=20
Seat 3: sergey347 ($1.56 in chips)=20
Seat 4: Hirnibirni ($1.58 in chips)=20
Seat 5: betao22 ($1.69 in chips)=20
Seat 6: Aracidus ($0.82 in chips)=20
Seat 8: Tom13333 ($1.99 in chips)=20
Hirnibirni: posts small blind $0.01
betao22: posts big blind $0.02
Radom94: sits out=20
*** HOLE CARDS ***
Dealt to the_wickstar [6h 3d]
Aracidus: calls $0.02
Tom13333: folds=20
iliyan66: folds=20
humane1ement leaves the table
the_wickstar: folds=20
sergey347: calls $0.02
Hirnibirni: calls $0.01
betao22: checks=20
*** FLOP *** [Ah 9s 4s]
Hirnibirni: checks=20
betao22: checks=20
Aracidus: checks=20
sergey347: checks=20
*** TURN *** [Ah 9s 4s] [Ac]
Hirnibirni: checks=20
betao22: checks=20
Aracidus: checks=20
sergey347: checks=20
*** RIVER *** [Ah 9s 4s Ac] [3h]
Hirnibirni: checks=20
betao22: checks=20
Aracidus: checks=20
sergey347: checks=20
*** SHOW DOWN ***
Hirnibirni: shows [Qh 8h] (a pair of Aces)
betao22: mucks hand=20
Aracidus: shows [Ks Th] (a pair of Aces - King kicker)
sergey347: mucks hand=20
Aracidus collected $0.08 from pot
*** SUMMARY ***
Total pot $0.08 | Rake $0=20
Board [Ah 9s 4s Ac 3h]
Seat 1: iliyan66 folded before Flop (didn't bet)
Seat 2: the_wickstar folded before Flop (didn't bet)
Seat 3: sergey347 (button) mucked [Js 8c]
Seat 4: Hirnibirni (small blind) showed [Qh 8h] and lost with a pair of=
 Aces
Seat 5: betao22 (big blind) mucked [5c 8s]
Seat 6: Aracidus showed [Ks Th] and won ($0.08) with a pair of Aces
Seat 8: Tom13333 folded before Flop (didn't bet)


*********** # 134 **************
PokerStars Hand #169404913577:  Hold'em No Limit ($0.01/$0.02 USD) - 20=
17/04/23 3:04:18 CUST [2017/04/22 13:04:18 ET]
Table 'Joella' 9-max Seat #1 is the button
Seat 1: betao22 ($1.87 in chips)=20
Seat 2: the_wickstar ($0.62 in chips)=20
Seat 4: gogu575 ($1.54 in chips)=20
Seat 5: oxxay ($2.49 in chips)=20
Seat 6: No1da ($2 in chips)=20
Seat 7: michispaw ($2 in chips)=20
Seat 8: Natsoviy711 ($2.29 in chips)=20
Seat 9: HokageVIP ($2 in chips)=20
the_wickstar: posts small blind $0.01
gogu575: posts big blind $0.02
michispaw: posts big blind $0.02
*** HOLE CARDS ***
Dealt to the_wickstar [8c Ks]
oxxay: folds=20
No1da: folds=20
michispaw: checks=20
Natsoviy711: folds=20
HokageVIP: folds=20
betao22: folds=20
the_wickstar: calls $0.01
gogu575: checks=20
*** FLOP *** [7s 5c 5s]
the_wickstar: checks=20
gogu575: checks=20
michispaw: checks=20
*** TURN *** [7s 5c 5s] [Tc]
the_wickstar: checks=20
gogu575: checks=20
michispaw: checks=20
*** RIVER *** [7s 5c 5s Tc] [6d]
the_wickstar: bets $0.06
gogu575: calls $0.06
michispaw: folds=20
*** SHOW DOWN ***
the_wickstar: shows [8c Ks] (a pair of Fives)
gogu575: shows [Ts Td] (a full house, Tens full of Fives)
gogu575 collected $0.17 from pot
*** SUMMARY ***
Total pot $0.18 | Rake $0.01=20
Board [7s 5c 5s Tc 6d]
Seat 1: betao22 (button) folded before Flop (didn't bet)
Seat 2: the_wickstar (small blind) showed [8c Ks] and lost with a pair =
of Fives
Seat 4: gogu575 (big blind) showed [Ts Td] and won ($0.17) with a full =
house, Tens full of Fives
Seat 5: oxxay folded before Flop (didn't bet)
Seat 6: No1da folded before Flop (didn't bet)
Seat 7: michispaw folded on the River
Seat 8: Natsoviy711 folded before Flop (didn't bet)
Seat 9: HokageVIP folded before Flop (didn't bet)


*********** # 135 **************
PokerStars Hand #169404896310:  Hold'em No Limit ($0.01/$0.02 USD) - 20=
17/04/23 3:03:57 CUST [2017/04/22 13:03:57 ET]
Table 'Enif' 9-max Seat #2 is the button
Seat 1: iliyan66 ($2 in chips)=20
Seat 2: the_wickstar ($0.94 in chips)=20
Seat 3: sergey347 ($1.60 in chips)=20
Seat 4: Hirnibirni ($1.60 in chips)=20
Seat 5: betao22 ($1.73 in chips)=20
Seat 6: Aracidus ($0.82 in chips)=20
Seat 8: Tom13333 ($1.99 in chips)=20
sergey347: posts small blind $0.01
Hirnibirni: posts big blind $0.02
Radom94: sits out=20
*** HOLE CARDS ***
Dealt to the_wickstar [6d 7s]
betao22: calls $0.02
Aracidus: folds=20
Tom13333: folds=20
iliyan66: folds=20
the_wickstar: raises $0.02 to $0.04
sergey347: calls $0.03
Hirnibirni: folds=20
betao22: calls $0.02
*** FLOP *** [Ad 8d 7h]
sergey347: checks=20
betao22: checks=20
the_wickstar: bets $0.12
sergey347: folds=20
betao22: folds=20
Uncalled bet ($0.12) returned to the_wickstar
the_wickstar collected $0.14 from pot
*** SUMMARY ***
Total pot $0.14 | Rake $0=20
Board [Ad 8d 7h]
Seat 1: iliyan66 folded before Flop (didn't bet)
Seat 2: the_wickstar (button) collected ($0.14)
Seat 3: sergey347 (small blind) folded on the Flop
Seat 4: Hirnibirni (big blind) folded before Flop
Seat 5: betao22 folded on the Flop
Seat 6: Aracidus folded before Flop (didn't bet)
Seat 8: Tom13333 folded before Flop (didn't bet)


*********** # 136 **************
PokerStars Hand #169404848005:  Hold'em No Limit ($0.01/$0.02 USD) - 20=
17/04/23 3:02:58 CUST [2017/04/22 13:02:58 ET]
Table 'Joella' 9-max Seat #9 is the button
Seat 1: betao22 ($1.97 in chips)=20
Seat 2: the_wickstar ($1.14 in chips)=20
Seat 4: gogu575 ($1.64 in chips)=20
Seat 5: oxxay ($2.53 in chips)=20
Seat 6: No1da ($2 in chips)=20
Seat 8: Natsoviy711 ($1.57 in chips)=20
Seat 9: HokageVIP ($2 in chips)=20
betao22: posts small blind $0.01
the_wickstar: posts big blind $0.02
michispaw: sits out=20
*** HOLE CARDS ***
Dealt to the_wickstar [6h 2s]
gogu575: calls $0.02
oxxay: raises $0.02 to $0.04
No1da: folds=20
Natsoviy711: calls $0.04
HokageVIP: folds=20
betao22: calls $0.03
the_wickstar: calls $0.02
gogu575: calls $0.02
*** FLOP *** [5s 3s Ad]
betao22: checks=20
the_wickstar: checks=20
gogu575: checks=20
oxxay: checks=20
Natsoviy711: checks=20
*** TURN *** [5s 3s Ad] [Jh]
betao22: bets $0.06
the_wickstar: calls $0.06
gogu575: calls $0.06
oxxay: folds=20
Natsoviy711: calls $0.06
*** RIVER *** [5s 3s Ad Jh] [As]
betao22: checks=20
the_wickstar: bets $0.42
gogu575: folds=20
Natsoviy711: calls $0.42
betao22: folds=20
*** SHOW DOWN ***
the_wickstar: shows [6h 2s] (a pair of Aces)
Natsoviy711: shows [Jc Qd] (two pair, Aces and Jacks)
Natsoviy711 collected $1.24 from pot
*** SUMMARY ***
Total pot $1.28 | Rake $0.04=20
Board [5s 3s Ad Jh As]
Seat 1: betao22 (small blind) folded on the River
Seat 2: the_wickstar (big blind) showed [6h 2s] and lost with a pair of=
 Aces
Seat 4: gogu575 folded on the River
Seat 5: oxxay folded on the Turn
Seat 6: No1da folded before Flop (didn't bet)
Seat 8: Natsoviy711 showed [Jc Qd] and won ($1.24) with two pair, Aces =
and Jacks
Seat 9: HokageVIP (button) folded before Flop (didn't bet)


*********** # 137 **************
PokerStars Hand #169404842769:  Hold'em No Limit ($0.01/$0.02 USD) - 20=
17/04/23 3:02:52 CUST [2017/04/22 13:02:52 ET]
Table 'Enif' 9-max Seat #1 is the button
Seat 1: iliyan66 ($2 in chips)=20
Seat 2: the_wickstar ($0.95 in chips)=20
Seat 3: sergey347 ($1.40 in chips)=20
Seat 5: betao22 ($1.73 in chips)=20
Seat 6: Aracidus ($0.82 in chips)=20
Seat 8: Tom13333 ($2.19 in chips)=20
the_wickstar: posts small blind $0.01
sergey347: posts big blind $0.02
Hirnibirni: sits out=20
Radom94: sits out=20
*** HOLE CARDS ***
Dealt to the_wickstar [9s Jc]
betao22: folds=20
Aracidus: folds=20
Tom13333: raises $0.08 to $0.10
iliyan66: folds=20
the_wickstar: folds=20
sergey347: calls $0.08
*** FLOP *** [2h Ts 6s]
sergey347: checks=20
Tom13333: bets $0.10
sergey347: calls $0.10
*** TURN *** [2h Ts 6s] [5d]
sergey347: checks=20
Tom13333: checks=20
*** RIVER *** [2h Ts 6s 5d] [7h]
sergey347: bets $0.12
Tom13333: folds=20
Uncalled bet ($0.12) returned to sergey347
sergey347 collected $0.40 from pot
sergey347: doesn't show hand=20
*** SUMMARY ***
Total pot $0.41 | Rake $0.01=20
Board [2h Ts 6s 5d 7h]
Seat 1: iliyan66 (button) folded before Flop (didn't bet)
Seat 2: the_wickstar (small blind) folded before Flop
Seat 3: sergey347 (big blind) collected ($0.40)
Seat 5: betao22 folded before Flop (didn't bet)
Seat 6: Aracidus folded before Flop (didn't bet)
Seat 8: Tom13333 folded on the River


*********** # 138 **************
PokerStars Hand #169404838109:  Hold'em No Limit ($0.01/$0.02 USD) - 20=
17/04/23 3:02:47 CUST [2017/04/22 13:02:47 ET]
Table 'Joella' 9-max Seat #8 is the button
Seat 1: betao22 ($1.96 in chips)=20
Seat 2: the_wickstar ($1.14 in chips)=20
Seat 4: gogu575 ($1.64 in chips)=20
Seat 5: oxxay ($2.53 in chips)=20
Seat 6: No1da ($2 in chips)=20
Seat 8: Natsoviy711 ($1.57 in chips)=20
Seat 9: HokageVIP ($2 in chips)=20
HokageVIP: posts small blind $0.01
betao22: posts big blind $0.02
michispaw: sits out=20
*** HOLE CARDS ***
Dealt to the_wickstar [6d Jc]
the_wickstar: folds=20
gogu575: folds=20
oxxay: folds=20
No1da: folds=20
Natsoviy711: folds=20
HokageVIP: folds=20
Uncalled bet ($0.01) returned to betao22
betao22 collected $0.02 from pot
betao22: doesn't show hand=20
*** SUMMARY ***
Total pot $0.02 | Rake $0=20
Seat 1: betao22 (big blind) collected ($0.02)
Seat 2: the_wickstar folded before Flop (didn't bet)
Seat 4: gogu575 folded before Flop (didn't bet)
Seat 5: oxxay folded before Flop (didn't bet)
Seat 6: No1da folded before Flop (didn't bet)
Seat 8: Natsoviy711 (button) folded before Flop (didn't bet)
Seat 9: HokageVIP (small blind) folded before Flop


*********** # 139 **************
PokerStars Hand #169404825324:  Hold'em No Limit ($0.01/$0.02 USD) - 20=
17/04/23 3:02:31 CUST [2017/04/22 13:02:31 ET]
Table 'Enif' 9-max Seat #8 is the button
Seat 1: iliyan66 ($1.98 in chips)=20
Seat 2: the_wickstar ($0.97 in chips)=20
Seat 3: sergey347 ($1.40 in chips)=20
Seat 5: betao22 ($1.73 in chips)=20
Seat 6: Aracidus ($0.82 in chips)=20
Seat 8: Tom13333 ($2.19 in chips)=20
iliyan66: posts small blind $0.01
the_wickstar: posts big blind $0.02
*** HOLE CARDS ***
Dealt to the_wickstar [4s Ts]
Radom94 joins the table at seat #9=20
sergey347: folds=20
betao22: folds=20
Aracidus: folds=20
Tom13333: folds=20
iliyan66: raises $0.04 to $0.06
the_wickstar: folds=20
Uncalled bet ($0.04) returned to iliyan66
iliyan66 collected $0.04 from pot
iliyan66: doesn't show hand=20
Hirnibirni joins the table at seat #4=20
*** SUMMARY ***
Total pot $0.04 | Rake $0=20
Seat 1: iliyan66 (small blind) collected ($0.04)
Seat 2: the_wickstar (big blind) folded before Flop
Seat 3: sergey347 folded before Flop (didn't bet)
Seat 5: betao22 folded before Flop (didn't bet)
Seat 6: Aracidus folded before Flop (didn't bet)
Seat 8: Tom13333 (button) folded before Flop (didn't bet)


*********** # 140 **************
PokerStars Hand #169404810932:  Hold'em No Limit ($0.01/$0.02 USD) - 20=
17/04/23 3:02:11 CUST [2017/04/22 13:02:11 ET]
Table 'Joella' 9-max Seat #6 is the button
Seat 1: betao22 ($1.98 in chips)=20
Seat 2: the_wickstar ($1.14 in chips)=20
Seat 4: gogu575 ($1.64 in chips)=20
Seat 5: oxxay ($2.53 in chips)=20
Seat 6: No1da ($2 in chips)=20
Seat 8: Natsoviy711 ($1.53 in chips)=20
Seat 9: HokageVIP ($2 in chips)=20
michispaw will be allowed to play after the button
Natsoviy711: posts small blind $0.01
HokageVIP: posts big blind $0.02
*** HOLE CARDS ***
Dealt to the_wickstar [9h 4h]
betao22: calls $0.02
the_wickstar: folds=20
gogu575: folds=20
oxxay: folds=20
No1da: folds=20
Natsoviy711: calls $0.01
HokageVIP: checks=20
*** FLOP *** [6h 5s Js]
Natsoviy711: checks=20
HokageVIP: checks=20
betao22: checks=20
*** TURN *** [6h 5s Js] [7h]
Natsoviy711: bets $0.03
HokageVIP: folds=20
betao22: folds=20
Uncalled bet ($0.03) returned to Natsoviy711
Natsoviy711 collected $0.06 from pot
*** SUMMARY ***
Total pot $0.06 | Rake $0=20
Board [6h 5s Js 7h]
Seat 1: betao22 folded on the Turn
Seat 2: the_wickstar folded before Flop (didn't bet)
Seat 4: gogu575 folded before Flop (didn't bet)
Seat 5: oxxay folded before Flop (didn't bet)
Seat 6: No1da (button) folded before Flop (didn't bet)
Seat 8: Natsoviy711 (small blind) collected ($0.06)
Seat 9: HokageVIP (big blind) folded on the Turn


*********** # 141 **************
PokerStars Hand #169404797123:  Hold'em No Limit ($0.01/$0.02 USD) - 20=
17/04/23 3:01:53 CUST [2017/04/22 13:01:53 ET]
Table 'Enif' 9-max Seat #6 is the button
Seat 1: iliyan66 ($2 in chips)=20
Seat 2: the_wickstar ($0.94 in chips)=20
Seat 3: sergey347 ($1.40 in chips)=20
Seat 4: VIOLIST BR ($2.45 in chips)=20
Seat 5: betao22 ($1.73 in chips)=20
Seat 6: Aracidus ($0.82 in chips)=20
Seat 8: Tom13333 ($2.20 in chips)=20
Tom13333: posts small blind $0.01
iliyan66: posts big blind $0.02
*** HOLE CARDS ***
Dealt to the_wickstar [4d 5d]
the_wickstar: calls $0.02
sergey347: folds=20
VIOLIST BR: folds=20
betao22: folds=20
Aracidus: folds=20
DmitriKataev leaves the table
Tom13333: folds=20
iliyan66: checks=20
*** FLOP *** [Qd 6s 5h]
iliyan66: checks=20
the_wickstar: bets $0.03
VIOLIST BR leaves the table
iliyan66: folds=20
Uncalled bet ($0.03) returned to the_wickstar
the_wickstar collected $0.05 from pot
*** SUMMARY ***
Total pot $0.05 | Rake $0=20
Board [Qd 6s 5h]
Seat 1: iliyan66 (big blind) folded on the Flop
Seat 2: the_wickstar collected ($0.05)
Seat 3: sergey347 folded before Flop (didn't bet)
Seat 4: VIOLIST BR folded before Flop (didn't bet)
Seat 5: betao22 folded before Flop (didn't bet)
Seat 6: Aracidus (button) folded before Flop (didn't bet)
Seat 8: Tom13333 (small blind) folded before Flop


*********** # 142 **************
PokerStars Hand #169404777738:  Hold'em No Limit ($0.01/$0.02 USD) - 20=
17/04/23 3:01:26 CUST [2017/04/22 13:01:26 ET]
Table 'Joella' 9-max Seat #5 is the button
Seat 1: betao22 ($1.98 in chips)=20
Seat 2: the_wickstar ($1.14 in chips)=20
Seat 4: gogu575 ($1.64 in chips)=20
Seat 5: oxxay ($2.59 in chips)=20
Seat 6: No1da ($2 in chips)=20
Seat 8: Natsoviy711 ($1.46 in chips)=20
Seat 9: HokageVIP ($2 in chips)=20
No1da: posts small blind $0.01
elenkachumak: is sitting out=20
Natsoviy711: posts big blind $0.02
*** HOLE CARDS ***
Dealt to the_wickstar [8d Qd]
elenkachumak leaves the table
HokageVIP: folds=20
betao22: folds=20
the_wickstar: folds=20
gogu575: folds=20
oxxay: calls $0.02
No1da: folds=20
michispaw joins the table at seat #7=20
Natsoviy711: checks=20
*** FLOP *** [Kc Qs 4h]
Natsoviy711: checks=20
oxxay: checks=20
*** TURN *** [Kc Qs 4h] [8c]
Natsoviy711: checks=20
oxxay: bets $0.04
Natsoviy711: raises $0.04 to $0.08
oxxay: folds=20
Uncalled bet ($0.04) returned to Natsoviy711
Natsoviy711 collected $0.13 from pot
*** SUMMARY ***
Total pot $0.13 | Rake $0=20
Board [Kc Qs 4h 8c]
Seat 1: betao22 folded before Flop (didn't bet)
Seat 2: the_wickstar folded before Flop (didn't bet)
Seat 4: gogu575 folded before Flop (didn't bet)
Seat 5: oxxay (button) folded on the Turn
Seat 6: No1da (small blind) folded before Flop
Seat 8: Natsoviy711 (big blind) collected ($0.13)
Seat 9: HokageVIP folded before Flop (didn't bet)


*********** # 143 **************
PokerStars Hand #169404756474:  Hold'em No Limit ($0.01/$0.02 USD) - 20=
17/04/23 3:00:56 CUST [2017/04/22 13:00:56 ET]
Table 'Joella' 9-max Seat #4 is the button
Seat 1: betao22 ($1.98 in chips)=20
Seat 2: the_wickstar ($1.09 in chips)=20
Seat 4: gogu575 ($1.64 in chips)=20
Seat 5: oxxay ($2.60 in chips)=20
Seat 6: No1da ($2 in chips)=20
Seat 7: elenkachumak ($0.89 in chips)=20
Seat 8: Natsoviy711 ($1.46 in chips)=20
Seat 9: HokageVIP ($2 in chips)=20
oxxay: posts small blind $0.01
No1da: posts big blind $0.02
*** HOLE CARDS ***
Dealt to the_wickstar [9d As]
elenkachumak: calls $0.02
Natsoviy711: folds=20
HokageVIP: folds=20
betao22: folds=20
the_wickstar: raises $0.04 to $0.06
gogu575: folds=20
oxxay: folds=20
No1da: folds=20
elenkachumak: folds=20
Uncalled bet ($0.04) returned to the_wickstar
the_wickstar collected $0.07 from pot
*** SUMMARY ***
Total pot $0.07 | Rake $0=20
Seat 1: betao22 folded before Flop (didn't bet)
Seat 2: the_wickstar collected ($0.07)
Seat 4: gogu575 (button) folded before Flop (didn't bet)
Seat 5: oxxay (small blind) folded before Flop
Seat 6: No1da (big blind) folded before Flop
Seat 7: elenkachumak folded before Flop
Seat 8: Natsoviy711 folded before Flop (didn't bet)
Seat 9: HokageVIP folded before Flop (didn't bet)


*********** # 144 **************
PokerStars Hand #169404743365:  Hold'em No Limit ($0.01/$0.02 USD) - 20=
17/04/23 3:00:36 CUST [2017/04/22 13:00:36 ET]
Table 'Enif' 9-max Seat #5 is the button
Seat 1: azrawith ($2 in chips)=20
Seat 2: the_wickstar ($0.94 in chips)=20
Seat 3: sergey347 ($1.42 in chips)=20
Seat 4: VIOLIST BR ($2.45 in chips)=20
Seat 5: betao22 ($1.68 in chips)=20
Seat 6: Aracidus ($0.83 in chips)=20
Seat 8: Tom13333 ($2.22 in chips)=20
Aracidus: posts small blind $0.01
humane1ement: is sitting out=20
Tom13333: posts big blind $0.02
*** HOLE CARDS ***
Dealt to the_wickstar [8d 9s]
azrawith: folds=20
azrawith leaves the table
the_wickstar: folds=20
sergey347: calls $0.02
VIOLIST BR: folds=20
betao22: calls $0.02
Aracidus: folds=20
Tom13333: checks=20
*** FLOP *** [5s 3h Qc]
Tom13333: checks=20
sergey347: checks=20
betao22: checks=20
*** TURN *** [5s 3h Qc] [Qh]
iliyan66 joins the table at seat #1=20
Tom13333: checks=20
sergey347: checks=20
betao22: checks=20
*** RIVER *** [5s 3h Qc Qh] [8c]
Tom13333: checks=20
sergey347: checks=20
betao22: checks=20
*** SHOW DOWN ***
Tom13333: shows [7h Kd] (a pair of Queens)
sergey347: mucks hand=20
betao22: shows [Ah 2h] (a pair of Queens - Ace kicker)
betao22 collected $0.07 from pot
*** SUMMARY ***
Total pot $0.07 | Rake $0=20
Board [5s 3h Qc Qh 8c]
Seat 1: azrawith folded before Flop (didn't bet)
Seat 2: the_wickstar folded before Flop (didn't bet)
Seat 3: sergey347 mucked [Jd Th]
Seat 4: VIOLIST BR folded before Flop (didn't bet)
Seat 5: betao22 (button) showed [Ah 2h] and won ($0.07) with a pair of =
Queens
Seat 6: Aracidus (small blind) folded before Flop
Seat 8: Tom13333 (big blind) showed [7h Kd] and lost with a pair of Que=
ens


*********** # 145 **************
PokerStars Hand #169404720602:  Hold'em No Limit ($0.01/$0.02 USD) - 20=
17/04/23 3:00:00 CUST [2017/04/22 13:00:00 ET]
Table 'Joella' 9-max Seat #2 is the button
Seat 1: betao22 ($2 in chips)=20
Seat 2: the_wickstar ($1.04 in chips)=20
Seat 4: gogu575 ($1.65 in chips)=20
Seat 5: oxxay ($2.62 in chips)=20
Seat 6: No1da ($2 in chips)=20
Seat 7: elenkachumak ($0.89 in chips)=20
Seat 8: Natsoviy711 ($1.46 in chips)=20
Seat 9: HokageVIP ($2 in chips)=20
gogu575: posts small blind $0.01
oxxay: posts big blind $0.02
betao22: posts big blind $0.02
*** HOLE CARDS ***
Dealt to the_wickstar [As 7s]
No1da: folds=20
elenkachumak: folds=20
Natsoviy711: folds=20
HokageVIP: folds=20
betao22: checks=20
the_wickstar: calls $0.02
gogu575: folds=20
oxxay: checks=20
*** FLOP *** [7c 9s 4c]
oxxay: checks=20
betao22: checks=20
the_wickstar: bets $0.05
oxxay: folds=20
betao22: folds=20
Uncalled bet ($0.05) returned to the_wickstar
the_wickstar collected $0.07 from pot
*** SUMMARY ***
Total pot $0.07 | Rake $0=20
Board [7c 9s 4c]
Seat 1: betao22 folded on the Flop
Seat 2: the_wickstar (button) collected ($0.07)
Seat 4: gogu575 (small blind) folded before Flop
Seat 5: oxxay (big blind) folded on the Flop
Seat 6: No1da folded before Flop (didn't bet)
Seat 7: elenkachumak folded before Flop (didn't bet)
Seat 8: Natsoviy711 folded before Flop (didn't bet)
Seat 9: HokageVIP folded before Flop (didn't bet)


*********** # 146 **************
PokerStars Hand #169404703883:  Hold'em No Limit ($0.01/$0.02 USD) - 20=
17/04/23 2:59:32 CUST [2017/04/22 12:59:32 ET]
Table 'Enif' 9-max Seat #4 is the button
Seat 1: azrawith ($2 in chips)=20
Seat 2: the_wickstar ($1 in chips)=20
Seat 3: sergey347 ($1.42 in chips)=20
Seat 4: VIOLIST BR ($2.45 in chips)=20
Seat 5: betao22 ($1.74 in chips)=20
Seat 6: Aracidus ($0.72 in chips)=20
Seat 7: humane1ement ($3.62 in chips)=20
Seat 8: Tom13333 ($2.22 in chips)=20
betao22: posts small blind $0.01
Aracidus: posts big blind $0.02
*** HOLE CARDS ***
Dealt to the_wickstar [3d 5d]
humane1ement: folds=20
Tom13333: folds=20
azrawith: folds=20
the_wickstar: calls $0.02
sergey347: folds=20
VIOLIST BR: folds=20
betao22: calls $0.01
Aracidus: raises $0.04 to $0.06
the_wickstar: calls $0.04
betao22: calls $0.04
*** FLOP *** [5h Qh As]
betao22: checks=20
Aracidus: bets $0.17
the_wickstar: folds=20
betao22: folds=20
Uncalled bet ($0.17) returned to Aracidus
Aracidus collected $0.17 from pot
Aracidus: doesn't show hand=20
*** SUMMARY ***
Total pot $0.18 | Rake $0.01=20
Board [5h Qh As]
Seat 1: azrawith folded before Flop (didn't bet)
Seat 2: the_wickstar folded on the Flop
Seat 3: sergey347 folded before Flop (didn't bet)
Seat 4: VIOLIST BR (button) folded before Flop (didn't bet)
Seat 5: betao22 (small blind) folded on the Flop
Seat 6: Aracidus (big blind) collected ($0.17)
Seat 7: humane1ement folded before Flop (didn't bet)
Seat 8: Tom13333 folded before Flop (didn't bet)


*********** # 147 **************
PokerStars Hand #169404702938:  Hold'em No Limit ($0.01/$0.02 USD) - 20=
17/04/23 2:59:31 CUST [2017/04/22 12:59:31 ET]
Table 'Joella' 9-max Seat #9 is the button
Seat 2: the_wickstar ($1.05 in chips)=20
Seat 4: gogu575 ($1.58 in chips)=20
Seat 5: oxxay ($2.62 in chips)=20
Seat 6: No1da ($2.03 in chips)=20
Seat 7: elenkachumak ($0.89 in chips)=20
Seat 8: Natsoviy711 ($1.46 in chips)=20
Seat 9: HokageVIP ($2 in chips)=20
betao22 will be allowed to play after the button
the_wickstar: posts small blind $0.01
gogu575: posts big blind $0.02
*** HOLE CARDS ***
Dealt to the_wickstar [4c 6h]
oxxay: folds=20
No1da: raises $0.04 to $0.06
elenkachumak: folds=20
Natsoviy711: folds=20
HokageVIP: folds=20
the_wickstar: folds=20
gogu575: calls $0.04
*** FLOP *** [Ks Tc 2d]
gogu575: checks=20
No1da: checks=20
*** TURN *** [Ks Tc 2d] [Ah]
gogu575: checks=20
No1da: checks=20
*** RIVER *** [Ks Tc 2d Ah] [Kc]
gogu575: checks=20
No1da: checks=20
*** SHOW DOWN ***
gogu575: shows [Jc Kd] (three of a kind, Kings)
No1da: mucks hand=20
gogu575 collected $0.13 from pot
*** SUMMARY ***
Total pot $0.13 | Rake $0=20
Board [Ks Tc 2d Ah Kc]
Seat 2: the_wickstar (small blind) folded before Flop
Seat 4: gogu575 (big blind) showed [Jc Kd] and won ($0.13) with three o=
f a kind, Kings
Seat 5: oxxay folded before Flop (didn't bet)
Seat 6: No1da mucked [Jd Jh]
Seat 7: elenkachumak folded before Flop (didn't bet)
Seat 8: Natsoviy711 folded before Flop (didn't bet)
Seat 9: HokageVIP (button) folded before Flop (didn't bet)


*********** # 148 **************
PokerStars Hand #169404674003:  Hold'em No Limit ($0.01/$0.02 USD) - 20=
17/04/23 2:58:44 CUST [2017/04/22 12:58:44 ET]
Table 'Joella' 9-max Seat #8 is the button
Seat 2: the_wickstar ($1.07 in chips)=20
Seat 4: gogu575 ($1.58 in chips)=20
Seat 5: oxxay ($2.59 in chips)=20
Seat 6: No1da ($2.03 in chips)=20
Seat 7: elenkachumak ($0.89 in chips)=20
Seat 8: Natsoviy711 ($1.46 in chips)=20
Seat 9: HokageVIP ($2.01 in chips)=20
HokageVIP: posts small blind $0.01
Darmasa: is sitting out=20
the_wickstar: posts big blind $0.02
*** HOLE CARDS ***
Dealt to the_wickstar [Kd 7h]
gogu575: folds=20
Darmasa leaves the table
oxxay: calls $0.02
No1da: folds=20
elenkachumak: folds=20
Natsoviy711: folds=20
HokageVIP: folds=20
the_wickstar: checks=20
*** FLOP *** [Th 2d 3d]
betao22 joins the table at seat #1=20
the_wickstar: checks=20
oxxay: bets $0.03
the_wickstar: folds=20
Uncalled bet ($0.03) returned to oxxay
oxxay collected $0.05 from pot
oxxay: doesn't show hand=20
*** SUMMARY ***
Total pot $0.05 | Rake $0=20
Board [Th 2d 3d]
Seat 2: the_wickstar (big blind) folded on the Flop
Seat 4: gogu575 folded before Flop (didn't bet)
Seat 5: oxxay collected ($0.05)
Seat 6: No1da folded before Flop (didn't bet)
Seat 7: elenkachumak folded before Flop (didn't bet)
Seat 8: Natsoviy711 (button) folded before Flop (didn't bet)
Seat 9: HokageVIP (small blind) folded before Flop


*********** # 149 **************
PokerStars Hand #169404665566:  Hold'em No Limit ($0.01/$0.02 USD) - 20=
17/04/23 2:58:30 CUST [2017/04/22 12:58:30 ET]
Table 'Enif' 9-max Seat #3 is the button
Seat 1: azrawith ($2 in chips)=20
Seat 2: the_wickstar ($1 in chips)=20
Seat 3: sergey347 ($0.62 in chips)=20
Seat 4: VIOLIST BR ($2.46 in chips)=20
Seat 5: betao22 ($1.76 in chips)=20
Seat 6: Aracidus ($0.72 in chips)=20
Seat 7: humane1ement ($3.62 in chips)=20
Seat 8: Tom13333 ($1.96 in chips)=20
VIOLIST BR: posts small blind $0.01
betao22: posts big blind $0.02
Tom13333: posts small & big blinds $0.03
*** HOLE CARDS ***
Dealt to the_wickstar [4s 7d]
Aracidus: folds=20
humane1ement: folds=20
Tom13333: checks=20
azrawith: raises $0.08 to $0.10
the_wickstar: folds=20
sergey347: folds=20
VIOLIST BR: folds=20
betao22: folds=20
Tom13333: calls $0.08
*** FLOP *** [Th Qh 8s]
Tom13333: checks=20
azrawith: bets $0.15
Tom13333: calls $0.15
*** TURN *** [Th Qh 8s] [Qd]
Tom13333: checks=20
azrawith: checks=20
*** RIVER *** [Th Qh 8s Qd] [6h]
Tom13333: bets $0.14
azrawith: folds=20
Uncalled bet ($0.14) returned to Tom13333
Tom13333 collected $0.52 from pot
Tom13333: doesn't show hand=20
*** SUMMARY ***
Total pot $0.54 | Rake $0.02=20
Board [Th Qh 8s Qd 6h]
Seat 1: azrawith folded on the River
Seat 2: the_wickstar folded before Flop (didn't bet)
Seat 3: sergey347 (button) folded before Flop (didn't bet)
Seat 4: VIOLIST BR (small blind) folded before Flop
Seat 5: betao22 (big blind) folded before Flop
Seat 6: Aracidus folded before Flop (didn't bet)
Seat 7: humane1ement folded before Flop (didn't bet)
Seat 8: Tom13333 collected ($0.52)


*********** # 150 **************
PokerStars Hand #169404653834:  Hold'em No Limit ($0.01/$0.02 USD) - 20=
17/04/23 2:58:11 CUST [2017/04/22 12:58:11 ET]
Table 'Enif' 9-max Seat #2 is the button
Seat 1: azrawith ($2 in chips)=20
Seat 2: the_wickstar ($1 in chips)=20
Seat 3: sergey347 ($0.63 in chips)=20
Seat 4: VIOLIST BR ($2.48 in chips)=20
Seat 6: Aracidus ($0.72 in chips)=20
Seat 7: humane1ement ($3.59 in chips)=20
sergey347: posts small blind $0.01
VIOLIST BR: posts big blind $0.02
Tom13333: sits out=20
*** HOLE CARDS ***
Dealt to the_wickstar [2h 5h]
Aracidus: folds=20
humane1ement: raises $0.04 to $0.06
azrawith: folds=20
the_wickstar: folds=20
betao22 joins the table at seat #5=20
sergey347: folds=20
VIOLIST BR: folds=20
Uncalled bet ($0.04) returned to humane1ement
humane1ement collected $0.05 from pot
humane1ement: doesn't show hand=20
*** SUMMARY ***
Total pot $0.05 | Rake $0=20
Seat 1: azrawith folded before Flop (didn't bet)
Seat 2: the_wickstar (button) folded before Flop (didn't bet)
Seat 3: sergey347 (small blind) folded before Flop
Seat 4: VIOLIST BR (big blind) folded before Flop
Seat 6: Aracidus folded before Flop (didn't bet)
Seat 7: humane1ement collected ($0.05)


*********** # 151 **************
PokerStars Hand #169404651862:  Hold'em No Limit ($0.01/$0.02 USD) - 20=
17/04/23 2:58:08 CUST [2017/04/22 12:58:08 ET]
Table 'Joella' 9-max Seat #7 is the button
Seat 1: Darmasa ($2.03 in chips)=20
Seat 2: the_wickstar ($1.07 in chips)=20
Seat 4: gogu575 ($1.58 in chips)=20
Seat 5: oxxay ($2.59 in chips)=20
Seat 6: No1da ($2 in chips)=20
Seat 7: elenkachumak ($0.89 in chips)=20
Seat 8: Natsoviy711 ($1.47 in chips)=20
Seat 9: HokageVIP ($2.03 in chips)=20
Natsoviy711: posts small blind $0.01
HokageVIP: posts big blind $0.02
*** HOLE CARDS ***
Dealt to the_wickstar [Ts 3c]
Darmasa: folds=20
the_wickstar: folds=20
gogu575: folds=20
oxxay: folds=20
No1da: raises $0.04 to $0.06
elenkachumak: folds=20
Natsoviy711: folds=20
HokageVIP: folds=20
Uncalled bet ($0.04) returned to No1da
No1da collected $0.05 from pot
No1da: doesn't show hand=20
*** SUMMARY ***
Total pot $0.05 | Rake $0=20
Seat 1: Darmasa folded before Flop (didn't bet)
Seat 2: the_wickstar folded before Flop (didn't bet)
Seat 4: gogu575 folded before Flop (didn't bet)
Seat 5: oxxay folded before Flop (didn't bet)
Seat 6: No1da collected ($0.05)
Seat 7: elenkachumak (button) folded before Flop (didn't bet)
Seat 8: Natsoviy711 (small blind) folded before Flop
Seat 9: HokageVIP (big blind) folded before Flop


*********** # 152 **************
PokerStars Hand #169404645159:  Hold'em No Limit ($0.01/$0.02 USD) - 20=
17/04/23 2:57:57 CUST [2017/04/22 12:57:57 ET]
Table 'Enif' 9-max Seat #1 is the button
Seat 1: azrawith ($2 in chips)=20
Seat 2: the_wickstar ($1.01 in chips)=20
Seat 3: sergey347 ($0.62 in chips)=20
Seat 4: VIOLIST BR ($2.48 in chips)=20
Seat 6: Aracidus ($0.72 in chips)=20
Seat 7: humane1ement ($3.59 in chips)=20
the_wickstar: posts small blind $0.01
sergey347: posts big blind $0.02
*** HOLE CARDS ***
Dealt to the_wickstar [8h 4h]
VIOLIST BR: folds=20
Aracidus: folds=20
humane1ement: folds=20
azrawith: folds=20
the_wickstar: folds=20
Uncalled bet ($0.01) returned to sergey347
sergey347 collected $0.02 from pot
sergey347: doesn't show hand=20
*** SUMMARY ***
Total pot $0.02 | Rake $0=20
Seat 1: azrawith (button) folded before Flop (didn't bet)
Seat 2: the_wickstar (small blind) folded before Flop
Seat 3: sergey347 (big blind) collected ($0.02)
Seat 4: VIOLIST BR folded before Flop (didn't bet)
Seat 6: Aracidus folded before Flop (didn't bet)
Seat 7: humane1ement folded before Flop (didn't bet)


*********** # 153 **************
PokerStars Hand #169404642282:  Hold'em No Limit ($0.01/$0.02 USD) - 20=
17/04/23 2:57:52 CUST [2017/04/22 12:57:52 ET]
Table 'Joella' 9-max Seat #6 is the button
Seat 1: Darmasa ($2.03 in chips)=20
Seat 2: the_wickstar ($1.07 in chips)=20
Seat 4: gogu575 ($1.58 in chips)=20
Seat 5: oxxay ($2.59 in chips)=20
Seat 6: No1da ($2 in chips)=20
Seat 7: elenkachumak ($0.90 in chips)=20
Seat 8: Natsoviy711 ($1.46 in chips)=20
Seat 9: HokageVIP ($2.03 in chips)=20
elenkachumak: posts small blind $0.01
Natsoviy711: posts big blind $0.02
*** HOLE CARDS ***
Dealt to the_wickstar [6c Qc]
HokageVIP: folds=20
Darmasa: folds=20
the_wickstar: folds=20
gogu575: folds=20
oxxay: folds=20
No1da: folds=20
elenkachumak: folds=20
Uncalled bet ($0.01) returned to Natsoviy711
Natsoviy711 collected $0.02 from pot
*** SUMMARY ***
Total pot $0.02 | Rake $0=20
Seat 1: Darmasa folded before Flop (didn't bet)
Seat 2: the_wickstar folded before Flop (didn't bet)
Seat 4: gogu575 folded before Flop (didn't bet)
Seat 5: oxxay folded before Flop (didn't bet)
Seat 6: No1da (button) folded before Flop (didn't bet)
Seat 7: elenkachumak (small blind) folded before Flop
Seat 8: Natsoviy711 (big blind) collected ($0.02)
Seat 9: HokageVIP folded before Flop (didn't bet)


*********** # 154 **************
PokerStars Hand #169404629932:  Hold'em No Limit ($0.01/$0.02 USD) - 20=
17/04/23 2:57:32 CUST [2017/04/22 12:57:32 ET]
Table 'Enif' 9-max Seat #7 is the button
Seat 1: azrawith ($2.01 in chips)=20
Seat 2: the_wickstar ($1 in chips)=20
Seat 3: sergey347 ($0.62 in chips)=20
Seat 4: VIOLIST BR ($2.48 in chips)=20
Seat 6: Aracidus ($0.72 in chips)=20
Seat 7: humane1ement ($3.59 in chips)=20
azrawith: posts small blind $0.01
the_wickstar: posts big blind $0.02
*** HOLE CARDS ***
Dealt to the_wickstar [3h 8d]
sergey347: folds=20
VIOLIST BR: folds=20
Aracidus: folds=20
humane1ement: folds=20
azrawith: folds=20
Uncalled bet ($0.01) returned to the_wickstar
the_wickstar collected $0.02 from pot
*** SUMMARY ***
Total pot $0.02 | Rake $0=20
Seat 1: azrawith (small blind) folded before Flop
Seat 2: the_wickstar (big blind) collected ($0.02)
Seat 3: sergey347 folded before Flop (didn't bet)
Seat 4: VIOLIST BR folded before Flop (didn't bet)
Seat 6: Aracidus folded before Flop (didn't bet)
Seat 7: humane1ement (button) folded before Flop (didn't bet)


*********** # 155 **************
PokerStars Hand #169404620996:  Hold'em No Limit ($0.01/$0.02 USD) - 20=
17/04/23 2:57:18 CUST [2017/04/22 12:57:18 ET]
Table 'Joella' 9-max Seat #5 is the button
Seat 1: Darmasa ($2.03 in chips)=20
Seat 2: the_wickstar ($1 in chips)=20
Seat 4: gogu575 ($1.60 in chips)=20
Seat 5: oxxay ($2.61 in chips)=20
Seat 6: No1da ($2.01 in chips)=20
Seat 7: elenkachumak ($0.92 in chips)=20
Seat 8: Natsoviy711 ($1.46 in chips)=20
Seat 9: HokageVIP ($2.03 in chips)=20
No1da: posts small blind $0.01
elenkachumak: posts big blind $0.02
gogu575: posts big blind $0.02
*** HOLE CARDS ***
Dealt to the_wickstar [2d Qs]
Natsoviy711: folds=20
HokageVIP: folds=20
Darmasa: folds=20
the_wickstar: calls $0.02
gogu575: checks=20
oxxay: calls $0.02
No1da: folds=20
elenkachumak: checks=20
*** FLOP *** [5s Ac As]
elenkachumak: checks=20
the_wickstar: bets $0.07
gogu575: folds=20
oxxay: folds=20
elenkachumak: folds=20
Uncalled bet ($0.07) returned to the_wickstar
the_wickstar collected $0.09 from pot
*** SUMMARY ***
Total pot $0.09 | Rake $0=20
Board [5s Ac As]
Seat 1: Darmasa folded before Flop (didn't bet)
Seat 2: the_wickstar collected ($0.09)
Seat 4: gogu575 folded on the Flop
Seat 5: oxxay (button) folded on the Flop
Seat 6: No1da (small blind) folded before Flop
Seat 7: elenkachumak (big blind) folded on the Flop
Seat 8: Natsoviy711 folded before Flop (didn't bet)
Seat 9: HokageVIP folded before Flop (didn't bet)


*********** # 156 **************
PokerStars Hand #169404612560:  Hold'em No Limit ($0.01/$0.02 USD) - 20=
17/04/23 2:57:04 CUST [2017/04/22 12:57:04 ET]
Table 'Joella' 9-max Seat #2 is the button
Seat 1: Darmasa ($2.03 in chips)=20
Seat 2: the_wickstar ($1 in chips)=20
Seat 5: oxxay ($2.62 in chips)=20
Seat 6: No1da ($2 in chips)=20
Seat 7: elenkachumak ($0.92 in chips)=20
Seat 9: HokageVIP ($2.03 in chips)=20
gogu575 will be allowed to play after the button
oxxay: posts small blind $0.01
No1da: posts big blind $0.02
*** HOLE CARDS ***
Dealt to the_wickstar [6d Tc]
elenkachumak: folds=20
HokageVIP: folds=20
Darmasa: folds=20
the_wickstar: folds=20
oxxay: folds=20
Uncalled bet ($0.01) returned to No1da
No1da collected $0.02 from pot
No1da: doesn't show hand=20
*** SUMMARY ***
Total pot $0.02 | Rake $0=20
Seat 1: Darmasa folded before Flop (didn't bet)
Seat 2: the_wickstar (button) folded before Flop (didn't bet)
Seat 5: oxxay (small blind) folded before Flop
Seat 6: No1da (big blind) collected ($0.02)
Seat 7: elenkachumak folded before Flop (didn't bet)
Seat 9: HokageVIP folded before Flop (didn't bet)


*********** # 157 **************
PokerStars Hand #169404574714:  Hold'em No Limit ($0.01/$0.02 USD) - 20=
17/04/23 2:56:02 CUST [2017/04/22 12:56:02 ET]
Table 'Joella' 9-max Seat #1 is the button
Seat 1: Darmasa ($2.09 in chips)=20
Seat 2: the_wickstar ($1.01 in chips)=20
Seat 5: oxxay ($1.97 in chips)=20
Seat 6: No1da ($2.18 in chips)=20
Seat 7: elenkachumak ($0.92 in chips)=20
Seat 9: HokageVIP ($2.03 in chips)=20
the_wickstar: posts small blind $0.01
clasicos: is sitting out=20
oxxay: posts big blind $0.02
*** HOLE CARDS ***
Dealt to the_wickstar [Ks 2d]
clasicos leaves the table
No1da: raises $0.04 to $0.06
elenkachumak: folds=20
HokageVIP: folds=20
Darmasa: calls $0.06
the_wickstar: folds=20
oxxay: calls $0.04
*** FLOP *** [Ac 6d Qh]
oxxay: checks=20
No1da: bets $0.12
Darmasa: folds=20
oxxay: raises $0.12 to $0.24
No1da: calls $0.12
*** TURN *** [Ac 6d Qh] [Qd]
oxxay: checks=20
gogu575 joins the table at seat #4=20
No1da: checks=20
*** RIVER *** [Ac 6d Qh Qd] [6s]
oxxay: bets $0.33
No1da: calls $0.33
*** SHOW DOWN ***
oxxay: shows [6h 6c] (four of a kind, Sixes)
No1da: mucks hand=20
oxxay collected $1.28 from pot
*** SUMMARY ***
Total pot $1.33 | Rake $0.05=20
Board [Ac 6d Qh Qd 6s]
Seat 1: Darmasa (button) folded on the Flop
Seat 2: the_wickstar (small blind) folded before Flop
Seat 5: oxxay (big blind) showed [6h 6c] and won ($1.28) with four of a=
 kind, Sixes
Seat 6: No1da mucked [Ad Td]
Seat 7: elenkachumak folded before Flop (didn't bet)
Seat 9: HokageVIP folded before Flop (didn't bet)


*********** # 158 **************
PokerStars Hand #169404558231:  Hold'em No Limit ($0.01/$0.02 USD) - 20=
17/04/23 2:55:35 CUST [2017/04/22 12:55:35 ET]
Table 'Joella' 9-max Seat #9 is the button
Seat 1: Darmasa ($2.10 in chips)=20
Seat 2: the_wickstar ($1 in chips)=20
Seat 3: ciusen ($1.62 in chips)=20
Seat 4: clasicos ($2.97 in chips)=20
Seat 5: oxxay ($1.97 in chips)=20
Seat 6: No1da ($2.18 in chips)=20
Seat 7: elenkachumak ($0.92 in chips)=20
Seat 9: HokageVIP ($2.03 in chips)=20
Darmasa: posts small blind $0.01
the_wickstar: posts big blind $0.02
*** HOLE CARDS ***
Dealt to the_wickstar [4d 4h]
ciusen: folds=20
clasicos: folds=20
oxxay: folds=20
No1da: folds=20
elenkachumak: folds=20
HokageVIP: folds=20
Darmasa: folds=20
Uncalled bet ($0.01) returned to the_wickstar
the_wickstar collected $0.02 from pot
*** SUMMARY ***
Total pot $0.02 | Rake $0=20
Seat 1: Darmasa (small blind) folded before Flop
Seat 2: the_wickstar (big blind) collected ($0.02)
Seat 3: ciusen folded before Flop (didn't bet)
Seat 4: clasicos folded before Flop (didn't bet)
Seat 5: oxxay folded before Flop (didn't bet)
Seat 6: No1da folded before Flop (didn't bet)
Seat 7: elenkachumak folded before Flop (didn't bet)
Seat 9: HokageVIP (button) folded before Flop (didn't bet)


*********** # 159 **************
PokerStars Hand #169399954629:  Hold'em No Limit ($0.01/$0.02 USD) - 20=
17/04/23 1:10:07 CUST [2017/04/22 11:10:07 ET]
Table 'Imperatrix' 9-max Seat #4 is the button
Seat 1: holderville ($2.70 in chips)=20
Seat 2: Comra1d ($2.04 in chips)=20
Seat 3: IceAngel82 ($2 in chips)=20
Seat 4: zsermano ($2.93 in chips)=20
Seat 5: romanius04 ($2.36 in chips)=20
Seat 6: the_wickstar ($2.11 in chips)=20
Seat 7: kaisukezz ($2.19 in chips)=20
Seat 8: FanLi ($2.14 in chips)=20
Seat 9: dlolo30 ($1.97 in chips)=20
romanius04: posts small blind $0.01
the_wickstar: posts big blind $0.02
*** HOLE CARDS ***
Dealt to the_wickstar [Qh 9h]
kaisukezz: folds=20
FanLi: folds=20
dlolo30: folds=20
holderville: folds=20
Comra1d: folds=20
IceAngel82: folds=20
zsermano: calls $0.02
romanius04: folds=20
the_wickstar: checks=20
*** FLOP *** [6d Jc 5d]
the_wickstar: checks=20
zsermano: bets $0.02
the_wickstar: calls $0.02
*** TURN *** [6d Jc 5d] [4h]
the_wickstar: checks=20
zsermano: bets $0.02
the_wickstar: raises $0.07 to $0.09
zsermano: folds=20
Uncalled bet ($0.07) returned to the_wickstar
the_wickstar collected $0.13 from pot
*** SUMMARY ***
Total pot $0.13 | Rake $0=20
Board [6d Jc 5d 4h]
Seat 1: holderville folded before Flop (didn't bet)
Seat 2: Comra1d folded before Flop (didn't bet)
Seat 3: IceAngel82 folded before Flop (didn't bet)
Seat 4: zsermano (button) folded on the Turn
Seat 5: romanius04 (small blind) folded before Flop
Seat 6: the_wickstar (big blind) collected ($0.13)
Seat 7: kaisukezz folded before Flop (didn't bet)
Seat 8: FanLi folded before Flop (didn't bet)
Seat 9: dlolo30 folded before Flop (didn't bet)


*********** # 160 **************
PokerStars Hand #169399910181:  Hold'em No Limit ($0.01/$0.02 USD) - 20=
17/04/23 1:09:02 CUST [2017/04/22 11:09:02 ET]
Table 'Imperatrix' 9-max Seat #3 is the button
Seat 1: holderville ($2.70 in chips)=20
Seat 2: Comra1d ($2.04 in chips)=20
Seat 3: IceAngel82 ($2 in chips)=20
Seat 4: zsermano ($2.89 in chips)=20
Seat 5: romanius04 ($2.38 in chips)=20
Seat 6: the_wickstar ($2.13 in chips)=20
Seat 7: kaisukezz ($2.19 in chips)=20
Seat 8: FanLi ($2.14 in chips)=20
Seat 9: dlolo30 ($1.97 in chips)=20
zsermano: posts small blind $0.01
romanius04: posts big blind $0.02
*** HOLE CARDS ***
Dealt to the_wickstar [Kh Jh]
the_wickstar: calls $0.02
kaisukezz: folds=20
FanLi: folds=20
dlolo30: folds=20
holderville: folds=20
Comra1d: folds=20
IceAngel82: folds=20
zsermano: calls $0.01
romanius04: checks=20
*** FLOP *** [7d 8s 3h]
zsermano: checks=20
romanius04: checks=20
the_wickstar: checks=20
*** TURN *** [7d 8s 3h] [8d]
zsermano: bets $0.02
romanius04: folds=20
the_wickstar: folds=20
Uncalled bet ($0.02) returned to zsermano
zsermano collected $0.06 from pot
*** SUMMARY ***
Total pot $0.06 | Rake $0=20
Board [7d 8s 3h 8d]
Seat 1: holderville folded before Flop (didn't bet)
Seat 2: Comra1d folded before Flop (didn't bet)
Seat 3: IceAngel82 (button) folded before Flop (didn't bet)
Seat 4: zsermano (small blind) collected ($0.06)
Seat 5: romanius04 (big blind) folded on the Turn
Seat 6: the_wickstar folded on the Turn
Seat 7: kaisukezz folded before Flop (didn't bet)
Seat 8: FanLi folded before Flop (didn't bet)
Seat 9: dlolo30 folded before Flop (didn't bet)


*********** # 161 **************
PokerStars Hand #169399885413:  Hold'em No Limit ($0.01/$0.02 USD) - 20=
17/04/23 1:08:26 CUST [2017/04/22 11:08:26 ET]
Table 'Imperatrix' 9-max Seat #2 is the button
Seat 1: holderville ($2.70 in chips)=20
Seat 2: Comra1d ($2.04 in chips)=20
Seat 3: IceAngel82 ($2 in chips)=20
Seat 4: zsermano ($2.91 in chips)=20
Seat 5: romanius04 ($2.38 in chips)=20
Seat 6: the_wickstar ($2.13 in chips)=20
Seat 7: kaisukezz ($2.19 in chips)=20
Seat 8: FanLi ($2.11 in chips)=20
Seat 9: dlolo30 ($1.97 in chips)=20
IceAngel82: posts small blind $0.01
zsermano: posts big blind $0.02
*** HOLE CARDS ***
Dealt to the_wickstar [3c 4s]
romanius04: folds=20
the_wickstar: folds=20
kaisukezz: folds=20
FanLi: raises $0.04 to $0.06
dlolo30: folds=20
holderville: folds=20
Comra1d: folds=20
IceAngel82: folds=20
zsermano: folds=20
Uncalled bet ($0.04) returned to FanLi
FanLi collected $0.05 from pot
FanLi: doesn't show hand=20
*** SUMMARY ***
Total pot $0.05 | Rake $0=20
Seat 1: holderville folded before Flop (didn't bet)
Seat 2: Comra1d (button) folded before Flop (didn't bet)
Seat 3: IceAngel82 (small blind) folded before Flop
Seat 4: zsermano (big blind) folded before Flop
Seat 5: romanius04 folded before Flop (didn't bet)
Seat 6: the_wickstar folded before Flop (didn't bet)
Seat 7: kaisukezz folded before Flop (didn't bet)
Seat 8: FanLi collected ($0.05)
Seat 9: dlolo30 folded before Flop (didn't bet)


*********** # 162 **************
PokerStars Hand #169399829843:  Hold'em No Limit ($0.01/$0.02 USD) - 20=
17/04/23 1:07:05 CUST [2017/04/22 11:07:05 ET]
Table 'Imperatrix' 9-max Seat #1 is the button
Seat 1: holderville ($2.70 in chips)=20
Seat 2: Comra1d ($2.05 in chips)=20
Seat 3: IceAngel82 ($2 in chips)=20
Seat 4: zsermano ($3.29 in chips)=20
Seat 5: romanius04 ($2 in chips)=20
Seat 6: the_wickstar ($2.13 in chips)=20
Seat 7: kaisukezz ($2.19 in chips)=20
Seat 8: FanLi ($2.11 in chips)=20
Seat 9: dlolo30 ($1.97 in chips)=20
Comra1d: posts small blind $0.01
IceAngel82: posts big blind $0.02
*** HOLE CARDS ***
Dealt to the_wickstar [Ks 7h]
zsermano: calls $0.02
romanius04: raises $0.04 to $0.06
the_wickstar: folds=20
kaisukezz: folds=20
FanLi: folds=20
dlolo30: folds=20
holderville: folds=20
Comra1d: folds=20
IceAngel82: folds=20
zsermano: calls $0.04
*** FLOP *** [Kc 5d Tc]
zsermano: bets $0.04
romanius04: calls $0.04
*** TURN *** [Kc 5d Tc] [2c]
zsermano: bets $0.08
romanius04: calls $0.08
*** RIVER *** [Kc 5d Tc 2c] [6h]
zsermano: bets $0.08
romanius04: raises $0.12 to $0.20
zsermano: calls $0.12
*** SHOW DOWN ***
romanius04: shows [Ts Td] (three of a kind, Tens)
zsermano: mucks hand=20
romanius04 collected $0.76 from pot
*** SUMMARY ***
Total pot $0.79 | Rake $0.03=20
Board [Kc 5d Tc 2c 6h]
Seat 1: holderville (button) folded before Flop (didn't bet)
Seat 2: Comra1d (small blind) folded before Flop
Seat 3: IceAngel82 (big blind) folded before Flop
Seat 4: zsermano mucked [Kh 2h]
Seat 5: romanius04 showed [Ts Td] and won ($0.76) with three of a kind,=
 Tens
Seat 6: the_wickstar folded before Flop (didn't bet)
Seat 7: kaisukezz folded before Flop (didn't bet)
Seat 8: FanLi folded before Flop (didn't bet)
Seat 9: dlolo30 folded before Flop (didn't bet)


*********** # 163 **************
PokerStars Hand #169399806562:  Hold'em No Limit ($0.01/$0.02 USD) - 20=
17/04/23 1:06:32 CUST [2017/04/22 11:06:32 ET]
Table 'Imperatrix' 9-max Seat #9 is the button
Seat 1: holderville ($2.71 in chips)=20
Seat 2: Comra1d ($2.07 in chips)=20
Seat 3: IceAngel82 ($2 in chips)=20
Seat 4: zsermano ($3.29 in chips)=20
Seat 5: romanius04 ($2 in chips)=20
Seat 6: the_wickstar ($2.10 in chips)=20
Seat 7: kaisukezz ($2.19 in chips)=20
Seat 8: FanLi ($2.11 in chips)=20
Seat 9: dlolo30 ($1.97 in chips)=20
holderville: posts small blind $0.01
Comra1d: posts big blind $0.02
*** HOLE CARDS ***
Dealt to the_wickstar [Qd Ac]
IceAngel82: folds=20
zsermano: folds=20
romanius04: folds=20
the_wickstar: raises $0.04 to $0.06
kaisukezz: folds=20
FanLi: folds=20
dlolo30: folds=20
holderville: folds=20
Comra1d: folds=20
Uncalled bet ($0.04) returned to the_wickstar
the_wickstar collected $0.05 from pot
*** SUMMARY ***
Total pot $0.05 | Rake $0=20
Seat 1: holderville (small blind) folded before Flop
Seat 2: Comra1d (big blind) folded before Flop
Seat 3: IceAngel82 folded before Flop (didn't bet)
Seat 4: zsermano folded before Flop (didn't bet)
Seat 5: romanius04 folded before Flop (didn't bet)
Seat 6: the_wickstar collected ($0.05)
Seat 7: kaisukezz folded before Flop (didn't bet)
Seat 8: FanLi folded before Flop (didn't bet)
Seat 9: dlolo30 (button) folded before Flop (didn't bet)


*********** # 164 **************
PokerStars Hand #169399730612:  Hold'em No Limit ($0.01/$0.02 USD) - 20=
17/04/23 1:04:41 CUST [2017/04/22 11:04:41 ET]
Table 'Imperatrix' 9-max Seat #8 is the button
Seat 1: holderville ($2.82 in chips)=20
Seat 2: Comra1d ($2.07 in chips)=20
Seat 3: IceAngel82 ($2 in chips)=20
Seat 4: zsermano ($3.29 in chips)=20
Seat 5: romanius04 ($2 in chips)=20
Seat 6: the_wickstar ($2.10 in chips)=20
Seat 7: kaisukezz ($2.19 in chips)=20
Seat 8: FanLi ($2 in chips)=20
Seat 9: dlolo30 ($1.98 in chips)=20
dlolo30: posts small blind $0.01
holderville: posts big blind $0.02
*** HOLE CARDS ***
Dealt to the_wickstar [4c 2d]
Comra1d: folds=20
IceAngel82: folds=20
zsermano: folds=20
romanius04: folds=20
the_wickstar: folds=20
kaisukezz: folds=20
FanLi: raises $0.03 to $0.05
dlolo30: folds=20
holderville: calls $0.03
*** FLOP *** [8s 5d 2c]
holderville: checks=20
FanLi: checks=20
*** TURN *** [8s 5d 2c] [9h]
holderville: checks=20
FanLi: checks=20
*** RIVER *** [8s 5d 2c 9h] [Qs]
holderville: checks=20
FanLi: bets $0.06
holderville: calls $0.06
*** SHOW DOWN ***
FanLi: shows [Jh Tc] (a straight, Eight to Queen)
holderville: mucks hand=20
FanLi collected $0.22 from pot
*** SUMMARY ***
Total pot $0.23 | Rake $0.01=20
Board [8s 5d 2c 9h Qs]
Seat 1: holderville (big blind) mucked [9s Kh]
Seat 2: Comra1d folded before Flop (didn't bet)
Seat 3: IceAngel82 folded before Flop (didn't bet)
Seat 4: zsermano folded before Flop (didn't bet)
Seat 5: romanius04 folded before Flop (didn't bet)
Seat 6: the_wickstar folded before Flop (didn't bet)
Seat 7: kaisukezz folded before Flop (didn't bet)
Seat 8: FanLi (button) showed [Jh Tc] and won ($0.22) with a straight, =
Eight to Queen
Seat 9: dlolo30 (small blind) folded before Flop


*********** # 165 **************
PokerStars Hand #169399705345:  Hold'em No Limit ($0.01/$0.02 USD) - 20=
17/04/23 1:04:05 CUST [2017/04/22 11:04:05 ET]
Table 'Imperatrix' 9-max Seat #7 is the button
Seat 1: holderville ($2.82 in chips)=20
Seat 2: Comra1d ($2.07 in chips)=20
Seat 3: IceAngel82 ($2 in chips)=20
Seat 4: zsermano ($3.29 in chips)=20
Seat 5: romanius04 ($2 in chips)=20
Seat 6: the_wickstar ($2.07 in chips)=20
Seat 7: kaisukezz ($2.19 in chips)=20
Seat 8: FanLi ($2 in chips)=20
Seat 9: dlolo30 ($2 in chips)=20
FanLi: posts small blind $0.01
dlolo30: posts big blind $0.02
*** HOLE CARDS ***
Dealt to the_wickstar [Kd Qd]
holderville: folds=20
Comra1d: folds=20
IceAngel82: folds=20
zsermano: folds=20
romanius04: folds=20
the_wickstar: raises $0.02 to $0.04
kaisukezz: folds=20
FanLi: folds=20
dlolo30: folds=20
Uncalled bet ($0.02) returned to the_wickstar
the_wickstar collected $0.05 from pot
*** SUMMARY ***
Total pot $0.05 | Rake $0=20
Seat 1: holderville folded before Flop (didn't bet)
Seat 2: Comra1d folded before Flop (didn't bet)
Seat 3: IceAngel82 folded before Flop (didn't bet)
Seat 4: zsermano folded before Flop (didn't bet)
Seat 5: romanius04 folded before Flop (didn't bet)
Seat 6: the_wickstar collected ($0.05)
Seat 7: kaisukezz (button) folded before Flop (didn't bet)
Seat 8: FanLi (small blind) folded before Flop
Seat 9: dlolo30 (big blind) folded before Flop


*********** # 166 **************
PokerStars Hand #169399643186:  Hold'em No Limit ($0.01/$0.02 USD) - 20=
17/04/23 1:02:34 CUST [2017/04/22 11:02:34 ET]
Table 'Imperatrix' 9-max Seat #6 is the button
Seat 1: holderville ($2.82 in chips)=20
Seat 2: Comra1d ($2.07 in chips)=20
Seat 3: IceAngel82 ($2 in chips)=20
Seat 4: zsermano ($3.29 in chips)=20
Seat 5: romanius04 ($2 in chips)=20
Seat 6: the_wickstar ($1.99 in chips)=20
Seat 7: kaisukezz ($2.20 in chips)=20
Seat 8: FanLi ($2 in chips)=20
Seat 9: aivenbh ($1.91 in chips)=20
kaisukezz: posts small blind $0.01
FanLi: posts big blind $0.02
*** HOLE CARDS ***
Dealt to the_wickstar [6s 8d]
aivenbh: folds=20
holderville: folds=20
aivenbh leaves the table
dlolo30 joins the table at seat #9=20
Comra1d: folds=20
IceAngel82: folds=20
zsermano: folds=20
romanius04: folds=20
the_wickstar: calls $0.02
kaisukezz: folds=20
FanLi: checks=20
*** FLOP *** [Td 7h 6c]
FanLi: checks=20
the_wickstar: checks=20
*** TURN *** [Td 7h 6c] [9s]
FanLi: bets $0.03
the_wickstar: raises $0.03 to $0.06
FanLi: calls $0.03
*** RIVER *** [Td 7h 6c 9s] [Ks]
FanLi: checks=20
the_wickstar: bets $0.08
FanLi: folds=20
Uncalled bet ($0.08) returned to the_wickstar
the_wickstar collected $0.16 from pot
*** SUMMARY ***
Total pot $0.17 | Rake $0.01=20
Board [Td 7h 6c 9s Ks]
Seat 1: holderville folded before Flop (didn't bet)
Seat 2: Comra1d folded before Flop (didn't bet)
Seat 3: IceAngel82 folded before Flop (didn't bet)
Seat 4: zsermano folded before Flop (didn't bet)
Seat 5: romanius04 folded before Flop (didn't bet)
Seat 6: the_wickstar (button) collected ($0.16)
Seat 7: kaisukezz (small blind) folded before Flop
Seat 8: FanLi (big blind) folded on the River
Seat 9: aivenbh folded before Flop (didn't bet)


*********** # 167 **************
PokerStars Hand #169399635141:  Hold'em No Limit ($0.01/$0.02 USD) - 20=
17/04/23 1:02:22 CUST [2017/04/22 11:02:22 ET]
Table 'Ottilia' 9-max Seat #3 is the button
Seat 2: Medet Isk ($1.60 in chips)=20
Seat 3: s74nitro ($2 in chips)=20
Seat 4: Forseti07 ($2.03 in chips)=20
Seat 6: costica1949 ($2.29 in chips)=20
Seat 7: the_wickstar ($1.98 in chips)=20
Seat 8: CherT678 ($2 in chips)=20
Seat 9: TONIELSE ($3.72 in chips)=20
Forseti07: posts small blind $0.01
costica1949: posts big blind $0.02
Wypka88: sits out=20
*** HOLE CARDS ***
Dealt to the_wickstar [9c Ks]
the_wickstar: folds=20
CherT678: folds=20
the_wickstar leaves the table
TONIELSE: folds=20
Medet Isk: calls $0.02
s74nitro: folds=20
Forseti07: calls $0.01
costica1949: checks=20
*** FLOP *** [Jh 9d 7h]
Forseti07: checks=20
costica1949: checks=20
Medet Isk: checks=20
*** TURN *** [Jh 9d 7h] [6c]
Forseti07: checks=20
costica1949: checks=20
Medet Isk: checks=20
*** RIVER *** [Jh 9d 7h 6c] [4h]
Forseti07: checks=20
costica1949: checks=20
Medet Isk: bets $0.02
Forseti07: folds=20
costica1949: calls $0.02
*** SHOW DOWN ***
Medet Isk: shows [Kh 4c] (a pair of Fours)
costica1949: shows [6s Ts] (a pair of Sixes)
costica1949 collected $0.10 from pot
*** SUMMARY ***
Total pot $0.10 | Rake $0=20
Board [Jh 9d 7h 6c 4h]
Seat 2: Medet Isk showed [Kh 4c] and lost with a pair of Fours
Seat 3: s74nitro (button) folded before Flop (didn't bet)
Seat 4: Forseti07 (small blind) folded on the River
Seat 6: costica1949 (big blind) showed [6s Ts] and won ($0.10) with a p=
air of Sixes
Seat 7: the_wickstar folded before Flop (didn't bet)
Seat 8: CherT678 folded before Flop (didn't bet)
Seat 9: TONIELSE folded before Flop (didn't bet)


*********** # 168 **************
PokerStars Hand #169399602321:  Hold'em No Limit ($0.01/$0.02 USD) - 20=
17/04/23 1:01:34 CUST [2017/04/22 11:01:34 ET]
Table 'Imperatrix' 9-max Seat #5 is the button
Seat 1: holderville ($2.82 in chips)=20
Seat 2: Comra1d ($2 in chips)=20
Seat 3: IceAngel82 ($2 in chips)=20
Seat 4: zsermano ($3.29 in chips)=20
Seat 5: romanius04 ($2 in chips)=20
Seat 6: the_wickstar ($2 in chips)=20
Seat 7: kaisukezz ($2.26 in chips)=20
Seat 9: aivenbh ($1.91 in chips)=20
the_wickstar: posts small blind $0.01
kaisukezz: posts big blind $0.02
FanLi: sits out=20
*** HOLE CARDS ***
Dealt to the_wickstar [2h Kc]
aivenbh: folds=20
holderville: folds=20
Comra1d: raises $0.04 to $0.06
IceAngel82: folds=20
zsermano: folds=20
romanius04: folds=20
the_wickstar: folds=20
kaisukezz: calls $0.04
*** FLOP *** [Ad 5d 8c]
kaisukezz: checks=20
Comra1d: bets $0.09
kaisukezz: folds=20
Uncalled bet ($0.09) returned to Comra1d
Comra1d collected $0.13 from pot
Comra1d: doesn't show hand=20
*** SUMMARY ***
Total pot $0.13 | Rake $0=20
Board [Ad 5d 8c]
Seat 1: holderville folded before Flop (didn't bet)
Seat 2: Comra1d collected ($0.13)
Seat 3: IceAngel82 folded before Flop (didn't bet)
Seat 4: zsermano folded before Flop (didn't bet)
Seat 5: romanius04 (button) folded before Flop (didn't bet)
Seat 6: the_wickstar (small blind) folded before Flop
Seat 7: kaisukezz (big blind) folded on the Flop
Seat 9: aivenbh folded before Flop (didn't bet)


*********** # 169 **************
PokerStars Hand #169399594941:  Hold'em No Limit ($0.01/$0.02 USD) - 20=
17/04/23 1:01:23 CUST [2017/04/22 11:01:23 ET]
Table 'Ottilia' 9-max Seat #2 is the button
Seat 2: Medet Isk ($1.62 in chips)=20
Seat 3: s74nitro ($2 in chips)=20
Seat 4: Forseti07 ($2 in chips)=20
Seat 6: costica1949 ($2.29 in chips)=20
Seat 7: the_wickstar ($1.98 in chips)=20
Seat 8: CherT678 ($2 in chips)=20
Seat 9: TONIELSE ($3.72 in chips)=20
s74nitro: posts small blind $0.01
Forseti07: posts big blind $0.02
Wypka88: sits out=20
*** HOLE CARDS ***
Dealt to the_wickstar [4c Jh]
costica1949: folds=20
the_wickstar: folds=20
CherT678: folds=20
TONIELSE: folds=20
Medet Isk: calls $0.02
s74nitro has timed out
s74nitro: folds=20
Forseti07: checks=20
*** FLOP *** [6c Kh 7h]
Forseti07: bets $0.04
Medet Isk: folds=20
Uncalled bet ($0.04) returned to Forseti07
Forseti07 collected $0.05 from pot
Forseti07: doesn't show hand=20
*** SUMMARY ***
Total pot $0.05 | Rake $0=20
Board [6c Kh 7h]
Seat 2: Medet Isk (button) folded on the Flop
Seat 3: s74nitro (small blind) folded before Flop
Seat 4: Forseti07 (big blind) collected ($0.05)
Seat 6: costica1949 folded before Flop (didn't bet)
Seat 7: the_wickstar folded before Flop (didn't bet)
Seat 8: CherT678 folded before Flop (didn't bet)
Seat 9: TONIELSE folded before Flop (didn't bet)


*********** # 170 **************
PokerStars Hand #169399582483:  Hold'em No Limit ($0.01/$0.02 USD) - 20=
17/04/23 1:01:04 CUST [2017/04/22 11:01:04 ET]
Table 'Imperatrix' 9-max Seat #4 is the button
Seat 1: holderville ($2.82 in chips)=20
Seat 2: Comra1d ($2 in chips)=20
Seat 3: IceAngel82 ($2 in chips)=20
Seat 4: zsermano ($3.29 in chips)=20
Seat 5: romanius04 ($2 in chips)=20
Seat 6: the_wickstar ($1.99 in chips)=20
Seat 7: kaisukezz ($2.26 in chips)=20
Seat 9: aivenbh ($1.91 in chips)=20
romanius04: posts small blind $0.01
the_wickstar: posts big blind $0.02
FanLi: sits out=20
*** HOLE CARDS ***
Dealt to the_wickstar [6s 8s]
kaisukezz: folds=20
aivenbh: folds=20
holderville: folds=20
Comra1d: folds=20
IceAngel82: folds=20
zsermano: folds=20
romanius04: folds=20
Uncalled bet ($0.01) returned to the_wickstar
the_wickstar collected $0.02 from pot
*** SUMMARY ***
Total pot $0.02 | Rake $0=20
Seat 1: holderville folded before Flop (didn't bet)
Seat 2: Comra1d folded before Flop (didn't bet)
Seat 3: IceAngel82 folded before Flop (didn't bet)
Seat 4: zsermano (button) folded before Flop (didn't bet)
Seat 5: romanius04 (small blind) folded before Flop
Seat 6: the_wickstar (big blind) collected ($0.02)
Seat 7: kaisukezz folded before Flop (didn't bet)
Seat 9: aivenbh folded before Flop (didn't bet)


*********** # 171 **************
PokerStars Hand #169399562158:  Hold'em No Limit ($0.01/$0.02 USD) - 20=
17/04/23 1:00:31 CUST [2017/04/22 11:00:31 ET]
Table 'Ottilia' 9-max Seat #9 is the button
Seat 2: Medet Isk ($1.63 in chips)=20
Seat 3: s74nitro ($2 in chips)=20
Seat 6: costica1949 ($2.29 in chips)=20
Seat 7: the_wickstar ($2 in chips)=20
Seat 8: CherT678 ($2 in chips)=20
Seat 9: TONIELSE ($3.67 in chips)=20
Wypka88 will be allowed to play after the button
Medet Isk: posts small blind $0.01
s74nitro: posts big blind $0.02
Forseti07: sits out=20
*** HOLE CARDS ***
Dealt to the_wickstar [Td Qd]
costica1949: folds=20
the_wickstar: calls $0.02
CherT678: folds=20
TONIELSE: raises $0.08 to $0.10
Medet Isk: folds=20
s74nitro: folds=20
the_wickstar said, "pairs?"
the_wickstar: folds=20
Uncalled bet ($0.08) returned to TONIELSE
TONIELSE collected $0.07 from pot
TONIELSE: doesn't show hand=20
*** SUMMARY ***
Total pot $0.07 | Rake $0=20
Seat 2: Medet Isk (small blind) folded before Flop
Seat 3: s74nitro (big blind) folded before Flop
Seat 6: costica1949 folded before Flop (didn't bet)
Seat 7: the_wickstar folded before Flop
Seat 8: CherT678 folded before Flop (didn't bet)
Seat 9: TONIELSE (button) collected ($0.07)


*********** # 172 **************
PokerStars Hand #169399542806:  Hold'em No Limit ($0.01/$0.02 USD) - 20=
17/04/23 1:00:00 CUST [2017/04/22 11:00:00 ET]
Table 'Imperatrix' 9-max Seat #3 is the button
Seat 1: holderville ($2.82 in chips)=20
Seat 2: Comra1d ($2 in chips)=20
Seat 3: IceAngel82 ($2 in chips)=20
Seat 4: zsermano ($3.21 in chips)=20
Seat 5: romanius04 ($2 in chips)=20
Seat 6: the_wickstar ($2.01 in chips)=20
Seat 7: kaisukezz ($2.26 in chips)=20
Seat 9: aivenbh ($1.91 in chips)=20
zsermano: posts small blind $0.01
romanius04: posts big blind $0.02
FanLi: sits out=20
*** HOLE CARDS ***
Dealt to the_wickstar [8h 9c]
the_wickstar: calls $0.02
kaisukezz: folds=20
aivenbh: folds=20
holderville: folds=20
Comra1d: folds=20
IceAngel82: folds=20
zsermano: calls $0.01
romanius04: raises $0.04 to $0.06
the_wickstar: folds=20
zsermano: calls $0.04
*** FLOP *** [6s Kc Kh]
zsermano: bets $0.04
romanius04: folds=20
Uncalled bet ($0.04) returned to zsermano
zsermano collected $0.14 from pot
*** SUMMARY ***
Total pot $0.14 | Rake $0=20
Board [6s Kc Kh]
Seat 1: holderville folded before Flop (didn't bet)
Seat 2: Comra1d folded before Flop (didn't bet)
Seat 3: IceAngel82 (button) folded before Flop (didn't bet)
Seat 4: zsermano (small blind) collected ($0.14)
Seat 5: romanius04 (big blind) folded on the Flop
Seat 6: the_wickstar folded before Flop
Seat 7: kaisukezz folded before Flop (didn't bet)
Seat 9: aivenbh folded before Flop (didn't bet)


*********** # 173 **************
PokerStars Hand #169399514891:  Hold'em No Limit ($0.01/$0.02 USD) - 20=
17/04/23 0:59:13 CUST [2017/04/22 10:59:13 ET]
Table 'Ottilia' 9-max Seat #8 is the button
Seat 2: Medet Isk ($1.69 in chips)=20
Seat 3: s74nitro ($2 in chips)=20
Seat 6: costica1949 ($2.29 in chips)=20
Seat 7: the_wickstar ($1.93 in chips)=20
Seat 8: CherT678 ($2 in chips)=20
Seat 9: TONIELSE ($3.68 in chips)=20
TONIELSE: posts small blind $0.01
Medet Isk: posts big blind $0.02
Forseti07: sits out=20
*** HOLE CARDS ***
Dealt to the_wickstar [3d Kh]
s74nitro: folds=20
costica1949: folds=20
the_wickstar: calls $0.02
CherT678: folds=20
TONIELSE: folds=20
Medet Isk: checks=20
*** FLOP *** [Ts Qc Jc]
Medet Isk: bets $0.02
the_wickstar: calls $0.02
*** TURN *** [Ts Qc Jc] [Ad]
Medet Isk: bets $0.02
the_wickstar: raises $0.07 to $0.09
Medet Isk: folds=20
Uncalled bet ($0.07) returned to the_wickstar
the_wickstar collected $0.13 from pot
*** SUMMARY ***
Total pot $0.13 | Rake $0=20
Board [Ts Qc Jc Ad]
Seat 2: Medet Isk (big blind) folded on the Turn
Seat 3: s74nitro folded before Flop (didn't bet)
Seat 6: costica1949 folded before Flop (didn't bet)
Seat 7: the_wickstar collected ($0.13)
Seat 8: CherT678 (button) folded before Flop (didn't bet)
Seat 9: TONIELSE (small blind) folded before Flop


*********** # 174 **************
PokerStars Hand #169399489458:  Hold'em No Limit ($0.01/$0.02 USD) - 20=
17/04/23 0:58:29 CUST [2017/04/22 10:58:29 ET]
Table 'Imperatrix' 9-max Seat #2 is the button
Seat 1: holderville ($2.82 in chips)=20
Seat 2: Comra1d ($2 in chips)=20
Seat 3: IceAngel82 ($2 in chips)=20
Seat 4: zsermano ($3.27 in chips)=20
Seat 5: romanius04 ($2 in chips)=20
Seat 6: the_wickstar ($1.93 in chips)=20
Seat 7: kaisukezz ($2.26 in chips)=20
Seat 9: aivenbh ($1.91 in chips)=20
IceAngel82: posts small blind $0.01
zsermano: posts big blind $0.02
FanLi: sits out=20
*** HOLE CARDS ***
Dealt to the_wickstar [Ad 7d]
romanius04: folds=20
the_wickstar: calls $0.02
kaisukezz: folds=20
aivenbh: folds=20
holderville: folds=20
Comra1d: folds=20
IceAngel82: calls $0.01
zsermano: checks=20
*** FLOP *** [As Qs 4c]
IceAngel82: checks=20
zsermano: bets $0.02
the_wickstar: raises $0.02 to $0.04
IceAngel82: folds=20
zsermano: calls $0.02
*** TURN *** [As Qs 4c] [Jd]
zsermano: checks=20
the_wickstar: bets $0.10
zsermano: folds=20
Uncalled bet ($0.10) returned to the_wickstar
the_wickstar collected $0.14 from pot
*** SUMMARY ***
Total pot $0.14 | Rake $0=20
Board [As Qs 4c Jd]
Seat 1: holderville folded before Flop (didn't bet)
Seat 2: Comra1d (button) folded before Flop (didn't bet)
Seat 3: IceAngel82 (small blind) folded on the Flop
Seat 4: zsermano (big blind) folded on the Turn
Seat 5: romanius04 folded before Flop (didn't bet)
Seat 6: the_wickstar collected ($0.14)
Seat 7: kaisukezz folded before Flop (didn't bet)
Seat 9: aivenbh folded before Flop (didn't bet)


*********** # 175 **************
PokerStars Hand #169399469469:  Hold'em No Limit ($0.01/$0.02 USD) - 20=
17/04/23 0:57:56 CUST [2017/04/22 10:57:56 ET]
Table 'Ottilia' 9-max Seat #7 is the button
Seat 2: Medet Isk ($1.71 in chips)=20
Seat 3: s74nitro ($2 in chips)=20
Seat 6: costica1949 ($2.29 in chips)=20
Seat 7: the_wickstar ($1.76 in chips)=20
Seat 8: CherT678 ($2.01 in chips)=20
Seat 9: TONIELSE ($3.70 in chips)=20
CherT678: posts small blind $0.01
TONIELSE: posts big blind $0.02
*** HOLE CARDS ***
Dealt to the_wickstar [9s 3h]
Medet Isk: calls $0.02
s74nitro: folds=20
costica1949: folds=20
the_wickstar: calls $0.02
CherT678: calls $0.01
TONIELSE: checks=20
*** FLOP *** [9h 3d Ts]
CherT678: bets $0.06
TONIELSE: folds=20
Medet Isk: folds=20
Forseti07 joins the table at seat #4=20
the_wickstar: raises $0.06 to $0.12
CherT678: calls $0.06
*** TURN *** [9h 3d Ts] [8c]
CherT678: checks=20
the_wickstar: bets $0.31
CherT678: folds=20
Uncalled bet ($0.31) returned to the_wickstar
the_wickstar collected $0.31 from pot
*** SUMMARY ***
Total pot $0.32 | Rake $0.01=20
Board [9h 3d Ts 8c]
Seat 2: Medet Isk folded on the Flop
Seat 3: s74nitro folded before Flop (didn't bet)
Seat 6: costica1949 folded before Flop (didn't bet)
Seat 7: the_wickstar (button) collected ($0.31)
Seat 8: CherT678 (small blind) folded on the Turn
Seat 9: TONIELSE (big blind) folded on the Flop


*********** # 176 **************
PokerStars Hand #169399446334:  Hold'em No Limit ($0.01/$0.02 USD) - 20=
17/04/23 0:57:16 CUST [2017/04/22 10:57:16 ET]
Table 'Imperatrix' 9-max Seat #1 is the button
Seat 1: holderville ($2.82 in chips)=20
Seat 2: Comra1d ($2 in chips)=20
Seat 3: IceAngel82 ($2 in chips)=20
Seat 4: zsermano ($3.27 in chips)=20
Seat 5: romanius04 ($2 in chips)=20
Seat 6: the_wickstar ($1.93 in chips)=20
Seat 7: kaisukezz ($2.03 in chips)=20
Seat 9: aivenbh ($1.91 in chips)=20
Comra1d: posts small blind $0.01
IceAngel82: posts big blind $0.02
FanLi: sits out=20
*** HOLE CARDS ***
Dealt to the_wickstar [3h As]
zsermano: folds=20
romanius04: raises $0.04 to $0.06
the_wickstar: folds=20
kaisukezz: calls $0.06
aivenbh: folds=20
holderville: folds=20
Comra1d: folds=20
IceAngel82: calls $0.04
*** FLOP *** [9c Jc Qh]
IceAngel82: checks=20
romanius04: checks=20
kaisukezz: bets $0.11
IceAngel82: calls $0.11
romanius04: folds=20
*** TURN *** [9c Jc Qh] [4d]
IceAngel82: checks=20
kaisukezz: checks=20
*** RIVER *** [9c Jc Qh 4d] [Qd]
IceAngel82: checks=20
kaisukezz: bets $0.20
IceAngel82: folds=20
Uncalled bet ($0.20) returned to kaisukezz
kaisukezz collected $0.40 from pot
kaisukezz: doesn't show hand=20
*** SUMMARY ***
Total pot $0.41 | Rake $0.01=20
Board [9c Jc Qh 4d Qd]
Seat 1: holderville (button) folded before Flop (didn't bet)
Seat 2: Comra1d (small blind) folded before Flop
Seat 3: IceAngel82 (big blind) folded on the River
Seat 4: zsermano folded before Flop (didn't bet)
Seat 5: romanius04 folded on the Flop
Seat 6: the_wickstar folded before Flop (didn't bet)
Seat 7: kaisukezz collected ($0.40)
Seat 9: aivenbh folded before Flop (didn't bet)


*********** # 177 **************
PokerStars Hand #169399442183:  Hold'em No Limit ($0.01/$0.02 USD) - 20=
17/04/23 0:57:09 CUST [2017/04/22 10:57:09 ET]
Table 'Ottilia' 9-max Seat #6 is the button
Seat 2: Medet Isk ($1.74 in chips)=20
Seat 3: s74nitro ($2 in chips)=20
Seat 6: costica1949 ($2.29 in chips)=20
Seat 7: the_wickstar ($1.71 in chips)=20
Seat 8: CherT678 ($2.03 in chips)=20
the_wickstar: posts small blind $0.01
CherT678: posts big blind $0.02
TONIELSE: sits out=20
Medet Isk: posts small & big blinds $0.03
*** HOLE CARDS ***
Dealt to the_wickstar [2s 9h]
Medet Isk: checks=20
s74nitro: folds=20
costica1949: folds=20
the_wickstar: calls $0.01
CherT678: checks=20
*** FLOP *** [Qh Ad 6h]
the_wickstar: checks=20
CherT678: checks=20
Medet Isk: checks=20
*** TURN *** [Qh Ad 6h] [7s]
the_wickstar: bets $0.04
CherT678: folds=20
Medet Isk: folds=20
Uncalled bet ($0.04) returned to the_wickstar
the_wickstar collected $0.07 from pot
*** SUMMARY ***
Total pot $0.07 | Rake $0=20
Board [Qh Ad 6h 7s]
Seat 2: Medet Isk folded on the Turn
Seat 3: s74nitro folded before Flop (didn't bet)
Seat 6: costica1949 (button) folded before Flop (didn't bet)
Seat 7: the_wickstar (small blind) collected ($0.07)
Seat 8: CherT678 (big blind) folded on the Turn


*********** # 178 **************
PokerStars Hand #169399407546:  Hold'em No Limit ($0.01/$0.02 USD) - 20=
17/04/23 0:56:10 CUST [2017/04/22 10:56:10 ET]
Table 'Imperatrix' 9-max Seat #9 is the button
Seat 1: holderville ($3.79 in chips)=20
Seat 2: Comra1d ($2 in chips)=20
Seat 4: zsermano ($3.27 in chips)=20
Seat 5: romanius04 ($2 in chips)=20
Seat 6: the_wickstar ($1.95 in chips)=20
Seat 7: kaisukezz ($2.03 in chips)=20
Seat 9: aivenbh ($0.97 in chips)=20
holderville: posts small blind $0.01
Comra1d: posts big blind $0.02
FanLi: sits out=20
*** HOLE CARDS ***
Dealt to the_wickstar [4h 5h]
zsermano: folds=20
romanius04: folds=20
the_wickstar: calls $0.02
kaisukezz: folds=20
aivenbh: raises $0.07 to $0.09
Tarc=EDdio leaves the table
IceAngel82 joins the table at seat #3=20
holderville: raises $0.12 to $0.21
Comra1d: folds=20
the_wickstar: folds=20
aivenbh: raises $0.76 to $0.97 and is all-in
holderville: calls $0.76
*** FLOP *** [4d Ts 9d]
*** TURN *** [4d Ts 9d] [Tc]
*** RIVER *** [4d Ts 9d Tc] [8h]
*** SHOW DOWN ***
holderville: shows [Qh As] (a pair of Tens)
aivenbh: shows [Qs Qc] (two pair, Queens and Tens)
aivenbh collected $1.91 from pot
*** SUMMARY ***
Total pot $1.98 | Rake $0.07=20
Board [4d Ts 9d Tc 8h]
Seat 1: holderville (small blind) showed [Qh As] and lost with a pair o=
f Tens
Seat 2: Comra1d (big blind) folded before Flop
Seat 4: zsermano folded before Flop (didn't bet)
Seat 5: romanius04 folded before Flop (didn't bet)
Seat 6: the_wickstar folded before Flop
Seat 7: kaisukezz folded before Flop (didn't bet)
Seat 9: aivenbh (button) showed [Qs Qc] and won ($1.91) with two pair, =
Queens and Tens


*********** # 179 **************
PokerStars Hand #169399390498:  Hold'em No Limit ($0.01/$0.02 USD) - 20=
17/04/23 0:55:41 CUST [2017/04/22 10:55:41 ET]
Table 'Ottilia' 9-max Seat #3 is the button
Seat 1: Wypka88 ($2.08 in chips)=20
Seat 3: s74nitro ($2 in chips)=20
Seat 5: 1989-2017UH ($2 in chips)=20
Seat 6: costica1949 ($2.33 in chips)=20
Seat 7: the_wickstar ($1.62 in chips)=20
Seat 8: CherT678 ($2.03 in chips)=20
1989-2017UH: posts small blind $0.01
costica1949: posts big blind $0.02
*** HOLE CARDS ***
Dealt to the_wickstar [Qh Kd]
the_wickstar: raises $0.02 to $0.04
CherT678: folds=20
Wypka88: folds=20
s74nitro: calls $0.04
1989-2017UH: folds=20
costica1949: calls $0.02
*** FLOP *** [6h 6c 2h]
costica1949: checks=20
the_wickstar: checks=20
s74nitro: checks=20
*** TURN *** [6h 6c 2h] [Ad]
costica1949: checks=20
the_wickstar: bets $0.13
s74nitro: folds=20
costica1949: folds=20
Uncalled bet ($0.13) returned to the_wickstar
the_wickstar collected $0.13 from pot
*** SUMMARY ***
Total pot $0.13 | Rake $0=20
Board [6h 6c 2h Ad]
Seat 1: Wypka88 folded before Flop (didn't bet)
Seat 3: s74nitro (button) folded on the Turn
Seat 5: 1989-2017UH (small blind) folded before Flop
Seat 6: costica1949 (big blind) folded on the Turn
Seat 7: the_wickstar collected ($0.13)
Seat 8: CherT678 folded before Flop (didn't bet)


*********** # 180 **************
PokerStars Hand #169399379672:  Hold'em No Limit ($0.01/$0.02 USD) - 20=
17/04/23 0:55:23 CUST [2017/04/22 10:55:23 ET]
Table 'Imperatrix' 9-max Seat #7 is the button
Seat 1: holderville ($3.81 in chips)=20
Seat 4: zsermano ($1.60 in chips)=20
Seat 5: romanius04 ($2 in chips)=20
Seat 6: the_wickstar ($2.01 in chips)=20
Seat 7: kaisukezz ($2.13 in chips)=20
Seat 9: aivenbh ($0.98 in chips)=20
aivenbh: posts small blind $0.01
holderville: posts big blind $0.02
Comra1d: sits out=20
zsermano: posts big blind $0.02
*** HOLE CARDS ***
Dealt to the_wickstar [6h Tc]
zsermano: raises $0.04 to $0.06
romanius04: calls $0.06
FanLi joins the table at seat #8=20
the_wickstar: calls $0.06
kaisukezz: calls $0.06
aivenbh: folds=20
holderville: folds=20
*** FLOP *** [Ah 5h 2c]
zsermano: bets $0.04
romanius04: calls $0.04
the_wickstar: folds=20
kaisukezz: calls $0.04
*** TURN *** [Ah 5h 2c] [Qd]
zsermano: bets $1.50 and is all-in
romanius04: raises $0.40 to $1.90 and is all-in
kaisukezz: folds=20
Uncalled bet ($0.40) returned to romanius04
*** RIVER *** [Ah 5h 2c Qd] [7s]
*** SHOW DOWN ***
zsermano: shows [As Ad] (three of a kind, Aces)
romanius04: shows [5d 5c] (three of a kind, Fives)
zsermano collected $3.27 from pot
*** SUMMARY ***
Total pot $3.39 | Rake $0.12=20
Board [Ah 5h 2c Qd 7s]
Seat 1: holderville (big blind) folded before Flop
Seat 4: zsermano showed [As Ad] and won ($3.27) with three of a kind, A=
ces
Seat 5: romanius04 showed [5d 5c] and lost with three of a kind, Fives
Seat 6: the_wickstar folded on the Flop
Seat 7: kaisukezz (button) folded on the Turn
Seat 9: aivenbh (small blind) folded before Flop


*********** # 181 **************
PokerStars Hand #169399377483:  Hold'em No Limit ($0.01/$0.02 USD) - 20=
17/04/23 0:55:19 CUST [2017/04/22 10:55:19 ET]
Table 'Ottilia' 9-max Seat #1 is the button
Seat 1: Wypka88 ($2.08 in chips)=20
Seat 3: s74nitro ($2 in chips)=20
Seat 5: 1989-2017UH ($2 in chips)=20
Seat 6: costica1949 ($2.33 in chips)=20
Seat 7: the_wickstar ($1.59 in chips)=20
Seat 8: CherT678 ($2.03 in chips)=20
s74nitro: posts small blind $0.01
1989-2017UH: posts big blind $0.02
*** HOLE CARDS ***
Dealt to the_wickstar [9c 9s]
costica1949: folds=20
the_wickstar: raises $0.04 to $0.06
CherT678: folds=20
Wypka88: folds=20
s74nitro: folds=20
1989-2017UH: folds=20
Uncalled bet ($0.04) returned to the_wickstar
the_wickstar collected $0.05 from pot
*** SUMMARY ***
Total pot $0.05 | Rake $0=20
Seat 1: Wypka88 (button) folded before Flop (didn't bet)
Seat 3: s74nitro (small blind) folded before Flop
Seat 5: 1989-2017UH (big blind) folded before Flop
Seat 6: costica1949 folded before Flop (didn't bet)
Seat 7: the_wickstar collected ($0.05)
Seat 8: CherT678 folded before Flop (didn't bet)


*********** # 182 **************
PokerStars Hand #169399351508:  Hold'em No Limit ($0.01/$0.02 USD) - 20=
17/04/23 0:54:39 CUST [2017/04/22 10:54:39 ET]
Table 'Ottilia' 9-max Seat #8 is the button
Seat 1: Wypka88 ($2 in chips)=20
Seat 3: s74nitro ($2 in chips)=20
Seat 4: frdrch ($2.07 in chips)=20
Seat 5: 1989-2017UH ($2 in chips)=20
Seat 6: costica1949 ($2.33 in chips)=20
Seat 7: the_wickstar ($1.59 in chips)=20
Seat 8: CherT678 ($2.03 in chips)=20
Wypka88: posts small blind $0.01
s74nitro: posts big blind $0.02
*** HOLE CARDS ***
Dealt to the_wickstar [4s 7d]
frdrch: folds=20
1989-2017UH: raises $0.04 to $0.06
costica1949: folds=20
frdrch leaves the table
the_wickstar: folds=20
CherT678: folds=20
Wypka88: raises $0.14 to $0.20
s74nitro: folds=20
1989-2017UH: folds=20
Uncalled bet ($0.14) returned to Wypka88
Wypka88 collected $0.14 from pot
Wypka88: doesn't show hand=20
*** SUMMARY ***
Total pot $0.14 | Rake $0=20
Seat 1: Wypka88 (small blind) collected ($0.14)
Seat 3: s74nitro (big blind) folded before Flop
Seat 4: frdrch folded before Flop (didn't bet)
Seat 5: 1989-2017UH folded before Flop
Seat 6: costica1949 folded before Flop (didn't bet)
Seat 7: the_wickstar folded before Flop (didn't bet)
Seat 8: CherT678 (button) folded before Flop (didn't bet)


*********** # 183 **************
PokerStars Hand #169399340797:  Hold'em No Limit ($0.01/$0.02 USD) - 20=
17/04/23 0:54:24 CUST [2017/04/22 10:54:24 ET]
Table 'Imperatrix' 9-max Seat #6 is the button
Seat 1: holderville ($3.81 in chips)=20
Seat 5: romanius04 ($2 in chips)=20
Seat 6: the_wickstar ($1.86 in chips)=20
Seat 7: kaisukezz ($2.21 in chips)=20
Seat 9: aivenbh ($1.06 in chips)=20
kaisukezz: posts small blind $0.01
aivenbh: posts big blind $0.02
*** HOLE CARDS ***
Dealt to the_wickstar [Td Th]
holderville: folds=20
romanius04: folds=20
the_wickstar: raises $0.06 to $0.08
Austrax leaves the table
kaisukezz: calls $0.07
aivenbh: calls $0.06
*** FLOP *** [8h Js 8c]
kaisukezz: checks=20
zsermano joins the table at seat #4=20
aivenbh: checks=20
the_wickstar: bets $0.23
kaisukezz: folds=20
aivenbh: folds=20
Uncalled bet ($0.23) returned to the_wickstar
the_wickstar collected $0.23 from pot
*** SUMMARY ***
Total pot $0.24 | Rake $0.01=20
Board [8h Js 8c]
Seat 1: holderville folded before Flop (didn't bet)
Seat 5: romanius04 folded before Flop (didn't bet)
Seat 6: the_wickstar (button) collected ($0.23)
Seat 7: kaisukezz (small blind) folded on the Flop
Seat 9: aivenbh (big blind) folded on the Flop


*********** # 184 **************
PokerStars Hand #169399296890:  Hold'em No Limit ($0.01/$0.02 USD) - 20=
17/04/23 0:53:34 CUST [2017/04/22 10:53:34 ET]
Table 'Ottilia' 9-max Seat #7 is the button
Seat 1: Wypka88 ($2 in chips)=20
Seat 4: frdrch ($2.07 in chips)=20
Seat 5: 1989-2017UH ($2 in chips)=20
Seat 6: costica1949 ($2.37 in chips)=20
Seat 7: the_wickstar ($1.50 in chips)=20
Seat 8: CherT678 ($2.04 in chips)=20
CherT678: posts small blind $0.01
Wypka88: posts big blind $0.02
s74nitro: sits out=20
*** HOLE CARDS ***
Dealt to the_wickstar [Ah 5d]
frdrch: folds=20
1989-2017UH: folds=20
costica1949: raises $0.02 to $0.04
the_wickstar: calls $0.04
CherT678: folds=20
Wypka88: calls $0.02
*** FLOP *** [9d 8h 7s]
Wypka88: checks=20
costica1949: checks=20
the_wickstar: checks=20
*** TURN *** [9d 8h 7s] [8c]
Wypka88: checks=20
costica1949: checks=20
the_wickstar: checks=20
*** RIVER *** [9d 8h 7s 8c] [Kd]
Wypka88: checks=20
costica1949: checks=20
the_wickstar: bets $0.13
Wypka88: folds=20
costica1949: folds=20
Uncalled bet ($0.13) returned to the_wickstar
the_wickstar collected $0.13 from pot
*** SUMMARY ***
Total pot $0.13 | Rake $0=20
Board [9d 8h 7s 8c Kd]
Seat 1: Wypka88 (big blind) folded on the River
Seat 4: frdrch folded before Flop (didn't bet)
Seat 5: 1989-2017UH folded before Flop (didn't bet)
Seat 6: costica1949 folded on the River
Seat 7: the_wickstar (button) collected ($0.13)
Seat 8: CherT678 (small blind) folded before Flop


*********** # 185 **************
PokerStars Hand #169399284257:  Hold'em No Limit ($0.01/$0.02 USD) - 20=
17/04/23 0:53:16 CUST [2017/04/22 10:53:16 ET]
Table 'Imperatrix' 9-max Seat #5 is the button
Seat 1: holderville ($3.81 in chips)=20
Seat 5: romanius04 ($2 in chips)=20
Seat 6: the_wickstar ($1.84 in chips)=20
Seat 7: kaisukezz ($2.23 in chips)=20
Seat 9: aivenbh ($1.06 in chips)=20
the_wickstar: posts small blind $0.01
kaisukezz: posts big blind $0.02
*** HOLE CARDS ***
Dealt to the_wickstar [8d Qh]
holderville said, "&-B"
aivenbh: folds=20
holderville: folds=20
romanius04: folds=20
the_wickstar: calls $0.01
kaisukezz: checks=20
*** FLOP *** [Kd Ad 3c]
the_wickstar: checks=20
kaisukezz: checks=20
*** TURN *** [Kd Ad 3c] [Tc]
the_wickstar: checks=20
kaisukezz: checks=20
*** RIVER *** [Kd Ad 3c Tc] [6c]
the_wickstar: bets $0.04
kaisukezz: folds=20
Uncalled bet ($0.04) returned to the_wickstar
the_wickstar collected $0.04 from pot
*** SUMMARY ***
Total pot $0.04 | Rake $0=20
Board [Kd Ad 3c Tc 6c]
Seat 1: holderville folded before Flop (didn't bet)
Seat 5: romanius04 (button) folded before Flop (didn't bet)
Seat 6: the_wickstar (small blind) collected ($0.04)
Seat 7: kaisukezz (big blind) folded on the River
Seat 9: aivenbh folded before Flop (didn't bet)


*********** # 186 **************
PokerStars Hand #169399270367:  Hold'em No Limit ($0.01/$0.02 USD) - 20=
17/04/23 0:52:56 CUST [2017/04/22 10:52:56 ET]
Table 'Ottilia' 9-max Seat #6 is the button
Seat 1: Wypka88 ($2 in chips)=20
Seat 2: Medet Isk ($1.74 in chips)=20
Seat 4: frdrch ($2.07 in chips)=20
Seat 5: 1989-2017UH ($2 in chips)=20
Seat 6: costica1949 ($2.34 in chips)=20
Seat 7: the_wickstar ($1.51 in chips)=20
Seat 8: CherT678 ($2.06 in chips)=20
the_wickstar: posts small blind $0.01
CherT678: posts big blind $0.02
s74nitro: sits out=20
*** HOLE CARDS ***
Dealt to the_wickstar [2c 4c]
Wypka88: folds=20
Medet Isk has timed out
Medet Isk: folds=20
frdrch: folds=20
1989-2017UH: folds=20
costica1949: raises $0.02 to $0.04
the_wickstar: folds=20
CherT678: folds=20
Uncalled bet ($0.02) returned to costica1949
costica1949 collected $0.05 from pot
costica1949: doesn't show hand=20
*** SUMMARY ***
Total pot $0.05 | Rake $0=20
Seat 1: Wypka88 folded before Flop (didn't bet)
Seat 2: Medet Isk folded before Flop (didn't bet)
Seat 4: frdrch folded before Flop (didn't bet)
Seat 5: 1989-2017UH folded before Flop (didn't bet)
Seat 6: costica1949 (button) collected ($0.05)
Seat 7: the_wickstar (small blind) folded before Flop
Seat 8: CherT678 (big blind) folded before Flop


*********** # 187 **************
PokerStars Hand #169399260914:  Hold'em No Limit ($0.01/$0.02 USD) - 20=
17/04/23 0:52:42 CUST [2017/04/22 10:52:42 ET]
Table 'Imperatrix' 9-max Seat #4 is the button
Seat 1: holderville ($2 in chips)=20
Seat 4: gimemorphine ($1.92 in chips)=20
Seat 5: romanius04 ($2 in chips)=20
Seat 6: the_wickstar ($1.86 in chips)=20
Seat 7: kaisukezz ($2.23 in chips)=20
Seat 9: aivenbh ($1.06 in chips)=20
romanius04: posts small blind $0.01
the_wickstar: posts big blind $0.02
*** HOLE CARDS ***
Dealt to the_wickstar [4h 7h]
kaisukezz: folds=20
aivenbh: folds=20
holderville: raises $0.04 to $0.06
gimemorphine: raises $0.11 to $0.17
romanius04: folds=20
the_wickstar: folds=20
holderville: raises $1.83 to $2 and is all-in
gimemorphine: calls $1.75 and is all-in
Uncalled bet ($0.08) returned to holderville
*** FLOP *** [9s 7s 6c]
*** TURN *** [9s 7s 6c] [Ts]
*** RIVER *** [9s 7s 6c Ts] [4c]
*** SHOW DOWN ***
holderville: shows [Kd Kh] (a pair of Kings)
gimemorphine: shows [5h Ks] (high card King)
gimemorphine leaves the table
holderville collected $3.73 from pot
*** SUMMARY ***
Total pot $3.87 | Rake $0.14=20
Board [9s 7s 6c Ts 4c]
Seat 1: holderville showed [Kd Kh] and won ($3.73) with a pair of Kings
Seat 4: gimemorphine (button) showed [5h Ks] and lost with high card Ki=
ng
Seat 5: romanius04 (small blind) folded before Flop
Seat 6: the_wickstar (big blind) folded before Flop
Seat 7: kaisukezz folded before Flop (didn't bet)
Seat 9: aivenbh folded before Flop (didn't bet)


*********** # 188 **************
PokerStars Hand #169399255484:  Hold'em No Limit ($0.01/$0.02 USD) - 20=
17/04/23 0:52:34 CUST [2017/04/22 10:52:34 ET]
Table 'Ottilia' 9-max Seat #5 is the button
Seat 1: Wypka88 ($2 in chips)=20
Seat 2: Medet Isk ($1.74 in chips)=20
Seat 4: frdrch ($2.07 in chips)=20
Seat 5: 1989-2017UH ($2 in chips)=20
Seat 6: costica1949 ($2.32 in chips)=20
Seat 7: the_wickstar ($1.53 in chips)=20
Seat 8: CherT678 ($2.06 in chips)=20
costica1949: posts small blind $0.01
the_wickstar: posts big blind $0.02
s74nitro: sits out=20
*** HOLE CARDS ***
Dealt to the_wickstar [6s 8d]
CherT678: folds=20
Wypka88: folds=20
Medet Isk: folds=20
frdrch: folds=20
1989-2017UH: folds=20
costica1949: raises $0.02 to $0.04
the_wickstar: folds=20
Uncalled bet ($0.02) returned to costica1949
costica1949 collected $0.04 from pot
costica1949: doesn't show hand=20
*** SUMMARY ***
Total pot $0.04 | Rake $0=20
Seat 1: Wypka88 folded before Flop (didn't bet)
Seat 2: Medet Isk folded before Flop (didn't bet)
Seat 4: frdrch folded before Flop (didn't bet)
Seat 5: 1989-2017UH (button) folded before Flop (didn't bet)
Seat 6: costica1949 (small blind) collected ($0.04)
Seat 7: the_wickstar (big blind) folded before Flop
Seat 8: CherT678 folded before Flop (didn't bet)


*********** # 189 **************
PokerStars Hand #169399245453:  Hold'em No Limit ($0.01/$0.02 USD) - 20=
17/04/23 0:52:20 CUST [2017/04/22 10:52:20 ET]
Table 'Imperatrix' 9-max Seat #1 is the button
Seat 1: holderville ($1.88 in chips)=20
Seat 4: gimemorphine ($1.90 in chips)=20
Seat 5: romanius04 ($2 in chips)=20
Seat 6: the_wickstar ($1.86 in chips)=20
Seat 7: kaisukezz ($2.23 in chips)=20
Seat 9: aivenbh ($1.06 in chips)=20
gimemorphine: posts small blind $0.01
romanius04: posts big blind $0.02
*** HOLE CARDS ***
Dealt to the_wickstar [3c As]
the_wickstar: folds=20
kaisukezz: folds=20
aivenbh: folds=20
holderville: folds=20
gimemorphine: calls $0.01
romanius04: checks=20
*** FLOP *** [6h Ts Qc]
gimemorphine: checks=20
romanius04: checks=20
*** TURN *** [6h Ts Qc] [8s]
gimemorphine: checks=20
romanius04: checks=20
*** RIVER *** [6h Ts Qc 8s] [4c]
gimemorphine: checks=20
romanius04: checks=20
*** SHOW DOWN ***
gimemorphine: shows [Kd 4h] (a pair of Fours)
romanius04: mucks hand=20
gimemorphine collected $0.04 from pot
*** SUMMARY ***
Total pot $0.04 | Rake $0=20
Board [6h Ts Qc 8s 4c]
Seat 1: holderville (button) folded before Flop (didn't bet)
Seat 4: gimemorphine (small blind) showed [Kd 4h] and won ($0.04) with =
a pair of Fours
Seat 5: romanius04 (big blind) mucked [Ac 5s]
Seat 6: the_wickstar folded before Flop (didn't bet)
Seat 7: kaisukezz folded before Flop (didn't bet)
Seat 9: aivenbh folded before Flop (didn't bet)


*********** # 190 **************
PokerStars Hand #169399209622:  Hold'em No Limit ($0.01/$0.02 USD) - 20=
17/04/23 0:51:27 CUST [2017/04/22 10:51:27 ET]
Table 'Ottilia' 9-max Seat #4 is the button
Seat 1: Wypka88 ($2 in chips)=20
Seat 2: Medet Isk ($1.78 in chips)=20
Seat 4: frdrch ($2.07 in chips)=20
Seat 5: 1989-2017UH ($2 in chips)=20
Seat 6: costica1949 ($2.36 in chips)=20
Seat 7: the_wickstar ($1.44 in chips)=20
Seat 8: CherT678 ($2.06 in chips)=20
Seat 9: TONIELSE ($3.70 in chips)=20
1989-2017UH: posts small blind $0.01
costica1949: posts big blind $0.02
s74nitro: sits out=20
*** HOLE CARDS ***
Dealt to the_wickstar [4c Ad]
the_wickstar: calls $0.02
CherT678: folds=20
TONIELSE: folds=20
Wypka88: folds=20
Medet Isk: calls $0.02
frdrch: folds=20
1989-2017UH: folds=20
costica1949: checks=20
*** FLOP *** [6d 5d Qh]
costica1949: checks=20
the_wickstar: checks=20
Medet Isk: bets $0.02
costica1949: calls $0.02
the_wickstar: calls $0.02
*** TURN *** [6d 5d Qh] [Kd]
costica1949: checks=20
the_wickstar: checks=20
Medet Isk: checks=20
*** RIVER *** [6d 5d Qh Kd] [Jd]
costica1949: checks=20
the_wickstar: bets $0.06
Medet Isk: folds=20
costica1949: folds=20
Uncalled bet ($0.06) returned to the_wickstar
the_wickstar collected $0.13 from pot
*** SUMMARY ***
Total pot $0.13 | Rake $0=20
Board [6d 5d Qh Kd Jd]
Seat 1: Wypka88 folded before Flop (didn't bet)
Seat 2: Medet Isk folded on the River
Seat 4: frdrch (button) folded before Flop (didn't bet)
Seat 5: 1989-2017UH (small blind) folded before Flop
Seat 6: costica1949 (big blind) folded on the River
Seat 7: the_wickstar collected ($0.13)
Seat 8: CherT678 folded before Flop (didn't bet)
Seat 9: TONIELSE folded before Flop (didn't bet)


*********** # 191 **************
PokerStars Hand #169399191193:  Hold'em No Limit ($0.01/$0.02 USD) - 20=
17/04/23 0:51:02 CUST [2017/04/22 10:51:02 ET]
Table 'Imperatrix' 9-max Seat #9 is the button
Seat 1: holderville ($1.92 in chips)=20
Seat 4: gimemorphine ($1.86 in chips)=20
Seat 5: romanius04 ($2 in chips)=20
Seat 6: the_wickstar ($1.86 in chips)=20
Seat 7: kaisukezz ($2.23 in chips)=20
Seat 8: Austrax ($2 in chips)=20
Seat 9: aivenbh ($1.06 in chips)=20
holderville: posts small blind $0.01
gimemorphine: posts big blind $0.02
*** HOLE CARDS ***
Dealt to the_wickstar [7h Qs]
romanius04: folds=20
the_wickstar: folds=20
kaisukezz: folds=20
Austrax: folds=20
aivenbh: folds=20
holderville: calls $0.01
gimemorphine: checks=20
*** FLOP *** [4h Js 4s]
holderville: bets $0.02
gimemorphine: raises $0.14 to $0.16
holderville: folds=20
Uncalled bet ($0.14) returned to gimemorphine
gimemorphine collected $0.08 from pot
gimemorphine: doesn't show hand=20
*** SUMMARY ***
Total pot $0.08 | Rake $0=20
Board [4h Js 4s]
Seat 1: holderville (small blind) folded on the Flop
Seat 4: gimemorphine (big blind) collected ($0.08)
Seat 5: romanius04 folded before Flop (didn't bet)
Seat 6: the_wickstar folded before Flop (didn't bet)
Seat 7: kaisukezz folded before Flop (didn't bet)
Seat 8: Austrax folded before Flop (didn't bet)
Seat 9: aivenbh (button) folded before Flop (didn't bet)


*********** # 192 **************
PokerStars Hand #169399190753:  Hold'em No Limit ($0.01/$0.02 USD) - 20=
17/04/23 0:51:02 CUST [2017/04/22 10:51:02 ET]
Table 'Ottilia' 9-max Seat #2 is the button
Seat 1: Wypka88 ($2 in chips)=20
Seat 2: Medet Isk ($1.75 in chips)=20
Seat 4: frdrch ($2.08 in chips)=20
Seat 5: 1989-2017UH ($2 in chips)=20
Seat 6: costica1949 ($2.36 in chips)=20
Seat 7: the_wickstar ($1.44 in chips)=20
Seat 8: CherT678 ($2.06 in chips)=20
Seat 9: TONIELSE ($3.70 in chips)=20
frdrch: posts small blind $0.01
1989-2017UH: posts big blind $0.02
*** HOLE CARDS ***
Dealt to the_wickstar [9h Ks]
costica1949: folds=20
the_wickstar: folds=20
CherT678: folds=20
TONIELSE: folds=20
Wypka88: folds=20
Medet Isk: calls $0.02
frdrch: folds=20
1989-2017UH: checks=20
*** FLOP *** [Td Jc 7s]
1989-2017UH: checks=20
Medet Isk: bets $0.02
s74nitro joins the table at seat #3=20
1989-2017UH: folds=20
Uncalled bet ($0.02) returned to Medet Isk
Medet Isk collected $0.05 from pot
*** SUMMARY ***
Total pot $0.05 | Rake $0=20
Board [Td Jc 7s]
Seat 1: Wypka88 folded before Flop (didn't bet)
Seat 2: Medet Isk (button) collected ($0.05)
Seat 4: frdrch (small blind) folded before Flop
Seat 5: 1989-2017UH (big blind) folded on the Flop
Seat 6: costica1949 folded before Flop (didn't bet)
Seat 7: the_wickstar folded before Flop (didn't bet)
Seat 8: CherT678 folded before Flop (didn't bet)
Seat 9: TONIELSE folded before Flop (didn't bet)


*********** # 193 **************
PokerStars Hand #169399166149:  Hold'em No Limit ($0.01/$0.02 USD) - 20=
17/04/23 0:50:25 CUST [2017/04/22 10:50:25 ET]
Table 'Ottilia' 9-max Seat #1 is the button
Seat 1: Wypka88 ($2 in chips)=20
Seat 2: Medet Isk ($1.71 in chips)=20
Seat 4: frdrch ($2.10 in chips)=20
Seat 5: 1989-2017UH ($2 in chips)=20
Seat 6: costica1949 ($2.36 in chips)=20
Seat 7: the_wickstar ($1.46 in chips)=20
Seat 8: CherT678 ($2.06 in chips)=20
Seat 9: TONIELSE ($3.70 in chips)=20
Medet Isk: posts small blind $0.01
genix94: is sitting out=20
frdrch: posts big blind $0.02
genix94 leaves the table
*** HOLE CARDS ***
Dealt to the_wickstar [Qs 6s]
Ch3mi5try joins the table at seat #3=20
1989-2017UH: folds=20
costica1949: folds=20
Ch3mi5try leaves the table
the_wickstar: calls $0.02
CherT678: folds=20
TONIELSE: folds=20
Wypka88: folds=20
Medet Isk: calls $0.01
frdrch: checks=20
*** FLOP *** [3c Td 5s]
Medet Isk: bets $0.02
frdrch: folds=20
the_wickstar: folds=20
Uncalled bet ($0.02) returned to Medet Isk
Medet Isk collected $0.06 from pot
*** SUMMARY ***
Total pot $0.06 | Rake $0=20
Board [3c Td 5s]
Seat 1: Wypka88 (button) folded before Flop (didn't bet)
Seat 2: Medet Isk (small blind) collected ($0.06)
Seat 4: frdrch (big blind) folded on the Flop
Seat 5: 1989-2017UH folded before Flop (didn't bet)
Seat 6: costica1949 folded before Flop (didn't bet)
Seat 7: the_wickstar folded on the Flop
Seat 8: CherT678 folded before Flop (didn't bet)
Seat 9: TONIELSE folded before Flop (didn't bet)


*********** # 194 **************
PokerStars Hand #169399157808:  Hold'em No Limit ($0.01/$0.02 USD) - 20=
17/04/23 0:50:19 CUST [2017/04/22 10:50:19 ET]
Table 'Imperatrix' 9-max Seat #8 is the button
Seat 1: holderville ($1.98 in chips)=20
Seat 4: gimemorphine ($1.92 in chips)=20
Seat 5: romanius04 ($2 in chips)=20
Seat 6: the_wickstar ($1.86 in chips)=20
Seat 7: kaisukezz ($2.23 in chips)=20
Seat 8: Austrax ($2 in chips)=20
Seat 9: aivenbh ($0.95 in chips)=20
aivenbh: posts small blind $0.01
holderville: posts big blind $0.02
*** HOLE CARDS ***
Dealt to the_wickstar [Jc 3s]
gimemorphine: raises $0.04 to $0.06
romanius04: folds=20
the_wickstar: folds=20
kaisukezz: folds=20
Austrax: folds=20
aivenbh: calls $0.05
holderville: calls $0.04
*** FLOP *** [4d 6d 5h]
aivenbh: bets $0.09
holderville: folds=20
gimemorphine: folds=20
Uncalled bet ($0.09) returned to aivenbh
aivenbh collected $0.17 from pot
*** SUMMARY ***
Total pot $0.18 | Rake $0.01=20
Board [4d 6d 5h]
Seat 1: holderville (big blind) folded on the Flop
Seat 4: gimemorphine folded on the Flop
Seat 5: romanius04 folded before Flop (didn't bet)
Seat 6: the_wickstar folded before Flop (didn't bet)
Seat 7: kaisukezz folded before Flop (didn't bet)
Seat 8: Austrax (button) folded before Flop (didn't bet)
Seat 9: aivenbh (small blind) collected ($0.17)


*********** # 195 **************
PokerStars Hand #169399144549:  Hold'em No Limit ($0.01/$0.02 USD) - 20=
17/04/23 0:49:59 CUST [2017/04/22 10:49:59 ET]
Table 'Imperatrix' 9-max Seat #7 is the button
Seat 1: holderville ($1.98 in chips)=20
Seat 4: gimemorphine ($1.89 in chips)=20
Seat 5: romanius04 ($2 in chips)=20
Seat 6: the_wickstar ($1.86 in chips)=20
Seat 7: kaisukezz ($2.23 in chips)=20
Seat 8: Austrax ($2 in chips)=20
Seat 9: aivenbh ($0.97 in chips)=20
Austrax: posts small blind $0.01
aivenbh: posts big blind $0.02
*** HOLE CARDS ***
Dealt to the_wickstar [Kh 4d]
holderville: folds=20
gimemorphine: raises $0.04 to $0.06
romanius04: folds=20
the_wickstar: folds=20
kaisukezz: folds=20
Austrax: folds=20
aivenbh: folds=20
Uncalled bet ($0.04) returned to gimemorphine
gimemorphine collected $0.05 from pot
gimemorphine: doesn't show hand=20
*** SUMMARY ***
Total pot $0.05 | Rake $0=20
Seat 1: holderville folded before Flop (didn't bet)
Seat 4: gimemorphine collected ($0.05)
Seat 5: romanius04 folded before Flop (didn't bet)
Seat 6: the_wickstar folded before Flop (didn't bet)
Seat 7: kaisukezz (button) folded before Flop (didn't bet)
Seat 8: Austrax (small blind) folded before Flop
Seat 9: aivenbh (big blind) folded before Flop


*********** # 196 **************
PokerStars Hand #169399124384:  Hold'em No Limit ($0.01/$0.02 USD) - 20=
17/04/23 0:49:29 CUST [2017/04/22 10:49:29 ET]
Table 'Ottilia' 9-max Seat #9 is the button
Seat 1: Wypka88 ($2.02 in chips)=20
Seat 2: Medet Isk ($1.62 in chips)=20
Seat 3: genix94 ($2.41 in chips)=20
Seat 4: frdrch ($2.10 in chips)=20
Seat 5: 1989-2017UH ($2 in chips)=20
Seat 6: costica1949 ($2.36 in chips)=20
Seat 7: the_wickstar ($1.48 in chips)=20
Seat 8: CherT678 ($2.06 in chips)=20
Seat 9: TONIELSE ($3.70 in chips)=20
Wypka88: posts small blind $0.01
Medet Isk: posts big blind $0.02
*** HOLE CARDS ***
Dealt to the_wickstar [Qd 7s]
genix94: folds=20
frdrch: folds=20
1989-2017UH: folds=20
costica1949: folds=20
the_wickstar: calls $0.02
CherT678: folds=20
TONIELSE: folds=20
Wypka88: raises $0.06 to $0.08
Medet Isk: calls $0.06
the_wickstar: folds=20
*** FLOP *** [6s 4s Ad]
Wypka88: checks=20
Medet Isk: bets $0.02
Wypka88: folds=20
Uncalled bet ($0.02) returned to Medet Isk
Medet Isk collected $0.17 from pot
*** SUMMARY ***
Total pot $0.18 | Rake $0.01=20
Board [6s 4s Ad]
Seat 1: Wypka88 (small blind) folded on the Flop
Seat 2: Medet Isk (big blind) collected ($0.17)
Seat 3: genix94 folded before Flop (didn't bet)
Seat 4: frdrch folded before Flop (didn't bet)
Seat 5: 1989-2017UH folded before Flop (didn't bet)
Seat 6: costica1949 folded before Flop (didn't bet)
Seat 7: the_wickstar folded before Flop
Seat 8: CherT678 folded before Flop (didn't bet)
Seat 9: TONIELSE (button) folded before Flop (didn't bet)


*********** # 197 **************
PokerStars Hand #169399096253:  Hold'em No Limit ($0.01/$0.02 USD) - 20=
17/04/23 0:48:54 CUST [2017/04/22 10:48:54 ET]
Table 'Imperatrix' 9-max Seat #6 is the button
Seat 1: holderville ($1.98 in chips)=20
Seat 4: gimemorphine ($1.77 in chips)=20
Seat 5: romanius04 ($2 in chips)=20
Seat 6: the_wickstar ($1.95 in chips)=20
Seat 7: kaisukezz ($2.25 in chips)=20
Seat 8: Austrax ($2 in chips)=20
Seat 9: Z.Zhdanov ($0.70 in chips)=20
kaisukezz: posts small blind $0.01
Austrax: posts big blind $0.02
*** HOLE CARDS ***
Dealt to the_wickstar [Qs 7d]
Z.Zhdanov: folds=20
Z.Zhdanov leaves the table
holderville: folds=20
gimemorphine: calls $0.02
romanius04: folds=20
the_wickstar: calls $0.02
kaisukezz: calls $0.01
Austrax: checks=20
*** FLOP *** [Jd 6s 6h]
kaisukezz: checks=20
Austrax: checks=20
gimemorphine: checks=20
the_wickstar: bets $0.07
kaisukezz: folds=20
Austrax: folds=20
gimemorphine: calls $0.07
*** TURN *** [Jd 6s 6h] [8d]
aivenbh joins the table at seat #9=20
gimemorphine: checks=20
the_wickstar: checks=20
*** RIVER *** [Jd 6s 6h 8d] [Jc]
gimemorphine: checks=20
Tarc=EDdio joins the table at seat #3=20
the_wickstar: checks=20
*** SHOW DOWN ***
gimemorphine: shows [9c 9s] (two pair, Jacks and Nines)
the_wickstar: mucks hand=20
gimemorphine collected $0.21 from pot
*** SUMMARY ***
Total pot $0.22 | Rake $0.01=20
Board [Jd 6s 6h 8d Jc]
Seat 1: holderville folded before Flop (didn't bet)
Seat 4: gimemorphine showed [9c 9s] and won ($0.21) with two pair, Jack=
s and Nines
Seat 5: romanius04 folded before Flop (didn't bet)
Seat 6: the_wickstar (button) mucked [Qs 7d]
Seat 7: kaisukezz (small blind) folded on the Flop
Seat 8: Austrax (big blind) folded on the Flop
Seat 9: Z.Zhdanov folded before Flop (didn't bet)


*********** # 198 **************
PokerStars Hand #169399071563:  Hold'em No Limit ($0.01/$0.02 USD) - 20=
17/04/23 0:48:22 CUST [2017/04/22 10:48:22 ET]
Table 'Ottilia' 9-max Seat #8 is the button
Seat 1: Wypka88 ($2.04 in chips)=20
Seat 2: Medet Isk ($1.45 in chips)=20
Seat 3: genix94 ($2.41 in chips)=20
Seat 4: frdrch ($2.10 in chips)=20
Seat 5: 1989-2017UH ($2 in chips)=20
Seat 6: costica1949 ($2.36 in chips)=20
Seat 7: the_wickstar ($1.50 in chips)=20
Seat 8: CherT678 ($2.06 in chips)=20
Seat 9: TONIELSE ($3.84 in chips)=20
TONIELSE: posts small blind $0.01
Wypka88: posts big blind $0.02
*** HOLE CARDS ***
Dealt to the_wickstar [4d 6d]
Medet Isk: calls $0.02
genix94: folds=20
frdrch: folds=20
1989-2017UH: folds=20
costica1949: folds=20
the_wickstar: calls $0.02
CherT678: folds=20
TONIELSE: raises $0.08 to $0.10
Wypka88: folds=20
Medet Isk: calls $0.08
the_wickstar: folds=20
*** FLOP *** [5s 8s Th]
TONIELSE: checks=20
Medet Isk: checks=20
*** TURN *** [5s 8s Th] [Jd]
TONIELSE: checks=20
Medet Isk: bets $0.02
TONIELSE: calls $0.02
*** RIVER *** [5s 8s Th Jd] [6h]
TONIELSE: checks=20
Medet Isk: bets $0.02
TONIELSE: calls $0.02
*** SHOW DOWN ***
Medet Isk: shows [Js 3s] (a pair of Jacks)
TONIELSE: mucks hand=20
Medet Isk collected $0.31 from pot
*** SUMMARY ***
Total pot $0.32 | Rake $0.01=20
Board [5s 8s Th Jd 6h]
Seat 1: Wypka88 (big blind) folded before Flop
Seat 2: Medet Isk showed [Js 3s] and won ($0.31) with a pair of Jacks
Seat 3: genix94 folded before Flop (didn't bet)
Seat 4: frdrch folded before Flop (didn't bet)
Seat 5: 1989-2017UH folded before Flop (didn't bet)
Seat 6: costica1949 folded before Flop (didn't bet)
Seat 7: the_wickstar folded before Flop
Seat 8: CherT678 (button) folded before Flop (didn't bet)
Seat 9: TONIELSE (small blind) mucked [Ad Qd]


*********** # 199 **************
PokerStars Hand #169399044029:  Hold'em No Limit ($0.01/$0.02 USD) - 20=
17/04/23 0:47:40 CUST [2017/04/22 10:47:40 ET]
Table 'Imperatrix' 9-max Seat #5 is the button
Seat 1: holderville ($1.98 in chips)=20
Seat 3: kano1313 ($0.81 in chips)=20
Seat 4: gimemorphine ($1.83 in chips)=20
Seat 5: romanius04 ($2.05 in chips)=20
Seat 6: the_wickstar ($1.74 in chips)=20
Seat 7: kaisukezz ($2.27 in chips)=20
Seat 8: Austrax ($2 in chips)=20
Seat 9: Z.Zhdanov ($0.78 in chips)=20
the_wickstar: posts small blind $0.01
kaisukezz: posts big blind $0.02
*** HOLE CARDS ***
Dealt to the_wickstar [Ks Td]
Austrax: folds=20
Z.Zhdanov: calls $0.02
holderville: folds=20
kano1313: folds=20
gimemorphine: calls $0.02
romanius04: raises $0.04 to $0.06
kano1313 leaves the table
the_wickstar: calls $0.05
kaisukezz: folds=20
Z.Zhdanov: calls $0.04
gimemorphine: calls $0.04
*** FLOP *** [2s 3c 6d]
the_wickstar: checks=20
Z.Zhdanov: bets $0.02
gimemorphine: folds=20
romanius04: folds=20
the_wickstar: calls $0.02
*** TURN *** [2s 3c 6d] [As]
the_wickstar: bets $0.20
Z.Zhdanov: folds=20
Uncalled bet ($0.20) returned to the_wickstar
the_wickstar collected $0.29 from pot
*** SUMMARY ***
Total pot $0.30 | Rake $0.01=20
Board [2s 3c 6d As]
Seat 1: holderville folded before Flop (didn't bet)
Seat 3: kano1313 folded before Flop (didn't bet)
Seat 4: gimemorphine folded on the Flop
Seat 5: romanius04 (button) folded on the Flop
Seat 6: the_wickstar (small blind) collected ($0.29)
Seat 7: kaisukezz (big blind) folded before Flop
Seat 8: Austrax folded before Flop (didn't bet)
Seat 9: Z.Zhdanov folded on the Turn


*********** # 200 **************
PokerStars Hand #169399003582:  Hold'em No Limit ($0.01/$0.02 USD) - 20=
17/04/23 0:46:55 CUST [2017/04/22 10:46:55 ET]
Table 'Imperatrix' 9-max Seat #4 is the button
Seat 1: holderville ($1.98 in chips)=20
Seat 3: kano1313 ($0.81 in chips)=20
Seat 4: gimemorphine ($1.85 in chips)=20
Seat 5: romanius04 ($2.06 in chips)=20
Seat 6: the_wickstar ($1.69 in chips)=20
Seat 7: kaisukezz ($2.27 in chips)=20
Seat 8: Austrax ($2 in chips)=20
Seat 9: Z.Zhdanov ($0.80 in chips)=20
romanius04: posts small blind $0.01
the_wickstar: posts big blind $0.02
Z.Zhdanov: posts big blind $0.02
*** HOLE CARDS ***
Dealt to the_wickstar [8d Tc]
kaisukezz: folds=20
Austrax: folds=20
Z.Zhdanov: checks=20
holderville: folds=20
kano1313: folds=20
gimemorphine: calls $0.02
romanius04: folds=20
the_wickstar: checks=20
*** FLOP *** [3s Qd Th]
the_wickstar: bets $0.05
Z.Zhdanov: folds=20
gimemorphine: folds=20
Uncalled bet ($0.05) returned to the_wickstar
the_wickstar collected $0.07 from pot
*** SUMMARY ***
Total pot $0.07 | Rake $0=20
Board [3s Qd Th]
Seat 1: holderville folded before Flop (didn't bet)
Seat 3: kano1313 folded before Flop (didn't bet)
Seat 4: gimemorphine (button) folded on the Flop
Seat 5: romanius04 (small blind) folded before Flop
Seat 6: the_wickstar (big blind) collected ($0.07)
Seat 7: kaisukezz folded before Flop (didn't bet)
Seat 8: Austrax folded before Flop (didn't bet)
Seat 9: Z.Zhdanov folded on the Flop



If you have any questions, please contact us at "PokerStars Support" <s=
upport@pokerstars.com>


