Delivered-To: sherhan.wicky@gmail.com
Received: by 10.79.136.132 with SMTP id k126csp785525ivd;
        Tue, 2 May 2017 06:57:29 -0700 (PDT)
X-Received: by 10.80.136.112 with SMTP id c45mr23279595edc.171.1493733449150;
        Tue, 02 May 2017 06:57:29 -0700 (PDT)
Return-Path: <support@pokerstars.com>
Received: from mx13.pokerstars.eu (mx13.pokerstars.eu. [77.87.179.125])
        by mx.google.com with ESMTPS id 64si16310464edy.309.2017.05.02.06.57.28
        for <sherhan.wicky@gmail.com>
        (version=TLS1_2 cipher=ECDHE-RSA-AES128-GCM-SHA256 bits=128/128);
        Tue, 02 May 2017 06:57:29 -0700 (PDT)
Received-SPF: pass (google.com: domain of support@pokerstars.com designates 77.87.179.125 as permitted sender) client-ip=77.87.179.125;
Authentication-Results: mx.google.com;
       dkim=pass (test mode) header.i=@pokerstars.com;
       spf=pass (google.com: domain of support@pokerstars.com designates 77.87.179.125 as permitted sender) smtp.mailfrom=support@pokerstars.com;
       dmarc=pass (p=NONE sp=NONE dis=NONE) header.from=pokerstars.com
Received: by mx13.pokerstars.eu (mailer, from userid 503)
	id 31D991FC3B2C; Tue,  2 May 2017 09:57:28 -0400 (EDT)
DKIM-Signature: v=1; a=rsa-sha1; c=relaxed; d=pokerstars.com; h=date
	:from:to:subject:message-id:mime-version:content-type
	:content-transfer-encoding; s=s1024; bh=RAYiQdf84LJGA1xo7eCLhhhL
	Wws=; b=HqZ65GEIhvbiCExXXoAigZ/77GZ8fPnR0VEHwp+nx/mtHafNQq7UlKJp
	efTGbPnS+UYMVtUcxF82SqC3JjDgPopGSj5rVezbVeUlNeoJ9DDPYoX0BQ88qAfC
	Q5DPwxo0U+5SLPLgKcQcagFLGwTh7uTC3yXrgE/LsPVc6zeuPRg=
X-PS-ID: c2hlcmhhbi53aWNreUBnbWFpbC5jb20=
Received: from pokerstars.com (IOM-20-81 [192.168.8.81])
	by mx13.pokerstars.eu (mailer) with SMTP id 188FB1FC3537
	for <sherhan.wicky@gmail.com>; Tue,  2 May 2017 09:57:28 -0400 (EDT)
Date: Tue, 2 May 2017 09:57:28 -0400
From: "PokerStars Support" <support@pokerstars.com>
To: sherhan.wicky@gmail.com
Subject: PokerStars Hand History Request - last 1 day of play
Message-Id: <59089048.A64092B8109B89D@pokerstars.com>
MIME-Version: 1.0
Content-Type: text/plain;
 charset="windows-1252"
Content-Transfer-Encoding: quoted-printable


Transcript for last 1 day of play requested by the_wickstar (sherhan.wi=
cky@gmail.com)

*********** # 1 **************
PokerStars Hand #169852046804:  Hold'em No Limit ($0.01/$0.02 USD) - 20=
17/05/02 23:56:32 CUST [2017/05/02 9:56:32 ET]
Table 'Telephus' 9-max Seat #8 is the button
Seat 1: the_wickstar ($1.69 in chips)=20
Seat 2: reivaj491 ($2 in chips)=20
Seat 3: Humanfritz ($2.73 in chips)=20
Seat 5: hihishka ($0.98 in chips)=20
Seat 8: 1tillit1 ($2.04 in chips)=20
Seat 9: iskarian ($2.08 in chips)=20
iskarian: posts small blind $0.01
the_wickstar: posts big blind $0.02
IIVadimII: sits out=20
*** HOLE CARDS ***
Dealt to the_wickstar [5d 8d]
Ch3mi5try joins the table at seat #7=20
reivaj491: folds=20
Humanfritz: raises $0.07 to $0.09
hihishka: folds=20
1tillit1: folds=20
iskarian: folds=20
the_wickstar: folds=20
Uncalled bet ($0.07) returned to Humanfritz
Humanfritz collected $0.05 from pot
Humanfritz: doesn't show hand=20
*** SUMMARY ***
Total pot $0.05 | Rake $0=20
Seat 1: the_wickstar (big blind) folded before Flop
Seat 2: reivaj491 folded before Flop (didn't bet)
Seat 3: Humanfritz collected ($0.05)
Seat 5: hihishka folded before Flop (didn't bet)
Seat 8: 1tillit1 (button) folded before Flop (didn't bet)
Seat 9: iskarian (small blind) folded before Flop


*********** # 2 **************
PokerStars Hand #169852024584:  Hold'em No Limit ($0.01/$0.02 USD) - 20=
17/05/02 23:55:45 CUST [2017/05/02 9:55:45 ET]
Table 'Botha' 9-max Seat #4 is the button
Seat 2: infiniti888 ($1.45 in chips)=20
Seat 3: Sprut2013 ($2.41 in chips)=20
Seat 4: Leopoker888 ($2.01 in chips)=20
Seat 5: Tikinh00 ($2.05 in chips)=20
Seat 6: taikroko ($2 in chips)=20
Seat 7: the_wickstar ($4.98 in chips)=20
Seat 8: psvworks ($2.10 in chips)=20
Seat 9: Demonidze31 ($2.09 in chips)=20
Tikinh00: posts small blind $0.01
taikroko: posts big blind $0.02
*** HOLE CARDS ***
Dealt to the_wickstar [6d Tc]
the_wickstar: folds=20
psvworks: folds=20
Demonidze31: folds=20
infiniti888: folds=20
Sprut2013: calls $0.02
the_wickstar leaves the table
Leopoker888: raises $0.06 to $0.08
Nagim M. joins the table at seat #7=20
Tikinh00: folds=20
taikroko: folds=20
Sprut2013: folds=20
Uncalled bet ($0.06) returned to Leopoker888
Leopoker888 collected $0.07 from pot
Leopoker888: doesn't show hand=20
*** SUMMARY ***
Total pot $0.07 | Rake $0=20
Seat 2: infiniti888 folded before Flop (didn't bet)
Seat 3: Sprut2013 folded before Flop
Seat 4: Leopoker888 (button) collected ($0.07)
Seat 5: Tikinh00 (small blind) folded before Flop
Seat 6: taikroko (big blind) folded before Flop
Seat 7: the_wickstar folded before Flop (didn't bet)
Seat 8: psvworks folded before Flop (didn't bet)
Seat 9: Demonidze31 folded before Flop (didn't bet)


*********** # 3 **************
PokerStars Hand #169852022458:  Hold'em No Limit ($0.01/$0.02 USD) - 20=
17/05/02 23:55:41 CUST [2017/05/02 9:55:41 ET]
Table 'Telephus' 9-max Seat #5 is the button
Seat 1: the_wickstar ($1.55 in chips)=20
Seat 2: reivaj491 ($2 in chips)=20
Seat 3: Humanfritz ($2.79 in chips)=20
Seat 5: hihishka ($1.04 in chips)=20
Seat 8: 1tillit1 ($2.05 in chips)=20
Seat 9: iskarian ($2.10 in chips)=20
1tillit1: posts small blind $0.01
iskarian: posts big blind $0.02
*** HOLE CARDS ***
Dealt to the_wickstar [Qh Qd]
the_wickstar: raises $0.04 to $0.06
reivaj491: folds=20
Humanfritz: calls $0.06
hihishka: calls $0.06
1tillit1: folds=20
iskarian: folds=20
*** FLOP *** [6c 5h 3s]
the_wickstar: bets $0.15
Humanfritz: folds=20
hihishka: folds=20
Uncalled bet ($0.15) returned to the_wickstar
the_wickstar collected $0.20 from pot
*** SUMMARY ***
Total pot $0.21 | Rake $0.01=20
Board [6c 5h 3s]
Seat 1: the_wickstar collected ($0.20)
Seat 2: reivaj491 folded before Flop (didn't bet)
Seat 3: Humanfritz folded on the Flop
Seat 5: hihishka (button) folded on the Flop
Seat 8: 1tillit1 (small blind) folded before Flop
Seat 9: iskarian (big blind) folded before Flop


*********** # 4 **************
PokerStars Hand #169852000008:  Hold'em No Limit ($0.01/$0.02 USD) - 20=
17/05/02 23:54:56 CUST [2017/05/02 9:54:56 ET]
Table 'Botha' 9-max Seat #3 is the button
Seat 2: infiniti888 ($1.45 in chips)=20
Seat 3: Sprut2013 ($2.41 in chips)=20
Seat 4: Leopoker888 ($1.97 in chips)=20
Seat 5: Tikinh00 ($2.07 in chips)=20
Seat 7: the_wickstar ($5 in chips)=20
Seat 8: psvworks ($2.10 in chips)=20
Seat 9: Demonidze31 ($2.09 in chips)=20
Leopoker888: posts small blind $0.01
Tikinh00: posts big blind $0.02
taikroko: sits out=20
*** HOLE CARDS ***
Dealt to the_wickstar [Ks Th]
the_wickstar: calls $0.02
psvworks: folds=20
Demonidze31: folds=20
infiniti888: folds=20
Sprut2013: folds=20
Leopoker888: raises $0.06 to $0.08
Tikinh00: folds=20
the_wickstar: folds=20
Uncalled bet ($0.06) returned to Leopoker888
Leopoker888 collected $0.06 from pot
Leopoker888: doesn't show hand=20
*** SUMMARY ***
Total pot $0.06 | Rake $0=20
Seat 2: infiniti888 folded before Flop (didn't bet)
Seat 3: Sprut2013 (button) folded before Flop (didn't bet)
Seat 4: Leopoker888 (small blind) collected ($0.06)
Seat 5: Tikinh00 (big blind) folded before Flop
Seat 7: the_wickstar folded before Flop
Seat 8: psvworks folded before Flop (didn't bet)
Seat 9: Demonidze31 folded before Flop (didn't bet)


*********** # 5 **************
PokerStars Hand #169851995638:  Hold'em No Limit ($0.01/$0.02 USD) - 20=
17/05/02 23:54:48 CUST [2017/05/02 9:54:48 ET]
Table 'Telephus' 9-max Seat #3 is the button
Seat 1: the_wickstar ($1.49 in chips)=20
Seat 2: reivaj491 ($2 in chips)=20
Seat 3: Humanfritz ($2.79 in chips)=20
Seat 5: hihishka ($1.05 in chips)=20
Seat 8: 1tillit1 ($2.10 in chips)=20
Seat 9: iskarian ($2.10 in chips)=20
hihishka: posts small blind $0.01
IceAngel82: is sitting out=20
GlobysBan: is sitting out=20
1tillit1: posts big blind $0.02
*** HOLE CARDS ***
Dealt to the_wickstar [Jh Ks]
iskarian: folds=20
GlobysBan leaves the table
the_wickstar: calls $0.02
reivaj491: folds=20
Humanfritz: folds=20
hihishka: folds=20
1tillit1: checks=20
*** FLOP *** [Jd Qc 7c]
1tillit1: bets $0.03
the_wickstar: calls $0.03
*** TURN *** [Jd Qc 7c] [8h]
1tillit1: checks=20
the_wickstar: checks=20
*** RIVER *** [Jd Qc 7c 8h] [Qs]
1tillit1: checks=20
the_wickstar: checks=20
*** SHOW DOWN ***
1tillit1: shows [6d 8s] (two pair, Queens and Eights)
the_wickstar: shows [Jh Ks] (two pair, Queens and Jacks)
the_wickstar collected $0.11 from pot
*** SUMMARY ***
Total pot $0.11 | Rake $0=20
Board [Jd Qc 7c 8h Qs]
Seat 1: the_wickstar showed [Jh Ks] and won ($0.11) with two pair, Quee=
ns and Jacks
Seat 2: reivaj491 folded before Flop (didn't bet)
Seat 3: Humanfritz (button) folded before Flop (didn't bet)
Seat 5: hihishka (small blind) folded before Flop
Seat 8: 1tillit1 (big blind) showed [6d 8s] and lost with two pair, Que=
ens and Eights
Seat 9: iskarian folded before Flop (didn't bet)


*********** # 6 **************
PokerStars Hand #169851979790:  Hold'em No Limit ($0.01/$0.02 USD) - 20=
17/05/02 23:54:20 CUST [2017/05/02 9:54:20 ET]
Table 'Botha' 9-max Seat #2 is the button
Seat 2: infiniti888 ($1.45 in chips)=20
Seat 3: Sprut2013 ($2.39 in chips)=20
Seat 4: Leopoker888 ($1.99 in chips)=20
Seat 5: Tikinh00 ($2.07 in chips)=20
Seat 7: the_wickstar ($5 in chips)=20
Seat 8: psvworks ($2.10 in chips)=20
Seat 9: Demonidze31 ($2.09 in chips)=20
Sprut2013: posts small blind $0.01
Leopoker888: posts big blind $0.02
taikroko: sits out=20
*** HOLE CARDS ***
Dealt to the_wickstar [Qc Td]
Tikinh00: folds=20
the_wickstar: folds=20
psvworks: folds=20
Demonidze31: folds=20
infiniti888: folds=20
Sprut2013: calls $0.01
Leopoker888: checks=20
*** FLOP *** [8d 8s 8h]
Sprut2013: bets $0.02
Leopoker888: folds=20
Uncalled bet ($0.02) returned to Sprut2013
Sprut2013 collected $0.04 from pot
Sprut2013: doesn't show hand=20
*** SUMMARY ***
Total pot $0.04 | Rake $0=20
Board [8d 8s 8h]
Seat 2: infiniti888 (button) folded before Flop (didn't bet)
Seat 3: Sprut2013 (small blind) collected ($0.04)
Seat 4: Leopoker888 (big blind) folded on the Flop
Seat 5: Tikinh00 folded before Flop (didn't bet)
Seat 7: the_wickstar folded before Flop (didn't bet)
Seat 8: psvworks folded before Flop (didn't bet)
Seat 9: Demonidze31 folded before Flop (didn't bet)


*********** # 7 **************
PokerStars Hand #169851977471:  Hold'em No Limit ($0.01/$0.02 USD) - 20=
17/05/02 23:54:15 CUST [2017/05/02 9:54:15 ET]
Table 'Telephus' 9-max Seat #2 is the button
Seat 1: the_wickstar ($1.49 in chips)=20
Seat 2: reivaj491 ($2 in chips)=20
Seat 3: Humanfritz ($2.80 in chips)=20
Seat 5: hihishka ($1.04 in chips)=20
Seat 6: IceAngel82 ($2 in chips)=20
Seat 7: GlobysBan ($4.27 in chips)=20
Seat 8: 1tillit1 ($2.10 in chips)=20
Seat 9: iskarian ($2.10 in chips)=20
Humanfritz: posts small blind $0.01
hihishka: posts big blind $0.02
*** HOLE CARDS ***
Dealt to the_wickstar [Ad 6d]
IceAngel82: folds=20
GlobysBan: folds=20
1tillit1: folds=20
iskarian: folds=20
the_wickstar: folds=20
reivaj491: folds=20
Humanfritz: folds=20
Uncalled bet ($0.01) returned to hihishka
hihishka collected $0.02 from pot
*** SUMMARY ***
Total pot $0.02 | Rake $0=20
Seat 1: the_wickstar folded before Flop (didn't bet)
Seat 2: reivaj491 (button) folded before Flop (didn't bet)
Seat 3: Humanfritz (small blind) folded before Flop
Seat 5: hihishka (big blind) collected ($0.02)
Seat 6: IceAngel82 folded before Flop (didn't bet)
Seat 7: GlobysBan folded before Flop (didn't bet)
Seat 8: 1tillit1 folded before Flop (didn't bet)
Seat 9: iskarian folded before Flop (didn't bet)


*********** # 8 **************
PokerStars Hand #169851964442:  Hold'em No Limit ($0.01/$0.02 USD) - 20=
17/05/02 23:53:52 CUST [2017/05/02 9:53:52 ET]
Table 'Telephus' 9-max Seat #1 is the button
Seat 1: the_wickstar ($1.49 in chips)=20
Seat 2: reivaj491 ($2 in chips)=20
Seat 3: Humanfritz ($2.79 in chips)=20
Seat 5: hihishka ($1.04 in chips)=20
Seat 6: IceAngel82 ($2 in chips)=20
Seat 7: GlobysBan ($4.27 in chips)=20
Seat 8: 1tillit1 ($2.10 in chips)=20
Seat 9: iskarian ($2.10 in chips)=20
reivaj491: posts small blind $0.01
Humanfritz: posts big blind $0.02
*** HOLE CARDS ***
Dealt to the_wickstar [Js 5s]
hihishka: folds=20
IceAngel82: folds=20
GlobysBan: folds=20
1tillit1: folds=20
iskarian: folds=20
the_wickstar: folds=20
reivaj491: folds=20
Uncalled bet ($0.01) returned to Humanfritz
Humanfritz collected $0.02 from pot
Humanfritz: doesn't show hand=20
*** SUMMARY ***
Total pot $0.02 | Rake $0=20
Seat 1: the_wickstar (button) folded before Flop (didn't bet)
Seat 2: reivaj491 (small blind) folded before Flop
Seat 3: Humanfritz (big blind) collected ($0.02)
Seat 5: hihishka folded before Flop (didn't bet)
Seat 6: IceAngel82 folded before Flop (didn't bet)
Seat 7: GlobysBan folded before Flop (didn't bet)
Seat 8: 1tillit1 folded before Flop (didn't bet)
Seat 9: iskarian folded before Flop (didn't bet)


*********** # 9 **************
PokerStars Hand #169851950500:  Hold'em No Limit ($0.01/$0.02 USD) - 20=
17/05/02 23:53:27 CUST [2017/05/02 9:53:27 ET]
Table 'Botha' 9-max Seat #9 is the button
Seat 2: infiniti888 ($1.45 in chips)=20
Seat 3: Sprut2013 ($2.43 in chips)=20
Seat 4: Leopoker888 ($1.99 in chips)=20
Seat 5: Tikinh00 ($2.11 in chips)=20
Seat 7: the_wickstar ($5 in chips)=20
Seat 8: psvworks ($2.10 in chips)=20
Seat 9: Demonidze31 ($2 in chips)=20
infiniti888: posts small blind $0.01
Sprut2013: posts big blind $0.02
taikroko: sits out=20
*** HOLE CARDS ***
Dealt to the_wickstar [Qd 4d]
Leopoker888: folds=20
Tikinh00: calls $0.02
the_wickstar: folds=20
psvworks: folds=20
Demonidze31: raises $0.02 to $0.04
infiniti888: folds=20
Sprut2013: calls $0.02
Tikinh00: calls $0.02
*** FLOP *** [2s Td 9h]
Sprut2013: checks=20
Tikinh00: checks=20
Demonidze31: checks=20
*** TURN *** [2s Td 9h] [4h]
Sprut2013: checks=20
Tikinh00: checks=20
Demonidze31: checks=20
*** RIVER *** [2s Td 9h 4h] [2c]
Sprut2013: checks=20
Tikinh00: checks=20
Demonidze31: checks=20
*** SHOW DOWN ***
Sprut2013: shows [Jh 5d] (a pair of Deuces)
Tikinh00: shows [Ah Qc] (a pair of Deuces - Ace kicker)
Demonidze31: shows [7h 7d] (two pair, Sevens and Deuces)
Demonidze31 collected $0.13 from pot
*** SUMMARY ***
Total pot $0.13 | Rake $0=20
Board [2s Td 9h 4h 2c]
Seat 2: infiniti888 (small blind) folded before Flop
Seat 3: Sprut2013 (big blind) showed [Jh 5d] and lost with a pair of De=
uces
Seat 4: Leopoker888 folded before Flop (didn't bet)
Seat 5: Tikinh00 showed [Ah Qc] and lost with a pair of Deuces
Seat 7: the_wickstar folded before Flop (didn't bet)
Seat 8: psvworks folded before Flop (didn't bet)
Seat 9: Demonidze31 (button) showed [7h 7d] and won ($0.13) with two pa=
ir, Sevens and Deuces


*********** # 10 **************
PokerStars Hand #169851918334:  Hold'em No Limit ($0.01/$0.02 USD) - 20=
17/05/02 23:52:28 CUST [2017/05/02 9:52:28 ET]
Table 'Telephus' 9-max Seat #9 is the button
Seat 1: the_wickstar ($1.50 in chips)=20
Seat 2: reivaj491 ($2 in chips)=20
Seat 3: Humanfritz ($2.79 in chips)=20
Seat 5: hihishka ($0.83 in chips)=20
Seat 6: IceAngel82 ($2 in chips)=20
Seat 7: GlobysBan ($4.27 in chips)=20
Seat 8: 1tillit1 ($2.30 in chips)=20
Seat 9: iskarian ($2.10 in chips)=20
the_wickstar: posts small blind $0.01
reivaj491: posts big blind $0.02
*** HOLE CARDS ***
Dealt to the_wickstar [8d 3c]
Humanfritz: folds=20
hihishka: raises $0.04 to $0.06
IceAngel82: folds=20
GlobysBan: folds=20
1tillit1: calls $0.06
iskarian: folds=20
the_wickstar: folds=20
reivaj491: folds=20
*** FLOP *** [6s 2d 3s]
hihishka: bets $0.14
IIVadimII is disconnected=20
1tillit1: calls $0.14
*** TURN *** [6s 2d 3s] [9s]
hihishka: bets $0.24
1tillit1: folds=20
Uncalled bet ($0.24) returned to hihishka
hihishka collected $0.41 from pot
*** SUMMARY ***
Total pot $0.43 | Rake $0.02=20
Board [6s 2d 3s 9s]
Seat 1: the_wickstar (small blind) folded before Flop
Seat 2: reivaj491 (big blind) folded before Flop
Seat 3: Humanfritz folded before Flop (didn't bet)
Seat 5: hihishka collected ($0.41)
Seat 6: IceAngel82 folded before Flop (didn't bet)
Seat 7: GlobysBan folded before Flop (didn't bet)
Seat 8: 1tillit1 folded on the Turn
Seat 9: iskarian (button) folded before Flop (didn't bet)


*********** # 11 **************
PokerStars Hand #169851912639:  Hold'em No Limit ($0.01/$0.02 USD) - 20=
17/05/02 23:52:18 CUST [2017/05/02 9:52:18 ET]
Table 'Botha' 9-max Seat #8 is the button
Seat 2: infiniti888 ($1.45 in chips)=20
Seat 3: Sprut2013 ($2.43 in chips)=20
Seat 4: Leopoker888 ($1.99 in chips)=20
Seat 5: Tikinh00 ($2.07 in chips)=20
Seat 7: the_wickstar ($5 in chips)=20
Seat 8: psvworks ($2.10 in chips)=20
Seat 9: Demonidze31 ($2 in chips)=20
Demonidze31: posts small blind $0.01
IceAngel82: is sitting out=20
infiniti888: posts big blind $0.02
taikroko: sits out=20
*** HOLE CARDS ***
Dealt to the_wickstar [Js 5c]
Sprut2013: folds=20
Leopoker888: folds=20
Tikinh00: calls $0.02
the_wickstar: folds=20
psvworks: folds=20
Demonidze31: calls $0.01
infiniti888: checks=20
*** FLOP *** [6h 2c 3s]
Demonidze31: checks=20
infiniti888: checks=20
Tikinh00: checks=20
*** TURN *** [6h 2c 3s] [9h]
Demonidze31: checks=20
infiniti888: checks=20
Tikinh00: checks=20
*** RIVER *** [6h 2c 3s 9h] [6s]
Demonidze31: checks=20
infiniti888: checks=20
Tikinh00: bets $0.02
Demonidze31: folds=20
infiniti888: folds=20
Uncalled bet ($0.02) returned to Tikinh00
Tikinh00 collected $0.06 from pot
Tikinh00: doesn't show hand=20
*** SUMMARY ***
Total pot $0.06 | Rake $0=20
Board [6h 2c 3s 9h 6s]
Seat 2: infiniti888 (big blind) folded on the River
Seat 3: Sprut2013 folded before Flop (didn't bet)
Seat 4: Leopoker888 folded before Flop (didn't bet)
Seat 5: Tikinh00 collected ($0.06)
Seat 7: the_wickstar folded before Flop (didn't bet)
Seat 8: psvworks (button) folded before Flop (didn't bet)
Seat 9: Demonidze31 (small blind) folded on the River


*********** # 12 **************
PokerStars Hand #169851899554:  Hold'em No Limit ($0.01/$0.02 USD) - 20=
17/05/02 23:51:54 CUST [2017/05/02 9:51:54 ET]
Table 'Botha' 9-max Seat #7 is the button
Seat 1: IceAngel82 ($3.78 in chips)=20
Seat 2: infiniti888 ($1.45 in chips)=20
Seat 3: Sprut2013 ($2.43 in chips)=20
Seat 4: Leopoker888 ($1.99 in chips)=20
Seat 5: Tikinh00 ($2.07 in chips)=20
Seat 7: the_wickstar ($5 in chips)=20
Seat 8: psvworks ($2.08 in chips)=20
Seat 9: Demonidze31 ($2 in chips)=20
psvworks: posts small blind $0.01
Demonidze31: posts big blind $0.02
taikroko: sits out=20
*** HOLE CARDS ***
Dealt to the_wickstar [4h 3h]
IceAngel82: folds=20
infiniti888: folds=20
Sprut2013: folds=20
Leopoker888: folds=20
Tikinh00: folds=20
the_wickstar: folds=20
psvworks: raises $0.04 to $0.06
Demonidze31: folds=20
Uncalled bet ($0.04) returned to psvworks
psvworks collected $0.04 from pot
*** SUMMARY ***
Total pot $0.04 | Rake $0=20
Seat 1: IceAngel82 folded before Flop (didn't bet)
Seat 2: infiniti888 folded before Flop (didn't bet)
Seat 3: Sprut2013 folded before Flop (didn't bet)
Seat 4: Leopoker888 folded before Flop (didn't bet)
Seat 5: Tikinh00 folded before Flop (didn't bet)
Seat 7: the_wickstar (button) folded before Flop (didn't bet)
Seat 8: psvworks (small blind) collected ($0.04)
Seat 9: Demonidze31 (big blind) folded before Flop


*********** # 13 **************
PokerStars Hand #169851893199:  Hold'em No Limit ($0.01/$0.02 USD) - 20=
17/05/02 23:51:42 CUST [2017/05/02 9:51:42 ET]
Table 'Telephus' 9-max Seat #8 is the button
Seat 1: the_wickstar ($1.52 in chips)=20
Seat 3: Humanfritz ($2.79 in chips)=20
Seat 5: hihishka ($0.80 in chips)=20
Seat 6: IceAngel82 ($2 in chips)=20
Seat 7: GlobysBan ($4.27 in chips)=20
Seat 8: 1tillit1 ($2.30 in chips)=20
Seat 9: iskarian ($2.11 in chips)=20
iskarian: posts small blind $0.01
the_wickstar: posts big blind $0.02
IIVadimII is disconnected=20
reivaj491: sits out=20
IIVadimII has timed out while disconnected
IIVadimII: is sitting out=20
hihishka: posts big blind $0.02
*** HOLE CARDS ***
Dealt to the_wickstar [8h 5d]
Humanfritz: folds=20
hihishka: raises $0.04 to $0.06
IceAngel82: folds=20
GlobysBan: folds=20
1tillit1: folds=20
iskarian: folds=20
the_wickstar: folds=20
Uncalled bet ($0.04) returned to hihishka
hihishka collected $0.05 from pot
*** SUMMARY ***
Total pot $0.05 | Rake $0=20
Seat 1: the_wickstar (big blind) folded before Flop
Seat 3: Humanfritz folded before Flop (didn't bet)
Seat 5: hihishka collected ($0.05)
Seat 6: IceAngel82 folded before Flop (didn't bet)
Seat 7: GlobysBan folded before Flop (didn't bet)
Seat 8: 1tillit1 (button) folded before Flop (didn't bet)
Seat 9: iskarian (small blind) folded before Flop


*********** # 14 **************
PokerStars Hand #169851848418:  Hold'em No Limit ($0.01/$0.02 USD) - 20=
17/05/02 23:50:21 CUST [2017/05/02 9:50:21 ET]
Table 'Botha' 9-max Seat #5 is the button
Seat 1: IceAngel82 ($3.88 in chips)=20
Seat 2: infiniti888 ($1.45 in chips)=20
Seat 3: Sprut2013 ($2.43 in chips)=20
Seat 4: Leopoker888 ($1.99 in chips)=20
Seat 5: Tikinh00 ($2.07 in chips)=20
Seat 7: the_wickstar ($2.53 in chips)=20
Seat 8: psvworks ($2.10 in chips)=20
Seat 9: Demonidze31 ($2.55 in chips)=20
taikroko will be allowed to play after the button
the_wickstar: posts small blind $0.01
psvworks: posts big blind $0.02
*** HOLE CARDS ***
Dealt to the_wickstar [Td Tc]
Demonidze31: raises $0.02 to $0.04
IceAngel82: raises $0.06 to $0.10
infiniti888: folds=20
Sprut2013: folds=20
Leopoker888: folds=20
Tikinh00: folds=20
the_wickstar: calls $0.09
psvworks: folds=20
Demonidze31: calls $0.06
*** FLOP *** [8d Ts 4s]
the_wickstar: bets $0.31
Demonidze31: calls $0.31
IceAngel82: folds=20
*** TURN *** [8d Ts 4s] [2d]
the_wickstar: bets $0.91
Demonidze31: raises $0.91 to $1.82
the_wickstar: calls $0.91
*** RIVER *** [8d Ts 4s 2d] [2c]
the_wickstar: bets $0.30 and is all-in
Demonidze31: calls $0.30
*** SHOW DOWN ***
the_wickstar: shows [Td Tc] (a full house, Tens full of Deuces)
Demonidze31: shows [8h 8c] (a full house, Eights full of Deuces)
the_wickstar collected $5 from pot
*** SUMMARY ***
Total pot $5.18 | Rake $0.18=20
Board [8d Ts 4s 2d 2c]
Seat 1: IceAngel82 folded on the Flop
Seat 2: infiniti888 folded before Flop (didn't bet)
Seat 3: Sprut2013 folded before Flop (didn't bet)
Seat 4: Leopoker888 folded before Flop (didn't bet)
Seat 5: Tikinh00 (button) folded before Flop (didn't bet)
Seat 7: the_wickstar (small blind) showed [Td Tc] and won ($5) with a f=
ull house, Tens full of Deuces
Seat 8: psvworks (big blind) folded before Flop
Seat 9: Demonidze31 showed [8h 8c] and lost with a full house, Eights f=
ull of Deuces


*********** # 15 **************
PokerStars Hand #169851838958:  Hold'em No Limit ($0.01/$0.02 USD) - 20=
17/05/02 23:50:03 CUST [2017/05/02 9:50:03 ET]
Table 'Telephus' 9-max Seat #7 is the button
Seat 1: the_wickstar ($1.52 in chips)=20
Seat 3: Humanfritz ($2.79 in chips)=20
Seat 5: rockstar1307 ($1.68 in chips)=20
Seat 6: IceAngel82 ($2 in chips)=20
Seat 7: GlobysBan ($4.27 in chips)=20
Seat 8: 1tillit1 ($2.42 in chips)=20
Seat 9: iskarian ($2 in chips)=20
1tillit1: posts small blind $0.01
iskarian: posts big blind $0.02
reivaj491: sits out=20
IIVadimII is disconnected=20
IIVadimII has timed out while disconnected
IIVadimII: is sitting out=20
*** HOLE CARDS ***
Dealt to the_wickstar [Ts 8h]
the_wickstar: folds=20
Humanfritz: folds=20
rockstar1307: folds=20
rockstar1307 leaves the table
IceAngel82: folds=20
GlobysBan: folds=20
1tillit1: raises $0.04 to $0.06
iskarian: calls $0.04
*** FLOP *** [8s Th Qs]
hihishka joins the table at seat #5=20
1tillit1: bets $0.06
iskarian: calls $0.06
*** TURN *** [8s Th Qs] [6d]
1tillit1: checks=20
iskarian: bets $0.12
1tillit1: folds=20
Uncalled bet ($0.12) returned to iskarian
iskarian collected $0.23 from pot
iskarian: doesn't show hand=20
*** SUMMARY ***
Total pot $0.24 | Rake $0.01=20
Board [8s Th Qs 6d]
Seat 1: the_wickstar folded before Flop (didn't bet)
Seat 3: Humanfritz folded before Flop (didn't bet)
Seat 5: rockstar1307 folded before Flop (didn't bet)
Seat 6: IceAngel82 folded before Flop (didn't bet)
Seat 7: GlobysBan (button) folded before Flop (didn't bet)
Seat 8: 1tillit1 (small blind) folded on the Turn
Seat 9: iskarian (big blind) collected ($0.23)


*********** # 16 **************
PokerStars Hand #169851805858:  Hold'em No Limit ($0.01/$0.02 USD) - 20=
17/05/02 23:49:03 CUST [2017/05/02 9:49:03 ET]
Table 'Botha' 9-max Seat #4 is the button
Seat 1: IceAngel82 ($3.88 in chips)=20
Seat 2: infiniti888 ($1.45 in chips)=20
Seat 3: Sprut2013 ($2.43 in chips)=20
Seat 4: Leopoker888 ($1.89 in chips)=20
Seat 5: Tikinh00 ($2.08 in chips)=20
Seat 6: diment76 ($1.86 in chips)=20
Seat 7: the_wickstar ($2.61 in chips)=20
Seat 8: psvworks ($2.10 in chips)=20
Seat 9: Demonidze31 ($2.55 in chips)=20
Tikinh00: posts small blind $0.01
diment76: posts big blind $0.02
*** HOLE CARDS ***
Dealt to the_wickstar [Qh Ah]
the_wickstar: calls $0.02
psvworks: folds=20
Demonidze31: folds=20
IceAngel82: folds=20
infiniti888: folds=20
Sprut2013: folds=20
Leopoker888: raises $0.06 to $0.08
Tikinh00: folds=20
diment76: folds=20
the_wickstar: calls $0.06
*** FLOP *** [6d 6h 2c]
diment76 leaves the table
taikroko joins the table at seat #6=20
the_wickstar: checks=20
Leopoker888: bets $0.10
the_wickstar: folds=20
Uncalled bet ($0.10) returned to Leopoker888
Leopoker888 collected $0.18 from pot
Leopoker888: doesn't show hand=20
*** SUMMARY ***
Total pot $0.19 | Rake $0.01=20
Board [6d 6h 2c]
Seat 1: IceAngel82 folded before Flop (didn't bet)
Seat 2: infiniti888 folded before Flop (didn't bet)
Seat 3: Sprut2013 folded before Flop (didn't bet)
Seat 4: Leopoker888 (button) collected ($0.18)
Seat 5: Tikinh00 (small blind) folded before Flop
Seat 6: diment76 (big blind) folded before Flop
Seat 7: the_wickstar folded on the Flop
Seat 8: psvworks folded before Flop (didn't bet)
Seat 9: Demonidze31 folded before Flop (didn't bet)


*********** # 17 **************
PokerStars Hand #169851805000:  Hold'em No Limit ($0.01/$0.02 USD) - 20=
17/05/02 23:49:01 CUST [2017/05/02 9:49:01 ET]
Table 'Telephus' 9-max Seat #6 is the button
Seat 1: the_wickstar ($1.52 in chips)=20
Seat 3: Humanfritz ($2.79 in chips)=20
Seat 5: rockstar1307 ($1.68 in chips)=20
Seat 6: IceAngel82 ($2 in chips)=20
Seat 7: GlobysBan ($4.19 in chips)=20
Seat 8: 1tillit1 ($2.44 in chips)=20
Seat 9: iskarian ($2 in chips)=20
GlobysBan: posts small blind $0.01
1tillit1: posts big blind $0.02
reivaj491: sits out=20
IIVadimII: sits out=20
*** HOLE CARDS ***
Dealt to the_wickstar [8s Qc]
iskarian: folds=20
the_wickstar: folds=20
Humanfritz: folds=20
rockstar1307: folds=20
IceAngel82: raises $0.04 to $0.06
GlobysBan: calls $0.05
1tillit1: folds=20
*** FLOP *** [7h 2h 3h]
GlobysBan: checks=20
IceAngel82: checks=20
*** TURN *** [7h 2h 3h] [Jh]
GlobysBan: bets $0.07
IceAngel82: folds=20
Uncalled bet ($0.07) returned to GlobysBan
GlobysBan collected $0.14 from pot
*** SUMMARY ***
Total pot $0.14 | Rake $0=20
Board [7h 2h 3h Jh]
Seat 1: the_wickstar folded before Flop (didn't bet)
Seat 3: Humanfritz folded before Flop (didn't bet)
Seat 5: rockstar1307 folded before Flop (didn't bet)
Seat 6: IceAngel82 (button) folded on the Turn
Seat 7: GlobysBan (small blind) collected ($0.14)
Seat 8: 1tillit1 (big blind) folded before Flop
Seat 9: iskarian folded before Flop (didn't bet)


*********** # 18 **************
PokerStars Hand #169851793502:  Hold'em No Limit ($0.01/$0.02 USD) - 20=
17/05/02 23:48:40 CUST [2017/05/02 9:48:40 ET]
Table 'Telephus' 9-max Seat #5 is the button
Seat 1: the_wickstar ($1.52 in chips)=20
Seat 3: Humanfritz ($2.79 in chips)=20
Seat 5: rockstar1307 ($1.68 in chips)=20
Seat 6: IceAngel82 ($2.01 in chips)=20
Seat 7: GlobysBan ($4.18 in chips)=20
Seat 8: 1tillit1 ($2.44 in chips)=20
Seat 9: iskarian ($2 in chips)=20
IceAngel82: posts small blind $0.01
GlobysBan: posts big blind $0.02
reivaj491: sits out=20
IIVadimII: sits out=20
*** HOLE CARDS ***
Dealt to the_wickstar [6h 4s]
1tillit1: folds=20
iskarian: folds=20
the_wickstar: folds=20
Humanfritz: folds=20
rockstar1307: folds=20
IceAngel82: folds=20
Uncalled bet ($0.01) returned to GlobysBan
GlobysBan collected $0.02 from pot
*** SUMMARY ***
Total pot $0.02 | Rake $0=20
Seat 1: the_wickstar folded before Flop (didn't bet)
Seat 3: Humanfritz folded before Flop (didn't bet)
Seat 5: rockstar1307 (button) folded before Flop (didn't bet)
Seat 6: IceAngel82 (small blind) folded before Flop
Seat 7: GlobysBan (big blind) collected ($0.02)
Seat 8: 1tillit1 folded before Flop (didn't bet)
Seat 9: iskarian folded before Flop (didn't bet)


*********** # 19 **************
PokerStars Hand #169851785640:  Hold'em No Limit ($0.01/$0.02 USD) - 20=
17/05/02 23:48:26 CUST [2017/05/02 9:48:26 ET]
Table 'Telephus' 9-max Seat #3 is the button
Seat 1: the_wickstar ($1.52 in chips)=20
Seat 3: Humanfritz ($2.79 in chips)=20
Seat 5: rockstar1307 ($1.69 in chips)=20
Seat 6: IceAngel82 ($2 in chips)=20
Seat 7: GlobysBan ($4.18 in chips)=20
Seat 8: 1tillit1 ($2.44 in chips)=20
Seat 9: iskarian ($2 in chips)=20
IIVadimII will be allowed to play after the button
rockstar1307: posts small blind $0.01
IceAngel82: posts big blind $0.02
*** HOLE CARDS ***
Dealt to the_wickstar [Jh 5d]
GlobysBan: folds=20
1tillit1: folds=20
iskarian: folds=20
the_wickstar: folds=20
pdilaccio leaves the table
Humanfritz: folds=20
reivaj491 joins the table at seat #2=20
rockstar1307: folds=20
Uncalled bet ($0.01) returned to IceAngel82
IceAngel82 collected $0.02 from pot
IceAngel82: doesn't show hand=20
*** SUMMARY ***
Total pot $0.02 | Rake $0=20
Seat 1: the_wickstar folded before Flop (didn't bet)
Seat 3: Humanfritz (button) folded before Flop (didn't bet)
Seat 5: rockstar1307 (small blind) folded before Flop
Seat 6: IceAngel82 (big blind) collected ($0.02)
Seat 7: GlobysBan folded before Flop (didn't bet)
Seat 8: 1tillit1 folded before Flop (didn't bet)
Seat 9: iskarian folded before Flop (didn't bet)


*********** # 20 **************
PokerStars Hand #169851763037:  Hold'em No Limit ($0.01/$0.02 USD) - 20=
17/05/02 23:47:45 CUST [2017/05/02 9:47:45 ET]
Table 'Telephus' 9-max Seat #2 is the button
Seat 1: the_wickstar ($1.52 in chips)=20
Seat 2: pdilaccio ($0.79 in chips)=20
Seat 3: Humanfritz ($2.04 in chips)=20
Seat 5: rockstar1307 ($1.71 in chips)=20
Seat 6: IceAngel82 ($2 in chips)=20
Seat 7: GlobysBan ($4.18 in chips)=20
Seat 8: 1tillit1 ($2.44 in chips)=20
Seat 9: iskarian ($2 in chips)=20
Humanfritz: posts small blind $0.01
rockstar1307: posts big blind $0.02
*** HOLE CARDS ***
Dealt to the_wickstar [6c 8s]
IceAngel82: folds=20
GlobysBan: folds=20
1tillit1: folds=20
iskarian: folds=20
the_wickstar: folds=20
pdilaccio: calls $0.02
Humanfritz: raises $0.07 to $0.09
rockstar1307: folds=20
pdilaccio: raises $0.70 to $0.79 and is all-in
Humanfritz: calls $0.70
*** FLOP *** [Jh 9c 9d]
*** TURN *** [Jh 9c 9d] [Jd]
*** RIVER *** [Jh 9c 9d Jd] [7h]
*** SHOW DOWN ***
Humanfritz: shows [Ah Kd] (two pair, Jacks and Nines)
pdilaccio: shows [2h 2c] (two pair, Jacks and Nines - lower kicker)
Humanfritz collected $1.54 from pot
*** SUMMARY ***
Total pot $1.60 | Rake $0.06=20
Board [Jh 9c 9d Jd 7h]
Seat 1: the_wickstar folded before Flop (didn't bet)
Seat 2: pdilaccio (button) showed [2h 2c] and lost with two pair, Jacks=
 and Nines
Seat 3: Humanfritz (small blind) showed [Ah Kd] and won ($1.54) with tw=
o pair, Jacks and Nines
Seat 5: rockstar1307 (big blind) folded before Flop
Seat 6: IceAngel82 folded before Flop (didn't bet)
Seat 7: GlobysBan folded before Flop (didn't bet)
Seat 8: 1tillit1 folded before Flop (didn't bet)
Seat 9: iskarian folded before Flop (didn't bet)


*********** # 21 **************
PokerStars Hand #169851751993:  Hold'em No Limit ($0.01/$0.02 USD) - 20=
17/05/02 23:47:24 CUST [2017/05/02 9:47:24 ET]
Table 'Botha' 9-max Seat #3 is the button
Seat 1: IceAngel82 ($3.73 in chips)=20
Seat 2: infiniti888 ($1.45 in chips)=20
Seat 3: Sprut2013 ($2.47 in chips)=20
Seat 4: Leopoker888 ($1.93 in chips)=20
Seat 5: Tikinh00 ($2.12 in chips)=20
Seat 6: diment76 ($1.86 in chips)=20
Seat 7: the_wickstar ($2.61 in chips)=20
Seat 8: psvworks ($2.10 in chips)=20
Seat 9: Demonidze31 ($2.59 in chips)=20
Leopoker888: posts small blind $0.01
Tikinh00: posts big blind $0.02
*** HOLE CARDS ***
Dealt to the_wickstar [3s 5c]
diment76: folds=20
the_wickstar: folds=20
psvworks: folds=20
Demonidze31: raises $0.02 to $0.04
IceAngel82: calls $0.04
infiniti888: folds=20
Sprut2013: calls $0.04
Leopoker888: calls $0.03
Tikinh00: calls $0.02
*** FLOP *** [Kd 3d 4d]
Leopoker888: checks=20
Tikinh00: checks=20
Demonidze31: checks=20
IceAngel82: checks=20
Sprut2013: checks=20
*** TURN *** [Kd 3d 4d] [Jh]
Leopoker888: checks=20
Tikinh00: checks=20
Demonidze31: checks=20
IceAngel82: checks=20
Sprut2013: checks=20
*** RIVER *** [Kd 3d 4d Jh] [7c]
Leopoker888: checks=20
Tikinh00: checks=20
Demonidze31: checks=20
IceAngel82: checks=20
Sprut2013: checks=20
*** SHOW DOWN ***
Leopoker888: shows [Ac 9h] (high card Ace)
Tikinh00: shows [7d 2h] (a pair of Sevens)
Demonidze31: mucks hand=20
IceAngel82: shows [Th Js] (a pair of Jacks)
Sprut2013: mucks hand=20
IceAngel82 collected $0.19 from pot
*** SUMMARY ***
Total pot $0.20 | Rake $0.01=20
Board [Kd 3d 4d Jh 7c]
Seat 1: IceAngel82 showed [Th Js] and won ($0.19) with a pair of Jacks
Seat 2: infiniti888 folded before Flop (didn't bet)
Seat 3: Sprut2013 (button) mucked [As 9s]
Seat 4: Leopoker888 (small blind) showed [Ac 9h] and lost with high car=
d Ace
Seat 5: Tikinh00 (big blind) showed [7d 2h] and lost with a pair of Sev=
ens
Seat 6: diment76 folded before Flop (didn't bet)
Seat 7: the_wickstar folded before Flop (didn't bet)
Seat 8: psvworks folded before Flop (didn't bet)
Seat 9: Demonidze31 mucked [2s 2c]


*********** # 22 **************
PokerStars Hand #169851723096:  Hold'em No Limit ($0.01/$0.02 USD) - 20=
17/05/02 23:46:32 CUST [2017/05/02 9:46:32 ET]
Table 'Botha' 9-max Seat #2 is the button
Seat 1: IceAngel82 ($3.73 in chips)=20
Seat 2: infiniti888 ($1.45 in chips)=20
Seat 3: Sprut2013 ($2.48 in chips)=20
Seat 4: Leopoker888 ($1.95 in chips)=20
Seat 5: Tikinh00 ($2.20 in chips)=20
Seat 6: diment76 ($1.86 in chips)=20
Seat 7: the_wickstar ($2.61 in chips)=20
Seat 8: psvworks ($2 in chips)=20
Seat 9: Demonidze31 ($2.59 in chips)=20
Sprut2013: posts small blind $0.01
Leopoker888: posts big blind $0.02
*** HOLE CARDS ***
Dealt to the_wickstar [2c Qs]
Tikinh00: calls $0.02
diment76: folds=20
the_wickstar: folds=20
psvworks: raises $0.06 to $0.08
Demonidze31: folds=20
IceAngel82: folds=20
infiniti888: folds=20
Sprut2013: folds=20
Leopoker888: folds=20
Tikinh00: calls $0.06
*** FLOP *** [8s 6d 5d]
Tikinh00: checks=20
psvworks: bets $0.14
Tikinh00: folds=20
Uncalled bet ($0.14) returned to psvworks
psvworks collected $0.18 from pot
*** SUMMARY ***
Total pot $0.19 | Rake $0.01=20
Board [8s 6d 5d]
Seat 1: IceAngel82 folded before Flop (didn't bet)
Seat 2: infiniti888 (button) folded before Flop (didn't bet)
Seat 3: Sprut2013 (small blind) folded before Flop
Seat 4: Leopoker888 (big blind) folded before Flop
Seat 5: Tikinh00 folded on the Flop
Seat 6: diment76 folded before Flop (didn't bet)
Seat 7: the_wickstar folded before Flop (didn't bet)
Seat 8: psvworks collected ($0.18)
Seat 9: Demonidze31 folded before Flop (didn't bet)


*********** # 23 **************
PokerStars Hand #169851695048:  Hold'em No Limit ($0.01/$0.02 USD) - 20=
17/05/02 23:45:40 CUST [2017/05/02 9:45:40 ET]
Table 'Botha' 9-max Seat #1 is the button
Seat 1: IceAngel82 ($3.73 in chips)=20
Seat 2: infiniti888 ($1.45 in chips)=20
Seat 3: Sprut2013 ($2.50 in chips)=20
Seat 4: Leopoker888 ($1.95 in chips)=20
Seat 5: Tikinh00 ($2.03 in chips)=20
Seat 6: diment76 ($1.86 in chips)=20
Seat 7: the_wickstar ($2.61 in chips)=20
Seat 8: psvworks ($2.03 in chips)=20
Seat 9: Demonidze31 ($2.59 in chips)=20
infiniti888: posts small blind $0.01
Sprut2013: posts big blind $0.02
*** HOLE CARDS ***
Dealt to the_wickstar [7h Qc]
Leopoker888: folds=20
Tikinh00: calls $0.02
diment76: folds=20
the_wickstar: folds=20
psvworks: calls $0.02
Demonidze31: folds=20
IceAngel82: folds=20
infiniti888: folds=20
Sprut2013: checks=20
*** FLOP *** [Tc 4d 8d]
Sprut2013: checks=20
Tikinh00: bets $0.04
psvworks: calls $0.04
Sprut2013: folds=20
*** TURN *** [Tc 4d 8d] [Kc]
Tikinh00: checks=20
psvworks: bets $0.09
Tikinh00: calls $0.09
*** RIVER *** [Tc 4d 8d Kc] [Kh]
Tikinh00: checks=20
psvworks: checks=20
*** SHOW DOWN ***
Tikinh00: shows [8c Ah] (two pair, Kings and Eights)
psvworks: mucks hand=20
Tikinh00 collected $0.32 from pot
*** SUMMARY ***
Total pot $0.33 | Rake $0.01=20
Board [Tc 4d 8d Kc Kh]
Seat 1: IceAngel82 (button) folded before Flop (didn't bet)
Seat 2: infiniti888 (small blind) folded before Flop
Seat 3: Sprut2013 (big blind) folded on the Flop
Seat 4: Leopoker888 folded before Flop (didn't bet)
Seat 5: Tikinh00 showed [8c Ah] and won ($0.32) with two pair, Kings an=
d Eights
Seat 6: diment76 folded before Flop (didn't bet)
Seat 7: the_wickstar folded before Flop (didn't bet)
Seat 8: psvworks mucked [8s 9s]
Seat 9: Demonidze31 folded before Flop (didn't bet)


*********** # 24 **************
PokerStars Hand #169851692957:  Hold'em No Limit ($0.01/$0.02 USD) - 20=
17/05/02 23:45:36 CUST [2017/05/02 9:45:36 ET]
Table 'Telephus' 9-max Seat #1 is the button
Seat 1: the_wickstar ($1.59 in chips)=20
Seat 2: pdilaccio ($0.80 in chips)=20
Seat 3: Humanfritz ($2.06 in chips)=20
Seat 4: IIVadimII ($0.80 in chips)=20
Seat 5: rockstar1307 ($1.60 in chips)=20
Seat 6: IceAngel82 ($2 in chips)=20
Seat 7: GlobysBan ($4.20 in chips)=20
Seat 8: 1tillit1 ($2.44 in chips)=20
Seat 9: iskarian ($2 in chips)=20
pdilaccio: posts small blind $0.01
Humanfritz: posts big blind $0.02
rockstar1307: posts big blind $0.02
*** HOLE CARDS ***
Dealt to the_wickstar [7h Qs]
IIVadimII has timed out
IIVadimII: folds=20
rockstar1307: checks=20
IceAngel82: folds=20
GlobysBan: calls $0.02
1tillit1: folds=20
iskarian: folds=20
the_wickstar: calls $0.02
pdilaccio: folds=20
Humanfritz: checks=20
*** FLOP *** [8d Kd 9h]
Humanfritz: checks=20
rockstar1307: checks=20
GlobysBan: checks=20
the_wickstar: bets $0.05
Humanfritz: folds=20
rockstar1307: calls $0.05
GlobysBan: folds=20
*** TURN *** [8d Kd 9h] [8h]
rockstar1307: checks=20
the_wickstar: checks=20
*** RIVER *** [8d Kd 9h 8h] [7d]
rockstar1307: bets $0.08
the_wickstar: folds=20
Uncalled bet ($0.08) returned to rockstar1307
rockstar1307 collected $0.18 from pot
rockstar1307: doesn't show hand=20
*** SUMMARY ***
Total pot $0.19 | Rake $0.01=20
Board [8d Kd 9h 8h 7d]
Seat 1: the_wickstar (button) folded on the River
Seat 2: pdilaccio (small blind) folded before Flop
Seat 3: Humanfritz (big blind) folded on the Flop
Seat 4: IIVadimII folded before Flop (didn't bet)
Seat 5: rockstar1307 collected ($0.18)
Seat 6: IceAngel82 folded before Flop (didn't bet)
Seat 7: GlobysBan folded on the Flop
Seat 8: 1tillit1 folded before Flop (didn't bet)
Seat 9: iskarian folded before Flop (didn't bet)


*********** # 25 **************
PokerStars Hand #169851678405:  Hold'em No Limit ($0.01/$0.02 USD) - 20=
17/05/02 23:45:09 CUST [2017/05/02 9:45:09 ET]
Table 'Botha' 9-max Seat #9 is the button
Seat 1: IceAngel82 ($3.74 in chips)=20
Seat 2: infiniti888 ($1.45 in chips)=20
Seat 3: Sprut2013 ($2.50 in chips)=20
Seat 4: Leopoker888 ($1.95 in chips)=20
Seat 5: Tikinh00 ($2.03 in chips)=20
Seat 6: diment76 ($1.86 in chips)=20
Seat 7: the_wickstar ($2.58 in chips)=20
Seat 8: psvworks ($2.03 in chips)=20
Seat 9: Demonidze31 ($2.59 in chips)=20
IceAngel82: posts small blind $0.01
infiniti888: posts big blind $0.02
*** HOLE CARDS ***
Dealt to the_wickstar [Ks Th]
Sprut2013: folds=20
Leopoker888: folds=20
Tikinh00: folds=20
diment76: folds=20
the_wickstar: raises $0.02 to $0.04
psvworks: folds=20
Demonidze31: folds=20
IceAngel82: folds=20
infiniti888: folds=20
Uncalled bet ($0.02) returned to the_wickstar
the_wickstar collected $0.05 from pot
*** SUMMARY ***
Total pot $0.05 | Rake $0=20
Seat 1: IceAngel82 (small blind) folded before Flop
Seat 2: infiniti888 (big blind) folded before Flop
Seat 3: Sprut2013 folded before Flop (didn't bet)
Seat 4: Leopoker888 folded before Flop (didn't bet)
Seat 5: Tikinh00 folded before Flop (didn't bet)
Seat 6: diment76 folded before Flop (didn't bet)
Seat 7: the_wickstar collected ($0.05)
Seat 8: psvworks folded before Flop (didn't bet)
Seat 9: Demonidze31 (button) folded before Flop (didn't bet)


*********** # 26 **************
PokerStars Hand #169851674229:  Hold'em No Limit ($0.01/$0.02 USD) - 20=
17/05/02 23:45:02 CUST [2017/05/02 9:45:02 ET]
Table 'Telephus' 9-max Seat #9 is the button
Seat 1: the_wickstar ($1.60 in chips)=20
Seat 2: pdilaccio ($0.79 in chips)=20
Seat 3: Humanfritz ($2.06 in chips)=20
Seat 4: IIVadimII ($0.80 in chips)=20
Seat 6: IceAngel82 ($2 in chips)=20
Seat 7: GlobysBan ($4.20 in chips)=20
Seat 8: 1tillit1 ($2.44 in chips)=20
Seat 9: iskarian ($2 in chips)=20
the_wickstar: posts small blind $0.01
pdilaccio: posts big blind $0.02
*** HOLE CARDS ***
Dealt to the_wickstar [8c 7d]
rockstar1307 joins the table at seat #5=20
Humanfritz: folds=20
IIVadimII: folds=20
IceAngel82: folds=20
GlobysBan: folds=20
1tillit1: folds=20
iskarian: folds=20
the_wickstar: folds=20
Uncalled bet ($0.01) returned to pdilaccio
pdilaccio collected $0.02 from pot
*** SUMMARY ***
Total pot $0.02 | Rake $0=20
Seat 1: the_wickstar (small blind) folded before Flop
Seat 2: pdilaccio (big blind) collected ($0.02)
Seat 3: Humanfritz folded before Flop (didn't bet)
Seat 4: IIVadimII folded before Flop (didn't bet)
Seat 6: IceAngel82 folded before Flop (didn't bet)
Seat 7: GlobysBan folded before Flop (didn't bet)
Seat 8: 1tillit1 folded before Flop (didn't bet)
Seat 9: iskarian (button) folded before Flop (didn't bet)


*********** # 27 **************
PokerStars Hand #169851663736:  Hold'em No Limit ($0.01/$0.02 USD) - 20=
17/05/02 23:44:42 CUST [2017/05/02 9:44:42 ET]
Table 'Botha' 9-max Seat #8 is the button
Seat 1: IceAngel82 ($3.76 in chips)=20
Seat 2: infiniti888 ($1.45 in chips)=20
Seat 3: Sprut2013 ($2.50 in chips)=20
Seat 4: Leopoker888 ($1.95 in chips)=20
Seat 5: Tikinh00 ($2.03 in chips)=20
Seat 6: diment76 ($1.86 in chips)=20
Seat 7: the_wickstar ($2.58 in chips)=20
Seat 8: psvworks ($2 in chips)=20
Seat 9: Demonidze31 ($2.60 in chips)=20
Demonidze31: posts small blind $0.01
IceAngel82: posts big blind $0.02
*** HOLE CARDS ***
Dealt to the_wickstar [9c Td]
infiniti888: folds=20
Sprut2013: folds=20
Leopoker888: folds=20
Tikinh00: folds=20
diment76: folds=20
the_wickstar: folds=20
psvworks: raises $0.03 to $0.05
Demonidze31: folds=20
IceAngel82: folds=20
Uncalled bet ($0.03) returned to psvworks
psvworks collected $0.05 from pot
*** SUMMARY ***
Total pot $0.05 | Rake $0=20
Seat 1: IceAngel82 (big blind) folded before Flop
Seat 2: infiniti888 folded before Flop (didn't bet)
Seat 3: Sprut2013 folded before Flop (didn't bet)
Seat 4: Leopoker888 folded before Flop (didn't bet)
Seat 5: Tikinh00 folded before Flop (didn't bet)
Seat 6: diment76 folded before Flop (didn't bet)
Seat 7: the_wickstar folded before Flop (didn't bet)
Seat 8: psvworks (button) collected ($0.05)
Seat 9: Demonidze31 (small blind) folded before Flop


*********** # 28 **************
PokerStars Hand #169851656082:  Hold'em No Limit ($0.01/$0.02 USD) - 20=
17/05/02 23:44:28 CUST [2017/05/02 9:44:28 ET]
Table 'Telephus' 9-max Seat #8 is the button
Seat 1: the_wickstar ($1.62 in chips)=20
Seat 2: pdilaccio ($0.79 in chips)=20
Seat 3: Humanfritz ($2.06 in chips)=20
Seat 4: IIVadimII ($0.80 in chips)=20
Seat 6: IceAngel82 ($2 in chips)=20
Seat 7: GlobysBan ($4.20 in chips)=20
Seat 8: 1tillit1 ($2.41 in chips)=20
Seat 9: iskarian ($2 in chips)=20
iskarian: posts small blind $0.01
the_wickstar: posts big blind $0.02
*** HOLE CARDS ***
Dealt to the_wickstar [Jd Kd]
pdilaccio: folds=20
Humanfritz: folds=20
IIVadimII: folds=20
RG&JP5 was removed from the table for failing to post
IceAngel82: folds=20
GlobysBan: folds=20
1tillit1: raises $0.03 to $0.05
iskarian: folds=20
the_wickstar: folds=20
Uncalled bet ($0.03) returned to 1tillit1
1tillit1 collected $0.05 from pot
1tillit1: doesn't show hand=20
*** SUMMARY ***
Total pot $0.05 | Rake $0=20
Seat 1: the_wickstar (big blind) folded before Flop
Seat 2: pdilaccio folded before Flop (didn't bet)
Seat 3: Humanfritz folded before Flop (didn't bet)
Seat 4: IIVadimII folded before Flop (didn't bet)
Seat 6: IceAngel82 folded before Flop (didn't bet)
Seat 7: GlobysBan folded before Flop (didn't bet)
Seat 8: 1tillit1 (button) collected ($0.05)
Seat 9: iskarian (small blind) folded before Flop


*********** # 29 **************
PokerStars Hand #169851651672:  Hold'em No Limit ($0.01/$0.02 USD) - 20=
17/05/02 23:44:20 CUST [2017/05/02 9:44:20 ET]
Table 'Botha' 9-max Seat #7 is the button
Seat 1: IceAngel82 ($3.76 in chips)=20
Seat 2: infiniti888 ($1.45 in chips)=20
Seat 3: Sprut2013 ($2.50 in chips)=20
Seat 4: Leopoker888 ($1.92 in chips)=20
Seat 5: Tikinh00 ($2.03 in chips)=20
Seat 6: diment76 ($1.86 in chips)=20
Seat 7: the_wickstar ($2.58 in chips)=20
Seat 8: psvworks ($2 in chips)=20
Seat 9: Demonidze31 ($2.62 in chips)=20
psvworks: posts small blind $0.01
Demonidze31: posts big blind $0.02
*** HOLE CARDS ***
Dealt to the_wickstar [7s Kc]
IceAngel82: folds=20
infiniti888: folds=20
Sprut2013: folds=20
Leopoker888: raises $0.04 to $0.06
Tikinh00: folds=20
diment76: folds=20
the_wickstar: folds=20
psvworks: folds=20
Demonidze31: folds=20
Uncalled bet ($0.04) returned to Leopoker888
Leopoker888 collected $0.05 from pot
Leopoker888: doesn't show hand=20
*** SUMMARY ***
Total pot $0.05 | Rake $0=20
Seat 1: IceAngel82 folded before Flop (didn't bet)
Seat 2: infiniti888 folded before Flop (didn't bet)
Seat 3: Sprut2013 folded before Flop (didn't bet)
Seat 4: Leopoker888 collected ($0.05)
Seat 5: Tikinh00 folded before Flop (didn't bet)
Seat 6: diment76 folded before Flop (didn't bet)
Seat 7: the_wickstar (button) folded before Flop (didn't bet)
Seat 8: psvworks (small blind) folded before Flop
Seat 9: Demonidze31 (big blind) folded before Flop


*********** # 30 **************
PokerStars Hand #169851639135:  Hold'em No Limit ($0.01/$0.02 USD) - 20=
17/05/02 23:43:57 CUST [2017/05/02 9:43:57 ET]
Table 'Telephus' 9-max Seat #7 is the button
Seat 1: the_wickstar ($1.62 in chips)=20
Seat 2: pdilaccio ($0.79 in chips)=20
Seat 3: Humanfritz ($2.03 in chips)=20
Seat 4: IIVadimII ($0.80 in chips)=20
Seat 6: IceAngel82 ($2 in chips)=20
Seat 7: GlobysBan ($4.20 in chips)=20
Seat 8: 1tillit1 ($2.42 in chips)=20
Seat 9: iskarian ($2 in chips)=20
1tillit1: posts small blind $0.01
iskarian: posts big blind $0.02
*** HOLE CARDS ***
Dealt to the_wickstar [Qh 6h]
the_wickstar: folds=20
pdilaccio: folds=20
Humanfritz: raises $0.07 to $0.09
IIVadimII: folds=20
IceAngel82: folds=20
GlobysBan: folds=20
1tillit1: folds=20
iskarian: folds=20
Uncalled bet ($0.07) returned to Humanfritz
Humanfritz collected $0.05 from pot
Humanfritz: doesn't show hand=20
*** SUMMARY ***
Total pot $0.05 | Rake $0=20
Seat 1: the_wickstar folded before Flop (didn't bet)
Seat 2: pdilaccio folded before Flop (didn't bet)
Seat 3: Humanfritz collected ($0.05)
Seat 4: IIVadimII folded before Flop (didn't bet)
Seat 6: IceAngel82 folded before Flop (didn't bet)
Seat 7: GlobysBan (button) folded before Flop (didn't bet)
Seat 8: 1tillit1 (small blind) folded before Flop
Seat 9: iskarian (big blind) folded before Flop


*********** # 31 **************
PokerStars Hand #169851617305:  Hold'em No Limit ($0.01/$0.02 USD) - 20=
17/05/02 23:43:16 CUST [2017/05/02 9:43:16 ET]
Table 'Telephus' 9-max Seat #6 is the button
Seat 1: the_wickstar ($1.62 in chips)=20
Seat 2: pdilaccio ($0.79 in chips)=20
Seat 3: Humanfritz ($2.03 in chips)=20
Seat 4: IIVadimII ($0.80 in chips)=20
Seat 6: IceAngel82 ($2 in chips)=20
Seat 7: GlobysBan ($4.22 in chips)=20
Seat 8: 1tillit1 ($2.40 in chips)=20
Seat 9: iskarian ($2 in chips)=20
GlobysBan: posts small blind $0.01
1tillit1: posts big blind $0.02
*** HOLE CARDS ***
Dealt to the_wickstar [7h Th]
iskarian: folds=20
the_wickstar: folds=20
pdilaccio: folds=20
Humanfritz: folds=20
IIVadimII: folds=20
IceAngel82: folds=20
GlobysBan: calls $0.01
1tillit1: checks=20
*** FLOP *** [8d 7c 4h]
GlobysBan: checks=20
1tillit1: bets $0.02
GlobysBan: folds=20
Uncalled bet ($0.02) returned to 1tillit1
1tillit1 collected $0.04 from pot
1tillit1: doesn't show hand=20
*** SUMMARY ***
Total pot $0.04 | Rake $0=20
Board [8d 7c 4h]
Seat 1: the_wickstar folded before Flop (didn't bet)
Seat 2: pdilaccio folded before Flop (didn't bet)
Seat 3: Humanfritz folded before Flop (didn't bet)
Seat 4: IIVadimII folded before Flop (didn't bet)
Seat 6: IceAngel82 (button) folded before Flop (didn't bet)
Seat 7: GlobysBan (small blind) folded on the Flop
Seat 8: 1tillit1 (big blind) collected ($0.04)
Seat 9: iskarian folded before Flop (didn't bet)


*********** # 32 **************
PokerStars Hand #169851609908:  Hold'em No Limit ($0.01/$0.02 USD) - 20=
17/05/02 23:43:02 CUST [2017/05/02 9:43:02 ET]
Table 'Botha' 9-max Seat #6 is the button
Seat 1: IceAngel82 ($3.76 in chips)=20
Seat 2: infiniti888 ($1.45 in chips)=20
Seat 3: Sprut2013 ($2.50 in chips)=20
Seat 4: Leopoker888 ($1.92 in chips)=20
Seat 5: Tikinh00 ($2.05 in chips)=20
Seat 6: diment76 ($1.92 in chips)=20
Seat 7: the_wickstar ($2.49 in chips)=20
Seat 8: psvworks ($2 in chips)=20
Seat 9: Demonidze31 ($2.62 in chips)=20
the_wickstar: posts small blind $0.01
psvworks: posts big blind $0.02
*** HOLE CARDS ***
Dealt to the_wickstar [2d Ts]
Demonidze31: folds=20
IceAngel82: folds=20
infiniti888: folds=20
Sprut2013: folds=20
Leopoker888: folds=20
Tikinh00: calls $0.02
diment76: calls $0.02
the_wickstar: calls $0.01
psvworks: checks=20
*** FLOP *** [Qd 7s Th]
the_wickstar: bets $0.04
psvworks: folds=20
Tikinh00: folds=20
diment76: calls $0.04
*** TURN *** [Qd 7s Th] [2c]
the_wickstar: bets $0.10
diment76: folds=20
Uncalled bet ($0.10) returned to the_wickstar
the_wickstar collected $0.15 from pot
*** SUMMARY ***
Total pot $0.16 | Rake $0.01=20
Board [Qd 7s Th 2c]
Seat 1: IceAngel82 folded before Flop (didn't bet)
Seat 2: infiniti888 folded before Flop (didn't bet)
Seat 3: Sprut2013 folded before Flop (didn't bet)
Seat 4: Leopoker888 folded before Flop (didn't bet)
Seat 5: Tikinh00 folded on the Flop
Seat 6: diment76 (button) folded on the Turn
Seat 7: the_wickstar (small blind) collected ($0.15)
Seat 8: psvworks (big blind) folded on the Flop
Seat 9: Demonidze31 folded before Flop (didn't bet)


*********** # 33 **************
PokerStars Hand #169851594148:  Hold'em No Limit ($0.01/$0.02 USD) - 20=
17/05/02 23:42:33 CUST [2017/05/02 9:42:33 ET]
Table 'Telephus' 9-max Seat #4 is the button
Seat 1: the_wickstar ($1.66 in chips)=20
Seat 2: pdilaccio ($0.72 in chips)=20
Seat 3: Humanfritz ($2.03 in chips)=20
Seat 4: IIVadimII ($0.80 in chips)=20
Seat 6: IceAngel82 ($2 in chips)=20
Seat 7: GlobysBan ($4.24 in chips)=20
Seat 8: 1tillit1 ($2.40 in chips)=20
Seat 9: iskarian ($2 in chips)=20
IceAngel82: posts small blind $0.01
GlobysBan: posts big blind $0.02
*** HOLE CARDS ***
Dealt to the_wickstar [Ks Qs]
1tillit1: folds=20
iskarian: folds=20
the_wickstar: raises $0.02 to $0.04
pdilaccio: raises $0.68 to $0.72 and is all-in
Humanfritz: folds=20
IIVadimII: folds=20
IceAngel82: folds=20
GlobysBan: folds=20
the_wickstar: folds=20
Uncalled bet ($0.68) returned to pdilaccio
pdilaccio collected $0.11 from pot
*** SUMMARY ***
Total pot $0.11 | Rake $0=20
Seat 1: the_wickstar folded before Flop
Seat 2: pdilaccio collected ($0.11)
Seat 3: Humanfritz folded before Flop (didn't bet)
Seat 4: IIVadimII (button) folded before Flop (didn't bet)
Seat 6: IceAngel82 (small blind) folded before Flop
Seat 7: GlobysBan (big blind) folded before Flop
Seat 8: 1tillit1 folded before Flop (didn't bet)
Seat 9: iskarian folded before Flop (didn't bet)


*********** # 34 **************
PokerStars Hand #169851581296:  Hold'em No Limit ($0.01/$0.02 USD) - 20=
17/05/02 23:42:09 CUST [2017/05/02 9:42:09 ET]
Table 'Telephus' 9-max Seat #3 is the button
Seat 1: the_wickstar ($1.66 in chips)=20
Seat 2: pdilaccio ($0.72 in chips)=20
Seat 3: Humanfritz ($2.03 in chips)=20
Seat 4: IIVadimII ($0.78 in chips)=20
Seat 6: IceAngel82 ($2 in chips)=20
Seat 7: GlobysBan ($4.24 in chips)=20
Seat 8: 1tillit1 ($2.40 in chips)=20
Seat 9: iskarian ($2 in chips)=20
IIVadimII: posts small blind $0.01
IceAngel82: posts big blind $0.02
*** HOLE CARDS ***
Dealt to the_wickstar [Ks 5h]
GlobysBan: folds=20
1tillit1: folds=20
iskarian: folds=20
the_wickstar: folds=20
pdilaccio: folds=20
Humanfritz: folds=20
IIVadimII: raises $0.02 to $0.04
IceAngel82: folds=20
Uncalled bet ($0.02) returned to IIVadimII
IIVadimII collected $0.04 from pot
IIVadimII: doesn't show hand=20
*** SUMMARY ***
Total pot $0.04 | Rake $0=20
Seat 1: the_wickstar folded before Flop (didn't bet)
Seat 2: pdilaccio folded before Flop (didn't bet)
Seat 3: Humanfritz (button) folded before Flop (didn't bet)
Seat 4: IIVadimII (small blind) collected ($0.04)
Seat 6: IceAngel82 (big blind) folded before Flop
Seat 7: GlobysBan folded before Flop (didn't bet)
Seat 8: 1tillit1 folded before Flop (didn't bet)
Seat 9: iskarian folded before Flop (didn't bet)


*********** # 35 **************
PokerStars Hand #169851558327:  Hold'em No Limit ($0.01/$0.02 USD) - 20=
17/05/02 23:41:26 CUST [2017/05/02 9:41:26 ET]
Table 'Telephus' 9-max Seat #2 is the button
Seat 1: the_wickstar ($1.66 in chips)=20
Seat 2: pdilaccio ($0.72 in chips)=20
Seat 3: Humanfritz ($2.01 in chips)=20
Seat 4: IIVadimII ($0.80 in chips)=20
Seat 6: IceAngel82 ($2 in chips)=20
Seat 7: GlobysBan ($4.24 in chips)=20
Seat 8: 1tillit1 ($2.40 in chips)=20
Seat 9: iskarian ($2 in chips)=20
Humanfritz: posts small blind $0.01
IIVadimII: posts big blind $0.02
*** HOLE CARDS ***
Dealt to the_wickstar [2c 8d]
IceAngel82: folds=20
GlobysBan: folds=20
1tillit1: folds=20
iskarian: folds=20
the_wickstar: folds=20
pdilaccio: folds=20
Humanfritz: raises $0.07 to $0.09
IIVadimII: folds=20
Uncalled bet ($0.07) returned to Humanfritz
Humanfritz collected $0.04 from pot
Humanfritz: doesn't show hand=20
*** SUMMARY ***
Total pot $0.04 | Rake $0=20
Seat 1: the_wickstar folded before Flop (didn't bet)
Seat 2: pdilaccio (button) folded before Flop (didn't bet)
Seat 3: Humanfritz (small blind) collected ($0.04)
Seat 4: IIVadimII (big blind) folded before Flop
Seat 6: IceAngel82 folded before Flop (didn't bet)
Seat 7: GlobysBan folded before Flop (didn't bet)
Seat 8: 1tillit1 folded before Flop (didn't bet)
Seat 9: iskarian folded before Flop (didn't bet)


*********** # 36 **************
PokerStars Hand #169851547893:  Hold'em No Limit ($0.01/$0.02 USD) - 20=
17/05/02 23:41:07 CUST [2017/05/02 9:41:07 ET]
Table 'Botha' 9-max Seat #5 is the button
Seat 1: IceAngel82 ($3.76 in chips)=20
Seat 2: infiniti888 ($1.45 in chips)=20
Seat 3: Sprut2013 ($2.50 in chips)=20
Seat 4: Leopoker888 ($2.14 in chips)=20
Seat 5: Tikinh00 ($2.05 in chips)=20
Seat 6: diment76 ($1.93 in chips)=20
Seat 7: the_wickstar ($2.53 in chips)=20
Seat 8: maksim.vl ($2 in chips)=20
Seat 9: Demonidze31 ($2.31 in chips)=20
diment76: posts small blind $0.01
the_wickstar: posts big blind $0.02
*** HOLE CARDS ***
Dealt to the_wickstar [6d Kc]
maksim.vl: folds=20
maksim.vl leaves the table
psvworks joins the table at seat #8=20
Demonidze31: raises $0.02 to $0.04
IceAngel82: folds=20
infiniti888: folds=20
Sprut2013: folds=20
Leopoker888: calls $0.04
Tikinh00: folds=20
diment76: folds=20
the_wickstar: calls $0.02
*** FLOP *** [Td 5s Ah]
the_wickstar: checks=20
Demonidze31: bets $0.08
Leopoker888: calls $0.08
the_wickstar: folds=20
*** TURN *** [Td 5s Ah] [4c]
Demonidze31: checks=20
Leopoker888: bets $0.16
Demonidze31: calls $0.16
*** RIVER *** [Td 5s Ah 4c] [8d]
Demonidze31: checks=20
Leopoker888: checks=20
*** SHOW DOWN ***
Demonidze31: shows [Ac Jc] (a pair of Aces)
Leopoker888: mucks hand=20
Demonidze31 collected $0.59 from pot
*** SUMMARY ***
Total pot $0.61 | Rake $0.02=20
Board [Td 5s Ah 4c 8d]
Seat 1: IceAngel82 folded before Flop (didn't bet)
Seat 2: infiniti888 folded before Flop (didn't bet)
Seat 3: Sprut2013 folded before Flop (didn't bet)
Seat 4: Leopoker888 mucked [Qc Ks]
Seat 5: Tikinh00 (button) folded before Flop (didn't bet)
Seat 6: diment76 (small blind) folded before Flop
Seat 7: the_wickstar (big blind) folded on the Flop
Seat 8: maksim.vl folded before Flop (didn't bet)
Seat 9: Demonidze31 showed [Ac Jc] and won ($0.59) with a pair of Aces


*********** # 37 **************
PokerStars Hand #169851521974:  Hold'em No Limit ($0.01/$0.02 USD) - 20=
17/05/02 23:40:19 CUST [2017/05/02 9:40:19 ET]
Table 'Telephus' 9-max Seat #1 is the button
Seat 1: the_wickstar ($1.17 in chips)=20
Seat 2: pdilaccio ($0.73 in chips)=20
Seat 3: Humanfritz ($2.03 in chips)=20
Seat 4: IIVadimII ($0.87 in chips)=20
Seat 6: IceAngel82 ($2 in chips)=20
Seat 7: GlobysBan ($4.24 in chips)=20
Seat 8: 1tillit1 ($2.40 in chips)=20
Seat 9: iskarian ($2 in chips)=20
pdilaccio: posts small blind $0.01
Humanfritz: posts big blind $0.02
*** HOLE CARDS ***
Dealt to the_wickstar [Js Jd]
IIVadimII: raises $0.04 to $0.06
IceAngel82: folds=20
GlobysBan: folds=20
1tillit1: folds=20
iskarian: folds=20
the_wickstar: raises $0.06 to $0.12
pdilaccio: folds=20
Humanfritz: folds=20
IIVadimII: calls $0.06
*** FLOP *** [Qh 5s 3s]
IIVadimII: checks=20
the_wickstar: bets $0.13
IIVadimII: calls $0.13
*** TURN *** [Qh 5s 3s] [Qs]
IIVadimII: checks=20
the_wickstar: checks=20
*** RIVER *** [Qh 5s 3s Qs] [6s]
IIVadimII: checks=20
the_wickstar: bets $0.25
IIVadimII: calls $0.25
*** SHOW DOWN ***
the_wickstar: shows [Js Jd] (a flush, Queen high)
IIVadimII: mucks hand=20
the_wickstar collected $0.99 from pot
*** SUMMARY ***
Total pot $1.03 | Rake $0.04=20
Board [Qh 5s 3s Qs 6s]
Seat 1: the_wickstar (button) showed [Js Jd] and won ($0.99) with a flu=
sh, Queen high
Seat 2: pdilaccio (small blind) folded before Flop
Seat 3: Humanfritz (big blind) folded before Flop
Seat 4: IIVadimII mucked [Ah Qc]
Seat 6: IceAngel82 folded before Flop (didn't bet)
Seat 7: GlobysBan folded before Flop (didn't bet)
Seat 8: 1tillit1 folded before Flop (didn't bet)
Seat 9: iskarian folded before Flop (didn't bet)


*********** # 38 **************
PokerStars Hand #169851520849:  Hold'em No Limit ($0.01/$0.02 USD) - 20=
17/05/02 23:40:17 CUST [2017/05/02 9:40:17 ET]
Table 'Botha' 9-max Seat #4 is the button
Seat 1: IceAngel82 ($3.76 in chips)=20
Seat 2: infiniti888 ($1.45 in chips)=20
Seat 3: Sprut2013 ($2.50 in chips)=20
Seat 4: Leopoker888 ($2.14 in chips)=20
Seat 5: Tikinh00 ($2.05 in chips)=20
Seat 6: diment76 ($1.93 in chips)=20
Seat 7: the_wickstar ($2.53 in chips)=20
Seat 8: maksim.vl ($2 in chips)=20
Seat 9: Demonidze31 ($2.31 in chips)=20
Tikinh00: posts small blind $0.01
diment76: posts big blind $0.02
*** HOLE CARDS ***
Dealt to the_wickstar [8d Qc]
the_wickstar: folds=20
maksim.vl: folds=20
Demonidze31: folds=20
IceAngel82: folds=20
infiniti888: folds=20
Sprut2013: folds=20
Leopoker888: folds=20
Tikinh00: calls $0.01
diment76: checks=20
*** FLOP *** [Js Ac 4c]
Tikinh00: checks=20
diment76: checks=20
*** TURN *** [Js Ac 4c] [9c]
Tikinh00: checks=20
diment76: checks=20
*** RIVER *** [Js Ac 4c 9c] [7c]
Tikinh00: checks=20
diment76: checks=20
*** SHOW DOWN ***
Tikinh00: shows [Ad 6h] (a pair of Aces)
diment76: shows [5h As] (a pair of Aces)
Tikinh00 collected $0.02 from pot
diment76 collected $0.02 from pot
*** SUMMARY ***
Total pot $0.04 | Rake $0=20
Board [Js Ac 4c 9c 7c]
Seat 1: IceAngel82 folded before Flop (didn't bet)
Seat 2: infiniti888 folded before Flop (didn't bet)
Seat 3: Sprut2013 folded before Flop (didn't bet)
Seat 4: Leopoker888 (button) folded before Flop (didn't bet)
Seat 5: Tikinh00 (small blind) showed [Ad 6h] and won ($0.02) with a pa=
ir of Aces
Seat 6: diment76 (big blind) showed [5h As] and won ($0.02) with a pair=
 of Aces
Seat 7: the_wickstar folded before Flop (didn't bet)
Seat 8: maksim.vl folded before Flop (didn't bet)
Seat 9: Demonidze31 folded before Flop (didn't bet)


*********** # 39 **************
PokerStars Hand #169851491139:  Hold'em No Limit ($0.01/$0.02 USD) - 20=
17/05/02 23:39:22 CUST [2017/05/02 9:39:22 ET]
Table 'Botha' 9-max Seat #3 is the button
Seat 1: IceAngel82 ($3.76 in chips)=20
Seat 2: infiniti888 ($1.45 in chips)=20
Seat 3: Sprut2013 ($2.50 in chips)=20
Seat 4: Leopoker888 ($2.08 in chips)=20
Seat 5: Tikinh00 ($2.11 in chips)=20
Seat 6: diment76 ($1.93 in chips)=20
Seat 7: the_wickstar ($2.53 in chips)=20
Seat 8: maksim.vl ($2 in chips)=20
Seat 9: Demonidze31 ($2.31 in chips)=20
Leopoker888: posts small blind $0.01
Tikinh00: posts big blind $0.02
*** HOLE CARDS ***
Dealt to the_wickstar [3c Ad]
diment76: folds=20
the_wickstar: folds=20
maksim.vl: folds=20
Demonidze31: folds=20
IceAngel82: folds=20
infiniti888: folds=20
Sprut2013: folds=20
Leopoker888: raises $0.04 to $0.06
Tikinh00: calls $0.04
*** FLOP *** [9d Kd 6h]
Leopoker888: bets $0.08
Tikinh00: folds=20
Uncalled bet ($0.08) returned to Leopoker888
Leopoker888 collected $0.12 from pot
Leopoker888: doesn't show hand=20
*** SUMMARY ***
Total pot $0.12 | Rake $0=20
Board [9d Kd 6h]
Seat 1: IceAngel82 folded before Flop (didn't bet)
Seat 2: infiniti888 folded before Flop (didn't bet)
Seat 3: Sprut2013 (button) folded before Flop (didn't bet)
Seat 4: Leopoker888 (small blind) collected ($0.12)
Seat 5: Tikinh00 (big blind) folded on the Flop
Seat 6: diment76 folded before Flop (didn't bet)
Seat 7: the_wickstar folded before Flop (didn't bet)
Seat 8: maksim.vl folded before Flop (didn't bet)
Seat 9: Demonidze31 folded before Flop (didn't bet)


*********** # 40 **************
PokerStars Hand #169851486485:  Hold'em No Limit ($0.01/$0.02 USD) - 20=
17/05/02 23:39:13 CUST [2017/05/02 9:39:13 ET]
Table 'Telephus' 9-max Seat #9 is the button
Seat 1: the_wickstar ($1.18 in chips)=20
Seat 2: pdilaccio ($0.75 in chips)=20
Seat 3: Humanfritz ($2.03 in chips)=20
Seat 4: IIVadimII ($0.87 in chips)=20
Seat 6: IceAngel82 ($2.22 in chips)=20
Seat 7: GlobysBan ($2.18 in chips)=20
Seat 8: 1tillit1 ($2.40 in chips)=20
Seat 9: iskarian ($2 in chips)=20
the_wickstar: posts small blind $0.01
pdilaccio: posts big blind $0.02
*** HOLE CARDS ***
Dealt to the_wickstar [7h Kd]
Humanfritz: folds=20
IIVadimII: folds=20
IceAngel82: raises $0.04 to $0.06
GlobysBan: raises $0.10 to $0.16
1tillit1: folds=20
iskarian: folds=20
the_wickstar: folds=20
pdilaccio: folds=20
IceAngel82: calls $0.10
*** FLOP *** [Ah Jh 5d]
IceAngel82: checks=20
GlobysBan: bets $0.16
IceAngel82: calls $0.16
*** TURN *** [Ah Jh 5d] [6c]
IceAngel82: checks=20
GlobysBan: bets $0.46
IceAngel82: raises $0.50 to $0.96
GlobysBan: raises $0.90 to $1.86 and is all-in
IceAngel82: calls $0.90
*** RIVER *** [Ah Jh 5d 6c] [9c]
*** SHOW DOWN ***
IceAngel82: shows [Jc Js] (three of a kind, Jacks)
GlobysBan: shows [As Ac] (three of a kind, Aces)
GlobysBan collected $4.24 from pot
*** SUMMARY ***
Total pot $4.39 | Rake $0.15=20
Board [Ah Jh 5d 6c 9c]
Seat 1: the_wickstar (small blind) folded before Flop
Seat 2: pdilaccio (big blind) folded before Flop
Seat 3: Humanfritz folded before Flop (didn't bet)
Seat 4: IIVadimII folded before Flop (didn't bet)
Seat 6: IceAngel82 showed [Jc Js] and lost with three of a kind, Jacks
Seat 7: GlobysBan showed [As Ac] and won ($4.24) with three of a kind, =
Aces
Seat 8: 1tillit1 folded before Flop (didn't bet)
Seat 9: iskarian (button) folded before Flop (didn't bet)


*********** # 41 **************
PokerStars Hand #169851470462:  Hold'em No Limit ($0.01/$0.02 USD) - 20=
17/05/02 23:38:43 CUST [2017/05/02 9:38:43 ET]
Table 'Telephus' 9-max Seat #8 is the button
Seat 1: the_wickstar ($1.20 in chips)=20
Seat 2: pdilaccio ($0.75 in chips)=20
Seat 3: Humanfritz ($2.03 in chips)=20
Seat 4: IIVadimII ($0.87 in chips)=20
Seat 6: IceAngel82 ($2.22 in chips)=20
Seat 7: GlobysBan ($2.15 in chips)=20
Seat 8: 1tillit1 ($2.40 in chips)=20
Seat 9: iskarian ($2 in chips)=20
iskarian: posts small blind $0.01
the_wickstar: posts big blind $0.02
*** HOLE CARDS ***
Dealt to the_wickstar [Ts Ks]
pdilaccio: folds=20
Humanfritz: folds=20
IIVadimII: folds=20
IceAngel82: folds=20
GlobysBan: raises $0.04 to $0.06
1tillit1: folds=20
iskarian: folds=20
the_wickstar: folds=20
Uncalled bet ($0.04) returned to GlobysBan
GlobysBan collected $0.05 from pot
*** SUMMARY ***
Total pot $0.05 | Rake $0=20
Seat 1: the_wickstar (big blind) folded before Flop
Seat 2: pdilaccio folded before Flop (didn't bet)
Seat 3: Humanfritz folded before Flop (didn't bet)
Seat 4: IIVadimII folded before Flop (didn't bet)
Seat 6: IceAngel82 folded before Flop (didn't bet)
Seat 7: GlobysBan collected ($0.05)
Seat 8: 1tillit1 (button) folded before Flop (didn't bet)
Seat 9: iskarian (small blind) folded before Flop


*********** # 42 **************
PokerStars Hand #169851445870:  Hold'em No Limit ($0.01/$0.02 USD) - 20=
17/05/02 23:37:57 CUST [2017/05/02 9:37:57 ET]
Table 'Telephus' 9-max Seat #7 is the button
Seat 1: the_wickstar ($1.20 in chips)=20
Seat 2: pdilaccio ($0.75 in chips)=20
Seat 3: Humanfritz ($2.03 in chips)=20
Seat 4: IIVadimII ($0.87 in chips)=20
Seat 6: IceAngel82 ($2.22 in chips)=20
Seat 7: GlobysBan ($2.08 in chips)=20
Seat 8: 1tillit1 ($2.41 in chips)=20
Seat 9: iskarian ($2.03 in chips)=20
1tillit1: posts small blind $0.01
iskarian: posts big blind $0.02
*** HOLE CARDS ***
Dealt to the_wickstar [7d 8h]
the_wickstar: folds=20
pdilaccio: folds=20
Humanfritz: folds=20
IIVadimII: folds=20
IceAngel82: folds=20
GlobysBan: raises $0.04 to $0.06
1tillit1: folds=20
iskarian: calls $0.04
*** FLOP *** [As Jc 3s]
iskarian: checks=20
GlobysBan: bets $0.08
iskarian: folds=20
Uncalled bet ($0.08) returned to GlobysBan
GlobysBan collected $0.13 from pot
*** SUMMARY ***
Total pot $0.13 | Rake $0=20
Board [As Jc 3s]
Seat 1: the_wickstar folded before Flop (didn't bet)
Seat 2: pdilaccio folded before Flop (didn't bet)
Seat 3: Humanfritz folded before Flop (didn't bet)
Seat 4: IIVadimII folded before Flop (didn't bet)
Seat 6: IceAngel82 folded before Flop (didn't bet)
Seat 7: GlobysBan (button) collected ($0.13)
Seat 8: 1tillit1 (small blind) folded before Flop
Seat 9: iskarian (big blind) folded on the Flop


*********** # 43 **************
PokerStars Hand #169851445598:  Hold'em No Limit ($0.01/$0.02 USD) - 20=
17/05/02 23:37:56 CUST [2017/05/02 9:37:56 ET]
Table 'Botha' 9-max Seat #2 is the button
Seat 1: IceAngel82 ($3.76 in chips)=20
Seat 2: infiniti888 ($1.45 in chips)=20
Seat 3: Sprut2013 ($2.52 in chips)=20
Seat 4: Leopoker888 ($2 in chips)=20
Seat 5: Tikinh00 ($2.13 in chips)=20
Seat 6: diment76 ($1.95 in chips)=20
Seat 7: the_wickstar ($2.53 in chips)=20
Seat 8: maksim.vl ($2 in chips)=20
Seat 9: Demonidze31 ($2.31 in chips)=20
Sprut2013: posts small blind $0.01
Leopoker888: posts big blind $0.02
*** HOLE CARDS ***
Dealt to the_wickstar [Kc 9c]
Tikinh00: calls $0.02
diment76: calls $0.02
the_wickstar: folds=20
maksim.vl: calls $0.02
Demonidze31: folds=20
IceAngel82: folds=20
infiniti888: folds=20
Sprut2013: calls $0.01
Leopoker888: checks=20
*** FLOP *** [Jc Qd 2s]
Sprut2013: checks=20
Leopoker888: checks=20
Tikinh00: checks=20
diment76: checks=20
maksim.vl: checks=20
*** TURN *** [Jc Qd 2s] [Jd]
Sprut2013: checks=20
Leopoker888: bets $0.10
Tikinh00: folds=20
diment76: folds=20
maksim.vl: folds=20
Sprut2013: folds=20
Uncalled bet ($0.10) returned to Leopoker888
Leopoker888 collected $0.10 from pot
Leopoker888: doesn't show hand=20
*** SUMMARY ***
Total pot $0.10 | Rake $0=20
Board [Jc Qd 2s Jd]
Seat 1: IceAngel82 folded before Flop (didn't bet)
Seat 2: infiniti888 (button) folded before Flop (didn't bet)
Seat 3: Sprut2013 (small blind) folded on the Turn
Seat 4: Leopoker888 (big blind) collected ($0.10)
Seat 5: Tikinh00 folded on the Turn
Seat 6: diment76 folded on the Turn
Seat 7: the_wickstar folded before Flop (didn't bet)
Seat 8: maksim.vl folded on the Turn
Seat 9: Demonidze31 folded before Flop (didn't bet)


*********** # 44 **************
PokerStars Hand #169851428405:  Hold'em No Limit ($0.01/$0.02 USD) - 20=
17/05/02 23:37:24 CUST [2017/05/02 9:37:24 ET]
Table 'Botha' 9-max Seat #1 is the button
Seat 1: IceAngel82 ($3.73 in chips)=20
Seat 2: infiniti888 ($1.45 in chips)=20
Seat 3: Sprut2013 ($2.54 in chips)=20
Seat 4: Leopoker888 ($2 in chips)=20
Seat 5: Tikinh00 ($2.13 in chips)=20
Seat 6: diment76 ($1.95 in chips)=20
Seat 7: the_wickstar ($2.53 in chips)=20
Seat 8: maksim.vl ($2 in chips)=20
Seat 9: Demonidze31 ($2.31 in chips)=20
infiniti888: posts small blind $0.01
Sprut2013: posts big blind $0.02
*** HOLE CARDS ***
Dealt to the_wickstar [Jd 7d]
Leopoker888: folds=20
Tikinh00: folds=20
diment76: folds=20
the_wickstar: folds=20
maksim.vl: folds=20
Demonidze31: folds=20
IceAngel82: raises $0.04 to $0.06
infiniti888: folds=20
Sprut2013: folds=20
Uncalled bet ($0.04) returned to IceAngel82
IceAngel82 collected $0.05 from pot
IceAngel82: doesn't show hand=20
*** SUMMARY ***
Total pot $0.05 | Rake $0=20
Seat 1: IceAngel82 (button) collected ($0.05)
Seat 2: infiniti888 (small blind) folded before Flop
Seat 3: Sprut2013 (big blind) folded before Flop
Seat 4: Leopoker888 folded before Flop (didn't bet)
Seat 5: Tikinh00 folded before Flop (didn't bet)
Seat 6: diment76 folded before Flop (didn't bet)
Seat 7: the_wickstar folded before Flop (didn't bet)
Seat 8: maksim.vl folded before Flop (didn't bet)
Seat 9: Demonidze31 folded before Flop (didn't bet)


*********** # 45 **************
PokerStars Hand #169851416472:  Hold'em No Limit ($0.01/$0.02 USD) - 20=
17/05/02 23:37:02 CUST [2017/05/02 9:37:02 ET]
Table 'Telephus' 9-max Seat #6 is the button
Seat 1: the_wickstar ($1.20 in chips)=20
Seat 2: pdilaccio ($0.77 in chips)=20
Seat 3: Humanfritz ($2.03 in chips)=20
Seat 4: IIVadimII ($0.87 in chips)=20
Seat 6: IceAngel82 ($2.22 in chips)=20
Seat 7: GlobysBan ($2.10 in chips)=20
Seat 8: 1tillit1 ($2.37 in chips)=20
Seat 9: iskarian ($2.03 in chips)=20
GlobysBan: posts small blind $0.01
1tillit1: posts big blind $0.02
*** HOLE CARDS ***
Dealt to the_wickstar [Ac 2c]
iskarian: folds=20
the_wickstar: folds=20
pdilaccio: calls $0.02
Humanfritz: folds=20
IIVadimII: folds=20
IceAngel82: folds=20
GlobysBan: calls $0.01
1tillit1: checks=20
*** FLOP *** [5d 6c Qh]
GlobysBan: checks=20
1tillit1: checks=20
pdilaccio: checks=20
*** TURN *** [5d 6c Qh] [4h]
GlobysBan: checks=20
1tillit1: checks=20
pdilaccio: checks=20
*** RIVER *** [5d 6c Qh 4h] [4c]
GlobysBan: checks=20
1tillit1: checks=20
pdilaccio: checks=20
*** SHOW DOWN ***
GlobysBan: shows [8d 9c] (a pair of Fours)
1tillit1: shows [6h 9d] (two pair, Sixes and Fours)
pdilaccio: mucks hand=20
1tillit1 collected $0.06 from pot
*** SUMMARY ***
Total pot $0.06 | Rake $0=20
Board [5d 6c Qh 4h 4c]
Seat 1: the_wickstar folded before Flop (didn't bet)
Seat 2: pdilaccio mucked [Js 9s]
Seat 3: Humanfritz folded before Flop (didn't bet)
Seat 4: IIVadimII folded before Flop (didn't bet)
Seat 6: IceAngel82 (button) folded before Flop (didn't bet)
Seat 7: GlobysBan (small blind) showed [8d 9c] and lost with a pair of =
Fours
Seat 8: 1tillit1 (big blind) showed [6h 9d] and won ($0.06) with two pa=
ir, Sixes and Fours
Seat 9: iskarian folded before Flop (didn't bet)


*********** # 46 **************
PokerStars Hand #169851405374:  Hold'em No Limit ($0.01/$0.02 USD) - 20=
17/05/02 23:36:41 CUST [2017/05/02 9:36:41 ET]
Table 'Botha' 9-max Seat #9 is the button
Seat 1: IceAngel82 ($3.74 in chips)=20
Seat 2: infiniti888 ($1.45 in chips)=20
Seat 3: Sprut2013 ($2.54 in chips)=20
Seat 4: Leopoker888 ($2 in chips)=20
Seat 5: Tikinh00 ($2.13 in chips)=20
Seat 6: diment76 ($1.90 in chips)=20
Seat 7: the_wickstar ($2.53 in chips)=20
Seat 8: maksim.vl ($2 in chips)=20
Seat 9: Demonidze31 ($2.33 in chips)=20
IceAngel82: posts small blind $0.01
infiniti888: posts big blind $0.02
*** HOLE CARDS ***
Dealt to the_wickstar [2h 6s]
Sprut2013: folds=20
Leopoker888: folds=20
Tikinh00: folds=20
diment76: calls $0.02
the_wickstar: folds=20
maksim.vl: folds=20
Demonidze31: calls $0.02
IceAngel82: folds=20
infiniti888: checks=20
*** FLOP *** [7s Qs 2s]
infiniti888: checks=20
diment76: bets $0.04
Demonidze31: folds=20
infiniti888: folds=20
Uncalled bet ($0.04) returned to diment76
diment76 collected $0.07 from pot
*** SUMMARY ***
Total pot $0.07 | Rake $0=20
Board [7s Qs 2s]
Seat 1: IceAngel82 (small blind) folded before Flop
Seat 2: infiniti888 (big blind) folded on the Flop
Seat 3: Sprut2013 folded before Flop (didn't bet)
Seat 4: Leopoker888 folded before Flop (didn't bet)
Seat 5: Tikinh00 folded before Flop (didn't bet)
Seat 6: diment76 collected ($0.07)
Seat 7: the_wickstar folded before Flop (didn't bet)
Seat 8: maksim.vl folded before Flop (didn't bet)
Seat 9: Demonidze31 (button) folded on the Flop


*********** # 47 **************
PokerStars Hand #169851402803:  Hold'em No Limit ($0.01/$0.02 USD) - 20=
17/05/02 23:36:36 CUST [2017/05/02 9:36:36 ET]
Table 'Telephus' 9-max Seat #4 is the button
Seat 1: the_wickstar ($1.20 in chips)=20
Seat 2: pdilaccio ($0.77 in chips)=20
Seat 3: Humanfritz ($2.03 in chips)=20
Seat 4: IIVadimII ($0.87 in chips)=20
Seat 6: IceAngel82 ($2.23 in chips)=20
Seat 7: GlobysBan ($2.09 in chips)=20
Seat 8: 1tillit1 ($2.37 in chips)=20
Seat 9: iskarian ($2.03 in chips)=20
IceAngel82: posts small blind $0.01
GlobysBan: posts big blind $0.02
*** HOLE CARDS ***
Dealt to the_wickstar [2d Tc]
1tillit1: folds=20
iskarian: folds=20
the_wickstar: folds=20
pdilaccio: folds=20
Humanfritz: folds=20
IIVadimII: folds=20
IceAngel82: folds=20
Uncalled bet ($0.01) returned to GlobysBan
GlobysBan collected $0.02 from pot
*** SUMMARY ***
Total pot $0.02 | Rake $0=20
Seat 1: the_wickstar folded before Flop (didn't bet)
Seat 2: pdilaccio folded before Flop (didn't bet)
Seat 3: Humanfritz folded before Flop (didn't bet)
Seat 4: IIVadimII (button) folded before Flop (didn't bet)
Seat 6: IceAngel82 (small blind) folded before Flop
Seat 7: GlobysBan (big blind) collected ($0.02)
Seat 8: 1tillit1 folded before Flop (didn't bet)
Seat 9: iskarian folded before Flop (didn't bet)


*********** # 48 **************
PokerStars Hand #169851387138:  Hold'em No Limit ($0.01/$0.02 USD) - 20=
17/05/02 23:36:07 CUST [2017/05/02 9:36:07 ET]
Table 'Telephus' 9-max Seat #3 is the button
Seat 1: the_wickstar ($1.20 in chips)=20
Seat 2: pdilaccio ($0.77 in chips)=20
Seat 3: Humanfritz ($2.03 in chips)=20
Seat 4: IIVadimII ($0.88 in chips)=20
Seat 6: IceAngel82 ($2.25 in chips)=20
Seat 7: GlobysBan ($2.06 in chips)=20
Seat 8: 1tillit1 ($2.37 in chips)=20
Seat 9: iskarian ($2.03 in chips)=20
IIVadimII: posts small blind $0.01
IceAngel82: posts big blind $0.02
*** HOLE CARDS ***
Dealt to the_wickstar [2s 9h]
GlobysBan: raises $0.04 to $0.06
1tillit1: folds=20
iskarian: folds=20
the_wickstar: folds=20
pdilaccio: folds=20
Humanfritz: folds=20
IIVadimII: folds=20
IceAngel82: folds=20
Uncalled bet ($0.04) returned to GlobysBan
GlobysBan collected $0.05 from pot
*** SUMMARY ***
Total pot $0.05 | Rake $0=20
Seat 1: the_wickstar folded before Flop (didn't bet)
Seat 2: pdilaccio folded before Flop (didn't bet)
Seat 3: Humanfritz (button) folded before Flop (didn't bet)
Seat 4: IIVadimII (small blind) folded before Flop
Seat 6: IceAngel82 (big blind) folded before Flop
Seat 7: GlobysBan collected ($0.05)
Seat 8: 1tillit1 folded before Flop (didn't bet)
Seat 9: iskarian folded before Flop (didn't bet)


*********** # 49 **************
PokerStars Hand #169851362674:  Hold'em No Limit ($0.01/$0.02 USD) - 20=
17/05/02 23:35:21 CUST [2017/05/02 9:35:21 ET]
Table 'Telephus' 9-max Seat #2 is the button
Seat 1: the_wickstar ($1.20 in chips)=20
Seat 2: pdilaccio ($0.72 in chips)=20
Seat 3: Humanfritz ($2.04 in chips)=20
Seat 4: IIVadimII ($0.92 in chips)=20
Seat 6: IceAngel82 ($2.25 in chips)=20
Seat 7: GlobysBan ($2.06 in chips)=20
Seat 8: 1tillit1 ($2.37 in chips)=20
Seat 9: iskarian ($2.03 in chips)=20
Humanfritz: posts small blind $0.01
IIVadimII: posts big blind $0.02
*** HOLE CARDS ***
Dealt to the_wickstar [7s Kh]
IceAngel82: folds=20
GlobysBan: folds=20
1tillit1: folds=20
iskarian: folds=20
the_wickstar has timed out
the_wickstar: folds=20
pdilaccio: calls $0.02
Humanfritz: folds=20
IIVadimII: checks=20
*** FLOP *** [3d 6c 6d]
IIVadimII: bets $0.02
pdilaccio: calls $0.02
*** TURN *** [3d 6c 6d] [Jd]
IIVadimII: checks=20
pdilaccio: checks=20
*** RIVER *** [3d 6c 6d Jd] [3c]
IIVadimII: checks=20
pdilaccio: checks=20
*** SHOW DOWN ***
IIVadimII: shows [2d 2h] (two pair, Sixes and Threes)
pdilaccio: shows [Qc Qs] (two pair, Queens and Sixes)
pdilaccio collected $0.09 from pot
*** SUMMARY ***
Total pot $0.09 | Rake $0=20
Board [3d 6c 6d Jd 3c]
Seat 1: the_wickstar folded before Flop (didn't bet)
Seat 2: pdilaccio (button) showed [Qc Qs] and won ($0.09) with two pair=
, Queens and Sixes
Seat 3: Humanfritz (small blind) folded before Flop
Seat 4: IIVadimII (big blind) showed [2d 2h] and lost with two pair, Si=
xes and Threes
Seat 6: IceAngel82 folded before Flop (didn't bet)
Seat 7: GlobysBan folded before Flop (didn't bet)
Seat 8: 1tillit1 folded before Flop (didn't bet)
Seat 9: iskarian folded before Flop (didn't bet)


*********** # 50 **************
PokerStars Hand #169851354606:  Hold'em No Limit ($0.01/$0.02 USD) - 20=
17/05/02 23:35:05 CUST [2017/05/02 9:35:05 ET]
Table 'Botha' 9-max Seat #8 is the button
Seat 1: IceAngel82 ($3.80 in chips)=20
Seat 2: infiniti888 ($1.45 in chips)=20
Seat 3: Sprut2013 ($2.54 in chips)=20
Seat 4: Leopoker888 ($2.04 in chips)=20
Seat 5: Tikinh00 ($2.13 in chips)=20
Seat 6: diment76 ($1.90 in chips)=20
Seat 7: the_wickstar ($2.59 in chips)=20
Seat 8: maksim.vl ($2 in chips)=20
Seat 9: Demonidze31 ($2.16 in chips)=20
Demonidze31: posts small blind $0.01
IceAngel82: posts big blind $0.02
*** HOLE CARDS ***
Dealt to the_wickstar [Qh Ac]
infiniti888: folds=20
Sprut2013: folds=20
Leopoker888: raises $0.04 to $0.06
Tikinh00: folds=20
diment76: folds=20
the_wickstar: calls $0.06
maksim.vl: folds=20
Demonidze31: calls $0.05
IceAngel82: calls $0.04
*** FLOP *** [Kd 9c Jh]
Demonidze31: checks=20
IceAngel82: checks=20
Leopoker888: checks=20
the_wickstar: checks=20
*** TURN *** [Kd 9c Jh] [3d]
Demonidze31: bets $0.21
IceAngel82: folds=20
Leopoker888: folds=20
the_wickstar: folds=20
Uncalled bet ($0.21) returned to Demonidze31
Demonidze31 collected $0.23 from pot
Demonidze31: doesn't show hand=20
*** SUMMARY ***
Total pot $0.24 | Rake $0.01=20
Board [Kd 9c Jh 3d]
Seat 1: IceAngel82 (big blind) folded on the Turn
Seat 2: infiniti888 folded before Flop (didn't bet)
Seat 3: Sprut2013 folded before Flop (didn't bet)
Seat 4: Leopoker888 folded on the Turn
Seat 5: Tikinh00 folded before Flop (didn't bet)
Seat 6: diment76 folded before Flop (didn't bet)
Seat 7: the_wickstar folded on the Turn
Seat 8: maksim.vl (button) folded before Flop (didn't bet)
Seat 9: Demonidze31 (small blind) collected ($0.23)


*********** # 51 **************
PokerStars Hand #169851336426:  Hold'em No Limit ($0.01/$0.02 USD) - 20=
17/05/02 23:34:31 CUST [2017/05/02 9:34:31 ET]
Table 'Telephus' 9-max Seat #1 is the button
Seat 1: the_wickstar ($1.20 in chips)=20
Seat 2: pdilaccio ($0.73 in chips)=20
Seat 3: Humanfritz ($2.06 in chips)=20
Seat 4: IIVadimII ($0.75 in chips)=20
Seat 6: IceAngel82 ($2.27 in chips)=20
Seat 7: GlobysBan ($2.06 in chips)=20
Seat 8: 1tillit1 ($2.49 in chips)=20
Seat 9: iskarian ($2.03 in chips)=20
pdilaccio: posts small blind $0.01
Humanfritz: posts big blind $0.02
*** HOLE CARDS ***
Dealt to the_wickstar [6c 6s]
IIVadimII: calls $0.02
IceAngel82: calls $0.02
GlobysBan: folds=20
RG&JP5 is disconnected=20
1tillit1: raises $0.10 to $0.12
iskarian: folds=20
the_wickstar: folds=20
pdilaccio: folds=20
Humanfritz: folds=20
IIVadimII: raises $0.16 to $0.28
IceAngel82: folds=20
1tillit1: folds=20
Uncalled bet ($0.16) returned to IIVadimII
IIVadimII collected $0.29 from pot
IIVadimII: doesn't show hand=20
*** SUMMARY ***
Total pot $0.29 | Rake $0=20
Seat 1: the_wickstar (button) folded before Flop (didn't bet)
Seat 2: pdilaccio (small blind) folded before Flop
Seat 3: Humanfritz (big blind) folded before Flop
Seat 4: IIVadimII collected ($0.29)
Seat 6: IceAngel82 folded before Flop
Seat 7: GlobysBan folded before Flop (didn't bet)
Seat 8: 1tillit1 folded before Flop
Seat 9: iskarian folded before Flop (didn't bet)


*********** # 52 **************
PokerStars Hand #169851320321:  Hold'em No Limit ($0.01/$0.02 USD) - 20=
17/05/02 23:34:01 CUST [2017/05/02 9:34:01 ET]
Table 'Telephus' 9-max Seat #9 is the button
Seat 1: the_wickstar ($1.21 in chips)=20
Seat 2: pdilaccio ($0.75 in chips)=20
Seat 3: Humanfritz ($2.03 in chips)=20
Seat 4: IIVadimII ($0.75 in chips)=20
Seat 6: IceAngel82 ($2.27 in chips)=20
Seat 7: GlobysBan ($2.06 in chips)=20
Seat 8: 1tillit1 ($2.49 in chips)=20
Seat 9: iskarian ($2.03 in chips)=20
the_wickstar: posts small blind $0.01
pdilaccio: posts big blind $0.02
*** HOLE CARDS ***
Dealt to the_wickstar [Ac 2s]
Humanfritz: raises $0.07 to $0.09
IIVadimII: folds=20
IceAngel82: folds=20
GlobysBan: folds=20
1tillit1: folds=20
iskarian: folds=20
the_wickstar: folds=20
pdilaccio: folds=20
Uncalled bet ($0.07) returned to Humanfritz
Humanfritz collected $0.05 from pot
Humanfritz: doesn't show hand=20
*** SUMMARY ***
Total pot $0.05 | Rake $0=20
Seat 1: the_wickstar (small blind) folded before Flop
Seat 2: pdilaccio (big blind) folded before Flop
Seat 3: Humanfritz collected ($0.05)
Seat 4: IIVadimII folded before Flop (didn't bet)
Seat 6: IceAngel82 folded before Flop (didn't bet)
Seat 7: GlobysBan folded before Flop (didn't bet)
Seat 8: 1tillit1 folded before Flop (didn't bet)
Seat 9: iskarian (button) folded before Flop (didn't bet)


*********** # 53 **************
PokerStars Hand #169851305437:  Hold'em No Limit ($0.01/$0.02 USD) - 20=
17/05/02 23:33:33 CUST [2017/05/02 9:33:33 ET]
Table 'Botha' 9-max Seat #7 is the button
Seat 1: IceAngel82 ($3.80 in chips)=20
Seat 2: infiniti888 ($1.45 in chips)=20
Seat 3: Sprut2013 ($2.54 in chips)=20
Seat 4: Leopoker888 ($2.04 in chips)=20
Seat 5: Tikinh00 ($2.03 in chips)=20
Seat 6: diment76 ($1.90 in chips)=20
Seat 7: the_wickstar ($2.65 in chips)=20
Seat 8: maksim.vl ($2 in chips)=20
Seat 9: Demonidze31 ($2.18 in chips)=20
maksim.vl: posts small blind $0.01
Demonidze31: posts big blind $0.02
*** HOLE CARDS ***
Dealt to the_wickstar [4d 3c]
IceAngel82: folds=20
infiniti888: calls $0.02
Sprut2013: folds=20
Leopoker888: folds=20
Tikinh00: calls $0.02
diment76: folds=20
the_wickstar: calls $0.02
maksim.vl: folds=20
Demonidze31: checks=20
*** FLOP *** [Jc 6h Ah]
Demonidze31: checks=20
infiniti888: checks=20
Tikinh00: checks=20
the_wickstar: checks=20
*** TURN *** [Jc 6h Ah] [4s]
Demonidze31: checks=20
infiniti888: checks=20
Tikinh00: bets $0.02
the_wickstar: calls $0.02
Demonidze31: folds=20
infiniti888: folds=20
*** RIVER *** [Jc 6h Ah 4s] [6d]
Tikinh00: bets $0.02
the_wickstar: calls $0.02
*** SHOW DOWN ***
Tikinh00: shows [Ac 5d] (two pair, Aces and Sixes)
the_wickstar: mucks hand=20
Tikinh00 collected $0.16 from pot
*** SUMMARY ***
Total pot $0.17 | Rake $0.01=20
Board [Jc 6h Ah 4s 6d]
Seat 1: IceAngel82 folded before Flop (didn't bet)
Seat 2: infiniti888 folded on the Turn
Seat 3: Sprut2013 folded before Flop (didn't bet)
Seat 4: Leopoker888 folded before Flop (didn't bet)
Seat 5: Tikinh00 showed [Ac 5d] and won ($0.16) with two pair, Aces and=
 Sixes
Seat 6: diment76 folded before Flop (didn't bet)
Seat 7: the_wickstar (button) mucked [4d 3c]
Seat 8: maksim.vl (small blind) folded before Flop
Seat 9: Demonidze31 (big blind) folded on the Turn


*********** # 54 **************
PokerStars Hand #169851301582:  Hold'em No Limit ($0.01/$0.02 USD) - 20=
17/05/02 23:33:26 CUST [2017/05/02 9:33:26 ET]
Table 'Telephus' 9-max Seat #8 is the button
Seat 1: the_wickstar ($1.23 in chips)=20
Seat 2: pdilaccio ($0.75 in chips)=20
Seat 3: Humanfritz ($2.03 in chips)=20
Seat 4: IIVadimII ($0.75 in chips)=20
Seat 6: IceAngel82 ($2.24 in chips)=20
Seat 7: GlobysBan ($2.06 in chips)=20
Seat 8: 1tillit1 ($2.49 in chips)=20
Seat 9: iskarian ($2.04 in chips)=20
iskarian: posts small blind $0.01
the_wickstar: posts big blind $0.02
*** HOLE CARDS ***
Dealt to the_wickstar [4d 2c]
pdilaccio: folds=20
RG&JP5 is disconnected=20
Humanfritz: folds=20
IIVadimII: folds=20
IceAngel82: raises $0.04 to $0.06
GlobysBan: folds=20
1tillit1: folds=20
iskarian: folds=20
the_wickstar: folds=20
Uncalled bet ($0.04) returned to IceAngel82
IceAngel82 collected $0.05 from pot
IceAngel82: doesn't show hand=20
*** SUMMARY ***
Total pot $0.05 | Rake $0=20
Seat 1: the_wickstar (big blind) folded before Flop
Seat 2: pdilaccio folded before Flop (didn't bet)
Seat 3: Humanfritz folded before Flop (didn't bet)
Seat 4: IIVadimII folded before Flop (didn't bet)
Seat 6: IceAngel82 collected ($0.05)
Seat 7: GlobysBan folded before Flop (didn't bet)
Seat 8: 1tillit1 (button) folded before Flop (didn't bet)
Seat 9: iskarian (small blind) folded before Flop


*********** # 55 **************
PokerStars Hand #169851283280:  Hold'em No Limit ($0.01/$0.02 USD) - 20=
17/05/02 23:32:52 CUST [2017/05/02 9:32:52 ET]
Table 'Telephus' 9-max Seat #7 is the button
Seat 1: the_wickstar ($1.23 in chips)=20
Seat 2: pdilaccio ($0.75 in chips)=20
Seat 3: Humanfritz ($2.03 in chips)=20
Seat 4: IIVadimII ($0.75 in chips)=20
Seat 6: IceAngel82 ($2.24 in chips)=20
Seat 7: GlobysBan ($2.06 in chips)=20
Seat 8: 1tillit1 ($2.50 in chips)=20
Seat 9: iskarian ($2.03 in chips)=20
1tillit1: posts small blind $0.01
iskarian: posts big blind $0.02
*** HOLE CARDS ***
Dealt to the_wickstar [5c 8c]
the_wickstar: folds=20
pdilaccio: folds=20
Humanfritz: folds=20
IIVadimII: folds=20
IceAngel82: folds=20
GlobysBan: folds=20
1tillit1: folds=20
Uncalled bet ($0.01) returned to iskarian
iskarian collected $0.02 from pot
iskarian: doesn't show hand=20
*** SUMMARY ***
Total pot $0.02 | Rake $0=20
Seat 1: the_wickstar folded before Flop (didn't bet)
Seat 2: pdilaccio folded before Flop (didn't bet)
Seat 3: Humanfritz folded before Flop (didn't bet)
Seat 4: IIVadimII folded before Flop (didn't bet)
Seat 6: IceAngel82 folded before Flop (didn't bet)
Seat 7: GlobysBan (button) folded before Flop (didn't bet)
Seat 8: 1tillit1 (small blind) folded before Flop
Seat 9: iskarian (big blind) collected ($0.02)


*********** # 56 **************
PokerStars Hand #169851265206:  Hold'em No Limit ($0.01/$0.02 USD) - 20=
17/05/02 23:32:18 CUST [2017/05/02 9:32:18 ET]
Table 'Botha' 9-max Seat #6 is the button
Seat 1: IceAngel82 ($3.86 in chips)=20
Seat 2: infiniti888 ($1.45 in chips)=20
Seat 3: Sprut2013 ($2.56 in chips)=20
Seat 4: Leopoker888 ($2.04 in chips)=20
Seat 5: Tikinh00 ($2.09 in chips)=20
Seat 6: diment76 ($1.90 in chips)=20
Seat 7: the_wickstar ($2.50 in chips)=20
Seat 8: maksim.vl ($2 in chips)=20
Seat 9: Demonidze31 ($2.18 in chips)=20
the_wickstar: posts small blind $0.01
maksim.vl: posts big blind $0.02
*** HOLE CARDS ***
Dealt to the_wickstar [Jd Jh]
Demonidze31: folds=20
IceAngel82: calls $0.02
infiniti888: folds=20
Sprut2013: calls $0.02
Leopoker888: folds=20
Tikinh00: calls $0.02
diment76: folds=20
the_wickstar: raises $0.04 to $0.06
maksim.vl: folds=20
IceAngel82: calls $0.04
Sprut2013: folds=20
Tikinh00: calls $0.04
*** FLOP *** [9h 7h Qs]
the_wickstar: checks=20
IceAngel82: checks=20
Tikinh00: checks=20
*** TURN *** [9h 7h Qs] [4s]
the_wickstar: bets $0.11
IceAngel82: folds=20
Tikinh00: folds=20
Uncalled bet ($0.11) returned to the_wickstar
the_wickstar collected $0.21 from pot
*** SUMMARY ***
Total pot $0.22 | Rake $0.01=20
Board [9h 7h Qs 4s]
Seat 1: IceAngel82 folded on the Turn
Seat 2: infiniti888 folded before Flop (didn't bet)
Seat 3: Sprut2013 folded before Flop
Seat 4: Leopoker888 folded before Flop (didn't bet)
Seat 5: Tikinh00 folded on the Turn
Seat 6: diment76 (button) folded before Flop (didn't bet)
Seat 7: the_wickstar (small blind) collected ($0.21)
Seat 8: maksim.vl (big blind) folded before Flop
Seat 9: Demonidze31 folded before Flop (didn't bet)


*********** # 57 **************
PokerStars Hand #169851265064:  Hold'em No Limit ($0.01/$0.02 USD) - 20=
17/05/02 23:32:17 CUST [2017/05/02 9:32:17 ET]
Table 'Telephus' 9-max Seat #6 is the button
Seat 1: the_wickstar ($1.23 in chips)=20
Seat 2: pdilaccio ($0.75 in chips)=20
Seat 3: Humanfritz ($2.03 in chips)=20
Seat 4: IIVadimII ($0.75 in chips)=20
Seat 6: IceAngel82 ($2.24 in chips)=20
Seat 7: GlobysBan ($2.07 in chips)=20
Seat 8: 1tillit1 ($2.52 in chips)=20
Seat 9: iskarian ($2 in chips)=20
GlobysBan: posts small blind $0.01
1tillit1: posts big blind $0.02
*** HOLE CARDS ***
Dealt to the_wickstar [6s Jd]
iskarian: raises $0.03 to $0.05
the_wickstar: folds=20
pdilaccio: folds=20
Humanfritz: folds=20
IIVadimII: folds=20
IceAngel82: folds=20
GlobysBan: folds=20
1tillit1: folds=20
Uncalled bet ($0.03) returned to iskarian
iskarian collected $0.05 from pot
iskarian: doesn't show hand=20
*** SUMMARY ***
Total pot $0.05 | Rake $0=20
Seat 1: the_wickstar folded before Flop (didn't bet)
Seat 2: pdilaccio folded before Flop (didn't bet)
Seat 3: Humanfritz folded before Flop (didn't bet)
Seat 4: IIVadimII folded before Flop (didn't bet)
Seat 6: IceAngel82 (button) folded before Flop (didn't bet)
Seat 7: GlobysBan (small blind) folded before Flop
Seat 8: 1tillit1 (big blind) folded before Flop
Seat 9: iskarian collected ($0.05)


*********** # 58 **************
PokerStars Hand #169851249549:  Hold'em No Limit ($0.01/$0.02 USD) - 20=
17/05/02 23:31:48 CUST [2017/05/02 9:31:48 ET]
Table 'Telephus' 9-max Seat #4 is the button
Seat 1: the_wickstar ($1.20 in chips)=20
Seat 2: pdilaccio ($0.75 in chips)=20
Seat 3: Humanfritz ($2.03 in chips)=20
Seat 4: IIVadimII ($0.75 in chips)=20
Seat 6: IceAngel82 ($2.25 in chips)=20
Seat 7: GlobysBan ($2.09 in chips)=20
Seat 8: 1tillit1 ($2.52 in chips)=20
Seat 9: iskarian ($2 in chips)=20
RG&JP5 will be allowed to play after the button
IceAngel82: posts small blind $0.01
GlobysBan: posts big blind $0.02
*** HOLE CARDS ***
Dealt to the_wickstar [Ah Qd]
1tillit1: folds=20
iskarian: folds=20
the_wickstar: calls $0.02
pdilaccio: folds=20
Humanfritz: folds=20
IIVadimII: folds=20
IceAngel82: folds=20
GlobysBan: checks=20
*** FLOP *** [Qc Js 7d]
GlobysBan: checks=20
the_wickstar: bets $0.03
GlobysBan: folds=20
Uncalled bet ($0.03) returned to the_wickstar
the_wickstar collected $0.05 from pot
*** SUMMARY ***
Total pot $0.05 | Rake $0=20
Board [Qc Js 7d]
Seat 1: the_wickstar collected ($0.05)
Seat 2: pdilaccio folded before Flop (didn't bet)
Seat 3: Humanfritz folded before Flop (didn't bet)
Seat 4: IIVadimII (button) folded before Flop (didn't bet)
Seat 6: IceAngel82 (small blind) folded before Flop
Seat 7: GlobysBan (big blind) folded on the Flop
Seat 8: 1tillit1 folded before Flop (didn't bet)
Seat 9: iskarian folded before Flop (didn't bet)


*********** # 59 **************
PokerStars Hand #169851234181:  Hold'em No Limit ($0.01/$0.02 USD) - 20=
17/05/02 23:31:19 CUST [2017/05/02 9:31:19 ET]
Table 'Telephus' 9-max Seat #3 is the button
Seat 1: the_wickstar ($1.20 in chips)=20
Seat 2: pdilaccio ($0.75 in chips)=20
Seat 3: Humanfritz ($2 in chips)=20
Seat 4: IIVadimII ($0.76 in chips)=20
Seat 6: IceAngel82 ($2.27 in chips)=20
Seat 7: GlobysBan ($2.09 in chips)=20
Seat 8: 1tillit1 ($2.52 in chips)=20
Seat 9: iskarian ($2 in chips)=20
IIVadimII: posts small blind $0.01
IceAngel82: posts big blind $0.02
*** HOLE CARDS ***
Dealt to the_wickstar [6d 9c]
GlobysBan: folds=20
1tillit1: folds=20
iskarian: folds=20
the_wickstar: folds=20
pdilaccio: folds=20
Humanfritz: raises $0.07 to $0.09
IIVadimII: folds=20
IceAngel82: folds=20
Uncalled bet ($0.07) returned to Humanfritz
Humanfritz collected $0.05 from pot
Humanfritz: doesn't show hand=20
*** SUMMARY ***
Total pot $0.05 | Rake $0=20
Seat 1: the_wickstar folded before Flop (didn't bet)
Seat 2: pdilaccio folded before Flop (didn't bet)
Seat 3: Humanfritz (button) collected ($0.05)
Seat 4: IIVadimII (small blind) folded before Flop
Seat 6: IceAngel82 (big blind) folded before Flop
Seat 7: GlobysBan folded before Flop (didn't bet)
Seat 8: 1tillit1 folded before Flop (didn't bet)
Seat 9: iskarian folded before Flop (didn't bet)


*********** # 60 **************
PokerStars Hand #169851233055:  Hold'em No Limit ($0.01/$0.02 USD) - 20=
17/05/02 23:31:17 CUST [2017/05/02 9:31:17 ET]
Table 'Botha' 9-max Seat #5 is the button
Seat 1: IceAngel82 ($3.86 in chips)=20
Seat 2: infiniti888 ($1.45 in chips)=20
Seat 3: Sprut2013 ($2.56 in chips)=20
Seat 4: Leopoker888 ($2.04 in chips)=20
Seat 5: Tikinh00 ($2.11 in chips)=20
Seat 6: diment76 ($1.86 in chips)=20
Seat 7: the_wickstar ($2.52 in chips)=20
Seat 8: WebCamSasha ($2 in chips)=20
Seat 9: Demonidze31 ($2.18 in chips)=20
diment76: posts small blind $0.01
the_wickstar: posts big blind $0.02
*** HOLE CARDS ***
Dealt to the_wickstar [Ks 2s]
WebCamSasha: folds=20
Demonidze31: folds=20
IceAngel82: folds=20
WebCamSasha leaves the table
maksim.vl joins the table at seat #8=20
infiniti888: folds=20
Sprut2013: folds=20
Leopoker888: folds=20
Tikinh00: calls $0.02
diment76: calls $0.01
the_wickstar: checks=20
*** FLOP *** [Tc 6d Td]
diment76: checks=20
the_wickstar: checks=20
Tikinh00: checks=20
*** TURN *** [Tc 6d Td] [As]
diment76: checks=20
the_wickstar: checks=20
Tikinh00: checks=20
*** RIVER *** [Tc 6d Td As] [5h]
diment76: checks=20
the_wickstar: checks=20
Tikinh00: checks=20
*** SHOW DOWN ***
diment76: shows [6h 5c] (two pair, Tens and Sixes)
the_wickstar: mucks hand=20
Tikinh00: mucks hand=20
diment76 collected $0.06 from pot
*** SUMMARY ***
Total pot $0.06 | Rake $0=20
Board [Tc 6d Td As 5h]
Seat 1: IceAngel82 folded before Flop (didn't bet)
Seat 2: infiniti888 folded before Flop (didn't bet)
Seat 3: Sprut2013 folded before Flop (didn't bet)
Seat 4: Leopoker888 folded before Flop (didn't bet)
Seat 5: Tikinh00 (button) mucked [2h 3h]
Seat 6: diment76 (small blind) showed [6h 5c] and won ($0.06) with two =
pair, Tens and Sixes
Seat 7: the_wickstar (big blind) mucked [Ks 2s]
Seat 8: WebCamSasha folded before Flop (didn't bet)
Seat 9: Demonidze31 folded before Flop (didn't bet)


*********** # 61 **************
PokerStars Hand #169851212743:  Hold'em No Limit ($0.01/$0.02 USD) - 20=
17/05/02 23:30:39 CUST [2017/05/02 9:30:39 ET]
Table 'Telephus' 9-max Seat #2 is the button
Seat 1: the_wickstar ($1.20 in chips)=20
Seat 2: pdilaccio ($0.70 in chips)=20
Seat 3: Humanfritz ($2 in chips)=20
Seat 4: IIVadimII ($0.80 in chips)=20
Seat 6: IceAngel82 ($2.27 in chips)=20
Seat 7: GlobysBan ($2.09 in chips)=20
Seat 8: 1tillit1 ($2.52 in chips)=20
Seat 9: iskarian ($2 in chips)=20
Humanfritz: posts small blind $0.01
IIVadimII: posts big blind $0.02
*** HOLE CARDS ***
Dealt to the_wickstar [3c 4c]
IceAngel82: folds=20
GlobysBan: folds=20
1tillit1: folds=20
iskarian: folds=20
the_wickstar: folds=20
pdilaccio: calls $0.02
Humanfritz: folds=20
IIVadimII: checks=20
*** FLOP *** [Kc Jc 5d]
IIVadimII: checks=20
pdilaccio: checks=20
*** TURN *** [Kc Jc 5d] [Qc]
IIVadimII: checks=20
pdilaccio: checks=20
*** RIVER *** [Kc Jc 5d Qc] [7c]
IIVadimII: bets $0.02
pdilaccio: calls $0.02
*** SHOW DOWN ***
IIVadimII: shows [3h 8d] (high card King)
pdilaccio: shows [2d 2c] (a flush, King high)
pdilaccio collected $0.09 from pot
*** SUMMARY ***
Total pot $0.09 | Rake $0=20
Board [Kc Jc 5d Qc 7c]
Seat 1: the_wickstar folded before Flop (didn't bet)
Seat 2: pdilaccio (button) showed [2d 2c] and won ($0.09) with a flush,=
 King high
Seat 3: Humanfritz (small blind) folded before Flop
Seat 4: IIVadimII (big blind) showed [3h 8d] and lost with high card Ki=
ng
Seat 6: IceAngel82 folded before Flop (didn't bet)
Seat 7: GlobysBan folded before Flop (didn't bet)
Seat 8: 1tillit1 folded before Flop (didn't bet)
Seat 9: iskarian folded before Flop (didn't bet)


*********** # 62 **************
PokerStars Hand #169851205760:  Hold'em No Limit ($0.01/$0.02 USD) - 20=
17/05/02 23:30:26 CUST [2017/05/02 9:30:26 ET]
Table 'Botha' 9-max Seat #4 is the button
Seat 1: IceAngel82 ($3.86 in chips)=20
Seat 2: infiniti888 ($1.45 in chips)=20
Seat 3: Sprut2013 ($2.36 in chips)=20
Seat 4: Leopoker888 ($2.04 in chips)=20
Seat 5: Tikinh00 ($2.12 in chips)=20
Seat 6: diment76 ($1.88 in chips)=20
Seat 7: the_wickstar ($2.52 in chips)=20
Seat 8: WebCamSasha ($2 in chips)=20
Seat 9: Demonidze31 ($2.18 in chips)=20
Tikinh00: posts small blind $0.01
diment76: posts big blind $0.02
*** HOLE CARDS ***
Dealt to the_wickstar [Qd 6d]
the_wickstar: folds=20
WebCamSasha: raises $0.04 to $0.06
Demonidze31: folds=20
IceAngel82: folds=20
infiniti888: folds=20
Sprut2013: raises $0.12 to $0.18
Leopoker888: folds=20
Tikinh00: folds=20
diment76: folds=20
WebCamSasha: calls $0.12
*** FLOP *** [3c 2d Ah]
WebCamSasha: checks=20
Sprut2013: bets $0.16
WebCamSasha: folds=20
Uncalled bet ($0.16) returned to Sprut2013
Sprut2013 collected $0.38 from pot
Sprut2013: doesn't show hand=20
*** SUMMARY ***
Total pot $0.39 | Rake $0.01=20
Board [3c 2d Ah]
Seat 1: IceAngel82 folded before Flop (didn't bet)
Seat 2: infiniti888 folded before Flop (didn't bet)
Seat 3: Sprut2013 collected ($0.38)
Seat 4: Leopoker888 (button) folded before Flop (didn't bet)
Seat 5: Tikinh00 (small blind) folded before Flop
Seat 6: diment76 (big blind) folded before Flop
Seat 7: the_wickstar folded before Flop (didn't bet)
Seat 8: WebCamSasha folded on the Flop
Seat 9: Demonidze31 folded before Flop (didn't bet)


*********** # 63 **************
PokerStars Hand #169851194752:  Hold'em No Limit ($0.01/$0.02 USD) - 20=
17/05/02 23:30:05 CUST [2017/05/02 9:30:05 ET]
Table 'Telephus' 9-max Seat #1 is the button
Seat 1: the_wickstar ($1.26 in chips)=20
Seat 2: pdilaccio ($0.71 in chips)=20
Seat 3: Humanfritz ($2 in chips)=20
Seat 6: IceAngel82 ($2.27 in chips)=20
Seat 7: GlobysBan ($2.01 in chips)=20
Seat 8: 1tillit1 ($2.52 in chips)=20
Seat 9: iskarian ($2 in chips)=20
pdilaccio: posts small blind $0.01
Humanfritz: posts big blind $0.02
IIVadimII: sits out=20
*** HOLE CARDS ***
Dealt to the_wickstar [Ad 9c]
IceAngel82: folds=20
GlobysBan: raises $0.04 to $0.06
1tillit1: folds=20
iskarian: folds=20
the_wickstar: calls $0.06
pdilaccio: folds=20
Humanfritz: folds=20
*** FLOP *** [5d Qc 6c]
GlobysBan: bets $0.08
the_wickstar: folds=20
Uncalled bet ($0.08) returned to GlobysBan
GlobysBan collected $0.14 from pot
*** SUMMARY ***
Total pot $0.15 | Rake $0.01=20
Board [5d Qc 6c]
Seat 1: the_wickstar (button) folded on the Flop
Seat 2: pdilaccio (small blind) folded before Flop
Seat 3: Humanfritz (big blind) folded before Flop
Seat 6: IceAngel82 folded before Flop (didn't bet)
Seat 7: GlobysBan collected ($0.14)
Seat 8: 1tillit1 folded before Flop (didn't bet)
Seat 9: iskarian folded before Flop (didn't bet)


*********** # 64 **************
PokerStars Hand #169851177982:  Hold'em No Limit ($0.01/$0.02 USD) - 20=
17/05/02 23:29:34 CUST [2017/05/02 9:29:34 ET]
Table 'Botha' 9-max Seat #3 is the button
Seat 1: IceAngel82 ($3.86 in chips)=20
Seat 2: infiniti888 ($1.45 in chips)=20
Seat 3: Sprut2013 ($2.36 in chips)=20
Seat 4: Leopoker888 ($2.10 in chips)=20
Seat 5: Tikinh00 ($2.06 in chips)=20
Seat 6: diment76 ($1.88 in chips)=20
Seat 7: the_wickstar ($2.52 in chips)=20
Seat 8: WebCamSasha ($2 in chips)=20
Seat 9: Demonidze31 ($2.18 in chips)=20
Leopoker888: posts small blind $0.01
Tikinh00: posts big blind $0.02
*** HOLE CARDS ***
Dealt to the_wickstar [Td 4h]
diment76: folds=20
the_wickstar: folds=20
WebCamSasha: folds=20
Demonidze31: folds=20
IceAngel82: folds=20
infiniti888: folds=20
Sprut2013: folds=20
Leopoker888: raises $0.04 to $0.06
Tikinh00: raises $0.04 to $0.10
Leopoker888: folds=20
Uncalled bet ($0.04) returned to Tikinh00
Tikinh00 collected $0.12 from pot
Tikinh00: doesn't show hand=20
*** SUMMARY ***
Total pot $0.12 | Rake $0=20
Seat 1: IceAngel82 folded before Flop (didn't bet)
Seat 2: infiniti888 folded before Flop (didn't bet)
Seat 3: Sprut2013 (button) folded before Flop (didn't bet)
Seat 4: Leopoker888 (small blind) folded before Flop
Seat 5: Tikinh00 (big blind) collected ($0.12)
Seat 6: diment76 folded before Flop (didn't bet)
Seat 7: the_wickstar folded before Flop (didn't bet)
Seat 8: WebCamSasha folded before Flop (didn't bet)
Seat 9: Demonidze31 folded before Flop (didn't bet)


*********** # 65 **************
PokerStars Hand #169851176729:  Hold'em No Limit ($0.01/$0.02 USD) - 20=
17/05/02 23:29:32 CUST [2017/05/02 9:29:32 ET]
Table 'Telephus' 9-max Seat #9 is the button
Seat 1: the_wickstar ($1.28 in chips)=20
Seat 2: pdilaccio ($0.73 in chips)=20
Seat 3: Humanfritz ($2 in chips)=20
Seat 6: IceAngel82 ($2.27 in chips)=20
Seat 7: GlobysBan ($1.97 in chips)=20
Seat 8: 1tillit1 ($2.52 in chips)=20
Seat 9: iskarian ($2 in chips)=20
the_wickstar: posts small blind $0.01
pdilaccio: posts big blind $0.02
*** HOLE CARDS ***
Dealt to the_wickstar [Ad 8h]
Humanfritz: folds=20
IceAngel82: folds=20
GlobysBan: calls $0.02
1tillit1: folds=20
iskarian: folds=20
the_wickstar: calls $0.01
pdilaccio: checks=20
*** FLOP *** [Qh 9h 6s]
IIVadimII joins the table at seat #4=20
the_wickstar: checks=20
pdilaccio: checks=20
GlobysBan: bets $0.04
the_wickstar: folds=20
pdilaccio: folds=20
Uncalled bet ($0.04) returned to GlobysBan
GlobysBan collected $0.06 from pot
*** SUMMARY ***
Total pot $0.06 | Rake $0=20
Board [Qh 9h 6s]
Seat 1: the_wickstar (small blind) folded on the Flop
Seat 2: pdilaccio (big blind) folded on the Flop
Seat 3: Humanfritz folded before Flop (didn't bet)
Seat 6: IceAngel82 folded before Flop (didn't bet)
Seat 7: GlobysBan collected ($0.06)
Seat 8: 1tillit1 folded before Flop (didn't bet)
Seat 9: iskarian (button) folded before Flop (didn't bet)


*********** # 66 **************
PokerStars Hand #169851156329:  Hold'em No Limit ($0.01/$0.02 USD) - 20=
17/05/02 23:28:53 CUST [2017/05/02 9:28:53 ET]
Table 'Botha' 9-max Seat #2 is the button
Seat 1: IceAngel82 ($3.86 in chips)=20
Seat 2: infiniti888 ($1.45 in chips)=20
Seat 3: Sprut2013 ($2.30 in chips)=20
Seat 4: Leopoker888 ($2.12 in chips)=20
Seat 5: Tikinh00 ($2.08 in chips)=20
Seat 6: diment76 ($1.88 in chips)=20
Seat 7: the_wickstar ($2.54 in chips)=20
Seat 8: WebCamSasha ($2 in chips)=20
Seat 9: Demonidze31 ($2.18 in chips)=20
Sprut2013: posts small blind $0.01
Leopoker888: posts big blind $0.02
*** HOLE CARDS ***
Dealt to the_wickstar [Jd Qc]
Tikinh00: calls $0.02
diment76: folds=20
the_wickstar: calls $0.02
WebCamSasha: folds=20
Demonidze31: folds=20
IceAngel82: folds=20
infiniti888: folds=20
Sprut2013: raises $0.10 to $0.12
Leopoker888: folds=20
Tikinh00: folds=20
the_wickstar: folds=20
Uncalled bet ($0.10) returned to Sprut2013
Sprut2013 collected $0.08 from pot
Sprut2013: doesn't show hand=20
*** SUMMARY ***
Total pot $0.08 | Rake $0=20
Seat 1: IceAngel82 folded before Flop (didn't bet)
Seat 2: infiniti888 (button) folded before Flop (didn't bet)
Seat 3: Sprut2013 (small blind) collected ($0.08)
Seat 4: Leopoker888 (big blind) folded before Flop
Seat 5: Tikinh00 folded before Flop
Seat 6: diment76 folded before Flop (didn't bet)
Seat 7: the_wickstar folded before Flop
Seat 8: WebCamSasha folded before Flop (didn't bet)
Seat 9: Demonidze31 folded before Flop (didn't bet)


*********** # 67 **************
PokerStars Hand #169851148727:  Hold'em No Limit ($0.01/$0.02 USD) - 20=
17/05/02 23:28:39 CUST [2017/05/02 9:28:39 ET]
Table 'Telephus' 9-max Seat #8 is the button
Seat 1: the_wickstar ($1.30 in chips)=20
Seat 2: pdilaccio ($0.73 in chips)=20
Seat 3: Humanfritz ($2 in chips)=20
Seat 5: RG&JP5 ($1.92 in chips)=20
Seat 6: IceAngel82 ($2.24 in chips)=20
Seat 7: GlobysBan ($1.97 in chips)=20
Seat 8: 1tillit1 ($2.52 in chips)=20
Seat 9: iskarian ($2 in chips)=20
iskarian: posts small blind $0.01
the_wickstar: posts big blind $0.02
*** HOLE CARDS ***
Dealt to the_wickstar [4h 5d]
pdilaccio: folds=20
Humanfritz: folds=20
RG&JP5 has timed out while being disconnected
RG&JP5: folds=20
IceAngel82: raises $0.04 to $0.06
RG&JP5 is disconnected=20
GlobysBan: folds=20
1tillit1: folds=20
iskarian: folds=20
the_wickstar: folds=20
Uncalled bet ($0.04) returned to IceAngel82
IceAngel82 collected $0.05 from pot
IceAngel82: doesn't show hand=20
*** SUMMARY ***
Total pot $0.05 | Rake $0=20
Seat 1: the_wickstar (big blind) folded before Flop
Seat 2: pdilaccio folded before Flop (didn't bet)
Seat 3: Humanfritz folded before Flop (didn't bet)
Seat 5: RG&JP5 folded before Flop (didn't bet)
Seat 6: IceAngel82 collected ($0.05)
Seat 7: GlobysBan folded before Flop (didn't bet)
Seat 8: 1tillit1 (button) folded before Flop (didn't bet)
Seat 9: iskarian (small blind) folded before Flop


*********** # 68 **************
PokerStars Hand #169851141016:  Hold'em No Limit ($0.01/$0.02 USD) - 20=
17/05/02 23:28:24 CUST [2017/05/02 9:28:24 ET]
Table 'Botha' 9-max Seat #1 is the button
Seat 1: IceAngel82 ($3.79 in chips)=20
Seat 2: infiniti888 ($1.45 in chips)=20
Seat 3: Sprut2013 ($2.32 in chips)=20
Seat 4: Leopoker888 ($2.12 in chips)=20
Seat 5: Tikinh00 ($2.08 in chips)=20
Seat 6: diment76 ($1.88 in chips)=20
Seat 7: the_wickstar ($2.54 in chips)=20
Seat 8: WebCamSasha ($2 in chips)=20
Seat 9: Demonidze31 ($2.22 in chips)=20
infiniti888: posts small blind $0.01
Sprut2013: posts big blind $0.02
*** HOLE CARDS ***
Dealt to the_wickstar [Ks 6s]
Leopoker888: folds=20
Tikinh00: folds=20
diment76: folds=20
the_wickstar: folds=20
WebCamSasha: folds=20
Demonidze31: raises $0.02 to $0.04
IceAngel82: raises $0.06 to $0.10
infiniti888: folds=20
Sprut2013: folds=20
Demonidze31: folds=20
Uncalled bet ($0.06) returned to IceAngel82
IceAngel82 collected $0.11 from pot
IceAngel82: doesn't show hand=20
*** SUMMARY ***
Total pot $0.11 | Rake $0=20
Seat 1: IceAngel82 (button) collected ($0.11)
Seat 2: infiniti888 (small blind) folded before Flop
Seat 3: Sprut2013 (big blind) folded before Flop
Seat 4: Leopoker888 folded before Flop (didn't bet)
Seat 5: Tikinh00 folded before Flop (didn't bet)
Seat 6: diment76 folded before Flop (didn't bet)
Seat 7: the_wickstar folded before Flop (didn't bet)
Seat 8: WebCamSasha folded before Flop (didn't bet)
Seat 9: Demonidze31 folded before Flop


*********** # 69 **************
PokerStars Hand #169851137201:  Hold'em No Limit ($0.01/$0.02 USD) - 20=
17/05/02 23:28:17 CUST [2017/05/02 9:28:17 ET]
Table 'Telephus' 9-max Seat #7 is the button
Seat 1: the_wickstar ($1.30 in chips)=20
Seat 2: pdilaccio ($0.73 in chips)=20
Seat 3: Humanfritz ($2 in chips)=20
Seat 4: TrueLargen ($2 in chips)=20
Seat 5: RG&JP5 ($1.92 in chips)=20
Seat 6: IceAngel82 ($2.21 in chips)=20
Seat 7: GlobysBan ($1.97 in chips)=20
Seat 8: 1tillit1 ($2.53 in chips)=20
Seat 9: iskarian ($2 in chips)=20
1tillit1: posts small blind $0.01
iskarian: posts big blind $0.02
*** HOLE CARDS ***
Dealt to the_wickstar [Jh 5s]
the_wickstar: folds=20
pdilaccio: folds=20
Humanfritz: folds=20
TrueLargen: folds=20
RG&JP5: folds=20
IceAngel82: raises $0.04 to $0.06
GlobysBan: folds=20
1tillit1: folds=20
TrueLargen leaves the table
iskarian: folds=20
Uncalled bet ($0.04) returned to IceAngel82
IceAngel82 collected $0.05 from pot
IceAngel82: doesn't show hand=20
*** SUMMARY ***
Total pot $0.05 | Rake $0=20
Seat 1: the_wickstar folded before Flop (didn't bet)
Seat 2: pdilaccio folded before Flop (didn't bet)
Seat 3: Humanfritz folded before Flop (didn't bet)
Seat 4: TrueLargen folded before Flop (didn't bet)
Seat 5: RG&JP5 folded before Flop (didn't bet)
Seat 6: IceAngel82 collected ($0.05)
Seat 7: GlobysBan (button) folded before Flop (didn't bet)
Seat 8: 1tillit1 (small blind) folded before Flop
Seat 9: iskarian (big blind) folded before Flop


*********** # 70 **************
PokerStars Hand #169851113015:  Hold'em No Limit ($0.01/$0.02 USD) - 20=
17/05/02 23:27:31 CUST [2017/05/02 9:27:31 ET]
Table 'Telephus' 9-max Seat #6 is the button
Seat 1: the_wickstar ($1.30 in chips)=20
Seat 2: pdilaccio ($0.73 in chips)=20
Seat 3: Humanfritz ($2 in chips)=20
Seat 4: TrueLargen ($2 in chips)=20
Seat 5: RG&JP5 ($1.85 in chips)=20
Seat 6: IceAngel82 ($2.21 in chips)=20
Seat 7: GlobysBan ($1.98 in chips)=20
Seat 8: 1tillit1 ($2.59 in chips)=20
GlobysBan: posts small blind $0.01
1tillit1: posts big blind $0.02
iskarian: sits out=20
*** HOLE CARDS ***
Dealt to the_wickstar [6d 3s]
the_wickstar: folds=20
pdilaccio: folds=20
Humanfritz: folds=20
TrueLargen: folds=20
RG&JP5: raises $0.04 to $0.06
IceAngel82: folds=20
GlobysBan: folds=20
1tillit1: calls $0.04
*** FLOP *** [Tc 7h Qs]
1tillit1: checks=20
RG&JP5: bets $0.06
1tillit1: folds=20
Uncalled bet ($0.06) returned to RG&JP5
RG&JP5 collected $0.13 from pot
RG&JP5: doesn't show hand=20
*** SUMMARY ***
Total pot $0.13 | Rake $0=20
Board [Tc 7h Qs]
Seat 1: the_wickstar folded before Flop (didn't bet)
Seat 2: pdilaccio folded before Flop (didn't bet)
Seat 3: Humanfritz folded before Flop (didn't bet)
Seat 4: TrueLargen folded before Flop (didn't bet)
Seat 5: RG&JP5 collected ($0.13)
Seat 6: IceAngel82 (button) folded before Flop (didn't bet)
Seat 7: GlobysBan (small blind) folded before Flop
Seat 8: 1tillit1 (big blind) folded on the Flop


*********** # 71 **************
PokerStars Hand #169851110447:  Hold'em No Limit ($0.01/$0.02 USD) - 20=
17/05/02 23:27:26 CUST [2017/05/02 9:27:26 ET]
Table 'Botha' 9-max Seat #9 is the button
Seat 1: IceAngel82 ($3.75 in chips)=20
Seat 2: infiniti888 ($1.45 in chips)=20
Seat 3: Sprut2013 ($2.32 in chips)=20
Seat 4: Leopoker888 ($2.12 in chips)=20
Seat 5: Tikinh00 ($2.10 in chips)=20
Seat 6: diment76 ($1.88 in chips)=20
Seat 7: the_wickstar ($2.54 in chips)=20
Seat 8: WebCamSasha ($2 in chips)=20
Seat 9: Demonidze31 ($2.22 in chips)=20
IceAngel82: posts small blind $0.01
infiniti888: posts big blind $0.02
*** HOLE CARDS ***
Dealt to the_wickstar [Qd 6c]
Sprut2013: folds=20
Leopoker888: folds=20
Tikinh00: calls $0.02
diment76: folds=20
the_wickstar: folds=20
WebCamSasha: folds=20
Demonidze31: folds=20
IceAngel82: calls $0.01
infiniti888: checks=20
*** FLOP *** [3d 2h 4s]
IceAngel82: checks=20
infiniti888: checks=20
Tikinh00: checks=20
*** TURN *** [3d 2h 4s] [5s]
IceAngel82: checks=20
infiniti888: checks=20
Tikinh00: checks=20
*** RIVER *** [3d 2h 4s 5s] [Tc]
IceAngel82: checks=20
infiniti888: checks=20
Tikinh00: checks=20
*** SHOW DOWN ***
IceAngel82: shows [As 9s] (a straight, Ace to Five)
infiniti888: mucks hand=20
Tikinh00: mucks hand=20
IceAngel82 collected $0.06 from pot
*** SUMMARY ***
Total pot $0.06 | Rake $0=20
Board [3d 2h 4s 5s Tc]
Seat 1: IceAngel82 (small blind) showed [As 9s] and won ($0.06) with a =
straight, Ace to Five
Seat 2: infiniti888 (big blind) mucked [Jh 3c]
Seat 3: Sprut2013 folded before Flop (didn't bet)
Seat 4: Leopoker888 folded before Flop (didn't bet)
Seat 5: Tikinh00 mucked [9d Jc]
Seat 6: diment76 folded before Flop (didn't bet)
Seat 7: the_wickstar folded before Flop (didn't bet)
Seat 8: WebCamSasha folded before Flop (didn't bet)
Seat 9: Demonidze31 (button) folded before Flop (didn't bet)


*********** # 72 **************
PokerStars Hand #169851086013:  Hold'em No Limit ($0.01/$0.02 USD) - 20=
17/05/02 23:26:40 CUST [2017/05/02 9:26:40 ET]
Table 'Telephus' 9-max Seat #5 is the button
Seat 1: the_wickstar ($1.27 in chips)=20
Seat 2: pdilaccio ($0.73 in chips)=20
Seat 3: Humanfritz ($2 in chips)=20
Seat 4: TrueLargen ($2 in chips)=20
Seat 5: RG&JP5 ($1.85 in chips)=20
Seat 6: IceAngel82 ($2.22 in chips)=20
Seat 7: GlobysBan ($2 in chips)=20
Seat 8: 1tillit1 ($2.59 in chips)=20
IceAngel82: posts small blind $0.01
GlobysBan: posts big blind $0.02
iskarian: sits out=20
*** HOLE CARDS ***
Dealt to the_wickstar [Kc Ad]
1tillit1: folds=20
the_wickstar: raises $0.04 to $0.06
pdilaccio: folds=20
Humanfritz: folds=20
TrueLargen: folds=20
RG&JP5: folds=20
IceAngel82: folds=20
GlobysBan: folds=20
Uncalled bet ($0.04) returned to the_wickstar
the_wickstar collected $0.05 from pot
*** SUMMARY ***
Total pot $0.05 | Rake $0=20
Seat 1: the_wickstar collected ($0.05)
Seat 2: pdilaccio folded before Flop (didn't bet)
Seat 3: Humanfritz folded before Flop (didn't bet)
Seat 4: TrueLargen folded before Flop (didn't bet)
Seat 5: RG&JP5 (button) folded before Flop (didn't bet)
Seat 6: IceAngel82 (small blind) folded before Flop
Seat 7: GlobysBan (big blind) folded before Flop
Seat 8: 1tillit1 folded before Flop (didn't bet)


*********** # 73 **************
PokerStars Hand #169851073799:  Hold'em No Limit ($0.01/$0.02 USD) - 20=
17/05/02 23:26:17 CUST [2017/05/02 9:26:17 ET]
Table 'Botha' 9-max Seat #8 is the button
Seat 1: IceAngel82 ($3.94 in chips)=20
Seat 3: Sprut2013 ($2.34 in chips)=20
Seat 4: Leopoker888 ($2.12 in chips)=20
Seat 5: Tikinh00 ($2.10 in chips)=20
Seat 6: diment76 ($1.88 in chips)=20
Seat 7: the_wickstar ($2.56 in chips)=20
Seat 8: WebCamSasha ($2 in chips)=20
Seat 9: Demonidze31 ($2 in chips)=20
Demonidze31: posts small blind $0.01
IceAngel82: posts big blind $0.02
infiniti888: sits out=20
*** HOLE CARDS ***
Dealt to the_wickstar [6c Ac]
Sprut2013: calls $0.02
Leopoker888: folds=20
Tikinh00: folds=20
diment76: folds=20
the_wickstar: calls $0.02
WebCamSasha: folds=20
Demonidze31: calls $0.01
IceAngel82: checks=20
*** FLOP *** [8s 3c Kd]
Demonidze31: checks=20
IceAngel82: checks=20
Sprut2013: checks=20
the_wickstar: checks=20
*** TURN *** [8s 3c Kd] [3h]
Demonidze31: bets $0.06
IceAngel82: calls $0.06
Sprut2013: folds=20
the_wickstar: folds=20
*** RIVER *** [8s 3c Kd 3h] [7s]
Demonidze31: bets $0.11
IceAngel82: calls $0.11
*** SHOW DOWN ***
Demonidze31: shows [2s 3s] (three of a kind, Threes)
IceAngel82: mucks hand=20
Demonidze31 collected $0.41 from pot
*** SUMMARY ***
Total pot $0.42 | Rake $0.01=20
Board [8s 3c Kd 3h 7s]
Seat 1: IceAngel82 (big blind) mucked [Kh 9d]
Seat 3: Sprut2013 folded on the Turn
Seat 4: Leopoker888 folded before Flop (didn't bet)
Seat 5: Tikinh00 folded before Flop (didn't bet)
Seat 6: diment76 folded before Flop (didn't bet)
Seat 7: the_wickstar folded on the Turn
Seat 8: WebCamSasha (button) folded before Flop (didn't bet)
Seat 9: Demonidze31 (small blind) showed [2s 3s] and won ($0.41) with t=
hree of a kind, Threes


*********** # 74 **************
PokerStars Hand #169851054092:  Hold'em No Limit ($0.01/$0.02 USD) - 20=
17/05/02 23:25:39 CUST [2017/05/02 9:25:39 ET]
Table 'Botha' 9-max Seat #7 is the button
Seat 1: IceAngel82 ($3.94 in chips)=20
Seat 3: Sprut2013 ($2.34 in chips)=20
Seat 4: Leopoker888 ($2.05 in chips)=20
Seat 5: Tikinh00 ($2.10 in chips)=20
Seat 6: diment76 ($1.88 in chips)=20
Seat 7: the_wickstar ($2.56 in chips)=20
Seat 8: WebCamSasha ($2 in chips)=20
Seat 9: Demonidze31 ($2 in chips)=20
WebCamSasha: posts small blind $0.01
Demonidze31: posts big blind $0.02
infiniti888: sits out=20
*** HOLE CARDS ***
Dealt to the_wickstar [Js 7d]
IceAngel82: folds=20
Sprut2013: folds=20
Leopoker888: raises $0.04 to $0.06
Tikinh00: folds=20
diment76: folds=20
the_wickstar: folds=20
WebCamSasha: folds=20
Demonidze31: calls $0.04
*** FLOP *** [5d 6h 5c]
Demonidze31: checks=20
Leopoker888: bets $0.10
Demonidze31: folds=20
Uncalled bet ($0.10) returned to Leopoker888
Leopoker888 collected $0.13 from pot
Leopoker888: doesn't show hand=20
*** SUMMARY ***
Total pot $0.13 | Rake $0=20
Board [5d 6h 5c]
Seat 1: IceAngel82 folded before Flop (didn't bet)
Seat 3: Sprut2013 folded before Flop (didn't bet)
Seat 4: Leopoker888 collected ($0.13)
Seat 5: Tikinh00 folded before Flop (didn't bet)
Seat 6: diment76 folded before Flop (didn't bet)
Seat 7: the_wickstar (button) folded before Flop (didn't bet)
Seat 8: WebCamSasha (small blind) folded before Flop
Seat 9: Demonidze31 (big blind) folded on the Flop


*********** # 75 **************
PokerStars Hand #169851047042:  Hold'em No Limit ($0.01/$0.02 USD) - 20=
17/05/02 23:25:26 CUST [2017/05/02 9:25:26 ET]
Table 'Telephus' 9-max Seat #4 is the button
Seat 1: the_wickstar ($1.29 in chips)=20
Seat 2: pdilaccio ($0.83 in chips)=20
Seat 3: Humanfritz ($2 in chips)=20
Seat 4: TrueLargen ($2.80 in chips)=20
Seat 5: RG&JP5 ($0.89 in chips)=20
Seat 6: IceAngel82 ($2.24 in chips)=20
Seat 8: 1tillit1 ($2.59 in chips)=20
RG&JP5: posts small blind $0.01
IceAngel82: posts big blind $0.02
GlobysBan: sits out=20
iskarian: sits out=20
*** HOLE CARDS ***
Dealt to the_wickstar [Ks Td]
1tillit1: folds=20
the_wickstar: calls $0.02
pdilaccio: calls $0.02
Humanfritz: folds=20
TrueLargen: raises $0.08 to $0.10
RG&JP5: calls $0.09
IceAngel82: folds=20
the_wickstar: folds=20
pdilaccio: calls $0.08
*** FLOP *** [3s 4d 6s]
RG&JP5: checks=20
pdilaccio: checks=20
TrueLargen: bets $0.20
RG&JP5: raises $0.59 to $0.79 and is all-in
pdilaccio: folds=20
TrueLargen: calls $0.59
*** TURN *** [3s 4d 6s] [Ts]
*** RIVER *** [3s 4d 6s Ts] [Ac]
*** SHOW DOWN ***
RG&JP5: shows [4c 3c] (two pair, Fours and Threes)
TrueLargen: shows [8h Ah] (a pair of Aces)
RG&JP5 collected $1.85 from pot
*** SUMMARY ***
Total pot $1.92 | Rake $0.07=20
Board [3s 4d 6s Ts Ac]
Seat 1: the_wickstar folded before Flop
Seat 2: pdilaccio folded on the Flop
Seat 3: Humanfritz folded before Flop (didn't bet)
Seat 4: TrueLargen (button) showed [8h Ah] and lost with a pair of Aces
Seat 5: RG&JP5 (small blind) showed [4c 3c] and won ($1.85) with two pa=
ir, Fours and Threes
Seat 6: IceAngel82 (big blind) folded before Flop
Seat 8: 1tillit1 folded before Flop (didn't bet)


*********** # 76 **************
PokerStars Hand #169851015855:  Hold'em No Limit ($0.01/$0.02 USD) - 20=
17/05/02 23:24:26 CUST [2017/05/02 9:24:26 ET]
Table 'Botha' 9-max Seat #6 is the button
Seat 1: IceAngel82 ($3.94 in chips)=20
Seat 3: Sprut2013 ($2.51 in chips)=20
Seat 4: Leopoker888 ($2.05 in chips)=20
Seat 5: Tikinh00 ($2.12 in chips)=20
Seat 6: diment76 ($1.88 in chips)=20
Seat 7: the_wickstar ($2.36 in chips)=20
Seat 8: WebCamSasha ($2 in chips)=20
Seat 9: Demonidze31 ($2 in chips)=20
the_wickstar: posts small blind $0.01
WebCamSasha: posts big blind $0.02
infiniti888: sits out=20
*** HOLE CARDS ***
Dealt to the_wickstar [8h Kh]
Demonidze31: folds=20
IceAngel82: folds=20
Sprut2013: calls $0.02
Leopoker888: folds=20
Tikinh00: calls $0.02
diment76: folds=20
the_wickstar: calls $0.01
WebCamSasha: checks=20
*** FLOP *** [5c As Kc]
the_wickstar: checks=20
WebCamSasha: checks=20
Sprut2013: bets $0.02
Tikinh00: folds=20
the_wickstar: calls $0.02
WebCamSasha: folds=20
*** TURN *** [5c As Kc] [7d]
the_wickstar: checks=20
Sprut2013: bets $0.02
the_wickstar: calls $0.02
*** RIVER *** [5c As Kc 7d] [Kd]
the_wickstar: checks=20
Sprut2013: bets $0.11
the_wickstar: calls $0.11
*** SHOW DOWN ***
Sprut2013: shows [3s Ks] (three of a kind, Kings)
the_wickstar: shows [8h Kh] (three of a kind, Kings - Ace+Eight kicker)
the_wickstar collected $0.37 from pot
*** SUMMARY ***
Total pot $0.38 | Rake $0.01=20
Board [5c As Kc 7d Kd]
Seat 1: IceAngel82 folded before Flop (didn't bet)
Seat 3: Sprut2013 showed [3s Ks] and lost with three of a kind, Kings
Seat 4: Leopoker888 folded before Flop (didn't bet)
Seat 5: Tikinh00 folded on the Flop
Seat 6: diment76 (button) folded before Flop (didn't bet)
Seat 7: the_wickstar (small blind) showed [8h Kh] and won ($0.37) with =
three of a kind, Kings
Seat 8: WebCamSasha (big blind) folded on the Flop
Seat 9: Demonidze31 folded before Flop (didn't bet)


*********** # 77 **************
PokerStars Hand #169851014520:  Hold'em No Limit ($0.01/$0.02 USD) - 20=
17/05/02 23:24:24 CUST [2017/05/02 9:24:24 ET]
Table 'Telephus' 9-max Seat #3 is the button
Seat 1: the_wickstar ($1.29 in chips)=20
Seat 2: pdilaccio ($0.85 in chips)=20
Seat 3: Humanfritz ($2 in chips)=20
Seat 4: TrueLargen ($2.71 in chips)=20
Seat 5: RG&JP5 ($0.97 in chips)=20
Seat 6: IceAngel82 ($2.24 in chips)=20
Seat 8: 1tillit1 ($2.59 in chips)=20
TrueLargen: posts small blind $0.01
RG&JP5: posts big blind $0.02
GlobysBan: sits out=20
iskarian: sits out=20
*** HOLE CARDS ***
Dealt to the_wickstar [Qc 7h]
IceAngel82: folds=20
1tillit1: folds=20
the_wickstar: folds=20
pdilaccio: calls $0.02
Humanfritz: folds=20
TrueLargen: raises $0.06 to $0.08
RG&JP5: calls $0.06
pdilaccio: folds=20
*** FLOP *** [3s Ah Ks]
TrueLargen: bets $0.90
RG&JP5: folds=20
Uncalled bet ($0.90) returned to TrueLargen
TrueLargen collected $0.17 from pot
TrueLargen: doesn't show hand=20
*** SUMMARY ***
Total pot $0.18 | Rake $0.01=20
Board [3s Ah Ks]
Seat 1: the_wickstar folded before Flop (didn't bet)
Seat 2: pdilaccio folded before Flop
Seat 3: Humanfritz (button) folded before Flop (didn't bet)
Seat 4: TrueLargen (small blind) collected ($0.17)
Seat 5: RG&JP5 (big blind) folded on the Flop
Seat 6: IceAngel82 folded before Flop (didn't bet)
Seat 8: 1tillit1 folded before Flop (didn't bet)


*********** # 78 **************
PokerStars Hand #169850997555:  Hold'em No Limit ($0.01/$0.02 USD) - 20=
17/05/02 23:23:51 CUST [2017/05/02 9:23:51 ET]
Table 'Telephus' 9-max Seat #2 is the button
Seat 1: the_wickstar ($1.29 in chips)=20
Seat 2: pdilaccio ($0.85 in chips)=20
Seat 3: Humanfritz ($2 in chips)=20
Seat 4: TrueLargen ($2.70 in chips)=20
Seat 5: RG&JP5 ($0.97 in chips)=20
Seat 6: IceAngel82 ($2.24 in chips)=20
Seat 8: 1tillit1 ($2.59 in chips)=20
Humanfritz: posts small blind $0.01
TrueLargen: posts big blind $0.02
GlobysBan: sits out=20
iskarian: sits out=20
*** HOLE CARDS ***
Dealt to the_wickstar [3c 4h]
RG&JP5: folds=20
IceAngel82: folds=20
1tillit1: folds=20
the_wickstar: folds=20
pdilaccio: folds=20
Humanfritz: folds=20
Uncalled bet ($0.01) returned to TrueLargen
TrueLargen collected $0.02 from pot
TrueLargen: doesn't show hand=20
*** SUMMARY ***
Total pot $0.02 | Rake $0=20
Seat 1: the_wickstar folded before Flop (didn't bet)
Seat 2: pdilaccio (button) folded before Flop (didn't bet)
Seat 3: Humanfritz (small blind) folded before Flop
Seat 4: TrueLargen (big blind) collected ($0.02)
Seat 5: RG&JP5 folded before Flop (didn't bet)
Seat 6: IceAngel82 folded before Flop (didn't bet)
Seat 8: 1tillit1 folded before Flop (didn't bet)


*********** # 79 **************
PokerStars Hand #169850984672:  Hold'em No Limit ($0.01/$0.02 USD) - 20=
17/05/02 23:23:27 CUST [2017/05/02 9:23:27 ET]
Table 'Telephus' 9-max Seat #1 is the button
Seat 1: the_wickstar ($1.29 in chips)=20
Seat 2: pdilaccio ($0.86 in chips)=20
Seat 3: Humanfritz ($2 in chips)=20
Seat 4: TrueLargen ($2.67 in chips)=20
Seat 5: RG&JP5 ($0.97 in chips)=20
Seat 6: IceAngel82 ($2.24 in chips)=20
Seat 8: 1tillit1 ($2.59 in chips)=20
pdilaccio: posts small blind $0.01
Humanfritz: posts big blind $0.02
iskarian: sits out=20
*** HOLE CARDS ***
Dealt to the_wickstar [8h 9s]
GlobysBan joins the table at seat #7=20
TrueLargen: raises $0.04 to $0.06
RG&JP5: folds=20
IceAngel82: folds=20
1tillit1: folds=20
the_wickstar: folds=20
pdilaccio: folds=20
Humanfritz: folds=20
Uncalled bet ($0.04) returned to TrueLargen
TrueLargen collected $0.05 from pot
TrueLargen: doesn't show hand=20
*** SUMMARY ***
Total pot $0.05 | Rake $0=20
Seat 1: the_wickstar (button) folded before Flop (didn't bet)
Seat 2: pdilaccio (small blind) folded before Flop
Seat 3: Humanfritz (big blind) folded before Flop
Seat 4: TrueLargen collected ($0.05)
Seat 5: RG&JP5 folded before Flop (didn't bet)
Seat 6: IceAngel82 folded before Flop (didn't bet)
Seat 8: 1tillit1 folded before Flop (didn't bet)


*********** # 80 **************
PokerStars Hand #169850980585:  Hold'em No Limit ($0.01/$0.02 USD) - 20=
17/05/02 23:23:19 CUST [2017/05/02 9:23:19 ET]
Table 'Botha' 9-max Seat #5 is the button
Seat 1: IceAngel82 ($3.94 in chips)=20
Seat 3: Sprut2013 ($2.51 in chips)=20
Seat 4: Leopoker888 ($2.05 in chips)=20
Seat 5: Tikinh00 ($2.16 in chips)=20
Seat 6: diment76 ($1.89 in chips)=20
Seat 7: the_wickstar ($2.07 in chips)=20
Seat 9: Demonidze31 ($2 in chips)=20
diment76: posts small blind $0.01
yri1961 joins the table at seat #2=20
the_wickstar: posts big blind $0.02
WebCamSasha: sits out=20
*** HOLE CARDS ***
Dealt to the_wickstar [Ac Ad]
yri1961 leaves the table
Demonidze31: raises $0.02 to $0.04
IceAngel82: folds=20
Sprut2013: folds=20
Leopoker888: folds=20
infiniti888 joins the table at seat #2=20
Tikinh00: calls $0.04
diment76: folds=20
the_wickstar: raises $0.08 to $0.12
Demonidze31: calls $0.08
Tikinh00: folds=20
*** FLOP *** [6c 8s Jh]
the_wickstar: bets $0.14
Demonidze31: calls $0.14
*** TURN *** [6c 8s Jh] [3h]
the_wickstar: bets $0.55
Demonidze31: folds=20
Uncalled bet ($0.55) returned to the_wickstar
the_wickstar collected $0.55 from pot
*** SUMMARY ***
Total pot $0.57 | Rake $0.02=20
Board [6c 8s Jh 3h]
Seat 1: IceAngel82 folded before Flop (didn't bet)
Seat 3: Sprut2013 folded before Flop (didn't bet)
Seat 4: Leopoker888 folded before Flop (didn't bet)
Seat 5: Tikinh00 (button) folded before Flop
Seat 6: diment76 (small blind) folded before Flop
Seat 7: the_wickstar (big blind) collected ($0.55)
Seat 9: Demonidze31 folded on the Turn


*********** # 81 **************
PokerStars Hand #169850977590:  Hold'em No Limit ($0.01/$0.02 USD) - 20=
17/05/02 23:23:13 CUST [2017/05/02 9:23:13 ET]
Table 'Telephus' 9-max Seat #8 is the button
Seat 1: the_wickstar ($1.30 in chips)=20
Seat 2: pdilaccio ($0.85 in chips)=20
Seat 3: Humanfritz ($2 in chips)=20
Seat 4: TrueLargen ($2.67 in chips)=20
Seat 5: RG&JP5 ($0.97 in chips)=20
Seat 6: IceAngel82 ($2.24 in chips)=20
Seat 8: 1tillit1 ($2.59 in chips)=20
iskarian will be allowed to play after the button
the_wickstar: posts small blind $0.01
pdilaccio: posts big blind $0.02
*** HOLE CARDS ***
Dealt to the_wickstar [5c 2h]
Humanfritz: folds=20
TrueLargen: folds=20
RG&JP5: folds=20
IceAngel82: folds=20
1tillit1: folds=20
the_wickstar: folds=20
Uncalled bet ($0.01) returned to pdilaccio
pdilaccio collected $0.02 from pot
*** SUMMARY ***
Total pot $0.02 | Rake $0=20
Seat 1: the_wickstar (small blind) folded before Flop
Seat 2: pdilaccio (big blind) collected ($0.02)
Seat 3: Humanfritz folded before Flop (didn't bet)
Seat 4: TrueLargen folded before Flop (didn't bet)
Seat 5: RG&JP5 folded before Flop (didn't bet)
Seat 6: IceAngel82 folded before Flop (didn't bet)
Seat 8: 1tillit1 (button) folded before Flop (didn't bet)


*********** # 82 **************
PokerStars Hand #169850963490:  Hold'em No Limit ($0.01/$0.02 USD) - 20=
17/05/02 23:22:46 CUST [2017/05/02 9:22:46 ET]
Table 'Telephus' 9-max Seat #6 is the button
Seat 1: the_wickstar ($1.30 in chips)=20
Seat 2: pdilaccio ($0.87 in chips)=20
Seat 3: Humanfritz ($2 in chips)=20
Seat 4: TrueLargen ($2.67 in chips)=20
Seat 5: RG&JP5 ($0.97 in chips)=20
Seat 6: IceAngel82 ($2.19 in chips)=20
Seat 7: mimi93731 ($1.56 in chips)=20
Seat 8: 1tillit1 ($2.61 in chips)=20
mimi93731: posts small blind $0.01
1tillit1: posts big blind $0.02
iskarian: sits out=20
*** HOLE CARDS ***
Dealt to the_wickstar [6d Jh]
the_wickstar: folds=20
pdilaccio: calls $0.02
Humanfritz: folds=20
TrueLargen: folds=20
RG&JP5: folds=20
IceAngel82: raises $0.06 to $0.08
mimi93731: folds=20
1tillit1: folds=20
pdilaccio: folds=20
Uncalled bet ($0.06) returned to IceAngel82
mimi93731 leaves the table
IceAngel82 collected $0.07 from pot
IceAngel82: doesn't show hand=20
*** SUMMARY ***
Total pot $0.07 | Rake $0=20
Seat 1: the_wickstar folded before Flop (didn't bet)
Seat 2: pdilaccio folded before Flop
Seat 3: Humanfritz folded before Flop (didn't bet)
Seat 4: TrueLargen folded before Flop (didn't bet)
Seat 5: RG&JP5 folded before Flop (didn't bet)
Seat 6: IceAngel82 (button) collected ($0.07)
Seat 7: mimi93731 (small blind) folded before Flop
Seat 8: 1tillit1 (big blind) folded before Flop


*********** # 83 **************
PokerStars Hand #169850960912:  Hold'em No Limit ($0.01/$0.02 USD) - 20=
17/05/02 23:22:41 CUST [2017/05/02 9:22:41 ET]
Table 'Botha' 9-max Seat #4 is the button
Seat 1: IceAngel82 ($3.94 in chips)=20
Seat 2: PAMEGERA ($2.65 in chips)=20
Seat 3: Sprut2013 ($2.51 in chips)=20
Seat 4: Leopoker888 ($2 in chips)=20
Seat 5: Tikinh00 ($2.17 in chips)=20
Seat 6: diment76 ($1.91 in chips)=20
Seat 7: the_wickstar ($2.09 in chips)=20
Seat 9: Demonidze31 ($2 in chips)=20
Tikinh00: posts small blind $0.01
diment76: posts big blind $0.02
WebCamSasha: sits out=20
*** HOLE CARDS ***
Dealt to the_wickstar [5s 5d]
the_wickstar: calls $0.02
Demonidze31: folds=20
IceAngel82: folds=20
PAMEGERA: folds=20
PAMEGERA leaves the table
Sprut2013: folds=20
Leopoker888: raises $0.06 to $0.08
Tikinh00: folds=20
diment76: folds=20
the_wickstar: folds=20
Uncalled bet ($0.06) returned to Leopoker888
Leopoker888 collected $0.07 from pot
Leopoker888: doesn't show hand=20
*** SUMMARY ***
Total pot $0.07 | Rake $0=20
Seat 1: IceAngel82 folded before Flop (didn't bet)
Seat 2: PAMEGERA folded before Flop (didn't bet)
Seat 3: Sprut2013 folded before Flop (didn't bet)
Seat 4: Leopoker888 (button) collected ($0.07)
Seat 5: Tikinh00 (small blind) folded before Flop
Seat 6: diment76 (big blind) folded before Flop
Seat 7: the_wickstar folded before Flop
Seat 9: Demonidze31 folded before Flop (didn't bet)


*********** # 84 **************
PokerStars Hand #169850938548:  Hold'em No Limit ($0.01/$0.02 USD) - 20=
17/05/02 23:21:59 CUST [2017/05/02 9:21:59 ET]
Table 'Botha' 9-max Seat #3 is the button
Seat 1: IceAngel82 ($3.94 in chips)=20
Seat 2: PAMEGERA ($2.62 in chips)=20
Seat 3: Sprut2013 ($2.51 in chips)=20
Seat 4: Leopoker888 ($2 in chips)=20
Seat 5: Tikinh00 ($2.19 in chips)=20
Seat 6: diment76 ($1.91 in chips)=20
Seat 7: the_wickstar ($2.09 in chips)=20
Seat 9: Demonidze31 ($2 in chips)=20
Leopoker888: posts small blind $0.01
Tikinh00: posts big blind $0.02
*** HOLE CARDS ***
Dealt to the_wickstar [3c 2h]
diment76: folds=20
Dooley121 leaves the table
the_wickstar: folds=20
Demonidze31: folds=20
IceAngel82: folds=20
WebCamSasha joins the table at seat #8=20
PAMEGERA: raises $0.04 to $0.06
Sprut2013: folds=20
Leopoker888: folds=20
Tikinh00: folds=20
Uncalled bet ($0.04) returned to PAMEGERA
PAMEGERA collected $0.05 from pot
PAMEGERA: doesn't show hand=20
*** SUMMARY ***
Total pot $0.05 | Rake $0=20
Seat 1: IceAngel82 folded before Flop (didn't bet)
Seat 2: PAMEGERA collected ($0.05)
Seat 3: Sprut2013 (button) folded before Flop (didn't bet)
Seat 4: Leopoker888 (small blind) folded before Flop
Seat 5: Tikinh00 (big blind) folded before Flop
Seat 6: diment76 folded before Flop (didn't bet)
Seat 7: the_wickstar folded before Flop (didn't bet)
Seat 9: Demonidze31 folded before Flop (didn't bet)


*********** # 85 **************
PokerStars Hand #169850927588:  Hold'em No Limit ($0.01/$0.02 USD) - 20=
17/05/02 23:21:38 CUST [2017/05/02 9:21:38 ET]
Table 'Telephus' 9-max Seat #5 is the button
Seat 1: the_wickstar ($1.30 in chips)=20
Seat 2: pdilaccio ($0.83 in chips)=20
Seat 3: Humanfritz ($2 in chips)=20
Seat 4: TrueLargen ($2.67 in chips)=20
Seat 5: RG&JP5 ($0.97 in chips)=20
Seat 6: IceAngel82 ($2.21 in chips)=20
Seat 7: mimi93731 ($1.58 in chips)=20
Seat 8: 1tillit1 ($2.61 in chips)=20
IceAngel82: posts small blind $0.01
mimi93731: posts big blind $0.02
iskarian: sits out=20
*** HOLE CARDS ***
Dealt to the_wickstar [8c Kh]
1tillit1: folds=20
the_wickstar: folds=20
pdilaccio: calls $0.02
Humanfritz: folds=20
TrueLargen: folds=20
RG&JP5: folds=20
IceAngel82: calls $0.01
mimi93731: checks=20
*** FLOP *** [Qd Ad 7c]
IceAngel82: checks=20
mimi93731: checks=20
pdilaccio: checks=20
*** TURN *** [Qd Ad 7c] [5h]
IceAngel82: checks=20
mimi93731: checks=20
pdilaccio: checks=20
*** RIVER *** [Qd Ad 7c 5h] [Jc]
IceAngel82: checks=20
mimi93731: checks=20
pdilaccio: checks=20
*** SHOW DOWN ***
IceAngel82: shows [4d 5c] (a pair of Fives)
mimi93731: mucks hand=20
pdilaccio: shows [Ah 3c] (a pair of Aces)
pdilaccio collected $0.06 from pot
*** SUMMARY ***
Total pot $0.06 | Rake $0=20
Board [Qd Ad 7c 5h Jc]
Seat 1: the_wickstar folded before Flop (didn't bet)
Seat 2: pdilaccio showed [Ah 3c] and won ($0.06) with a pair of Aces
Seat 3: Humanfritz folded before Flop (didn't bet)
Seat 4: TrueLargen folded before Flop (didn't bet)
Seat 5: RG&JP5 (button) folded before Flop (didn't bet)
Seat 6: IceAngel82 (small blind) showed [4d 5c] and lost with a pair of=
 Fives
Seat 7: mimi93731 (big blind) mucked [2h Ts]
Seat 8: 1tillit1 folded before Flop (didn't bet)


*********** # 86 **************
PokerStars Hand #169850917289:  Hold'em No Limit ($0.01/$0.02 USD) - 20=
17/05/02 23:21:18 CUST [2017/05/02 9:21:18 ET]
Table 'Telephus' 9-max Seat #4 is the button
Seat 1: the_wickstar ($1.30 in chips)=20
Seat 2: pdilaccio ($0.83 in chips)=20
Seat 3: Humanfritz ($2 in chips)=20
Seat 4: TrueLargen ($2.67 in chips)=20
Seat 5: RG&JP5 ($0.98 in chips)=20
Seat 6: IceAngel82 ($2.20 in chips)=20
Seat 7: mimi93731 ($1.58 in chips)=20
Seat 8: 1tillit1 ($2.61 in chips)=20
RG&JP5: posts small blind $0.01
IceAngel82: posts big blind $0.02
iskarian: sits out=20
*** HOLE CARDS ***
Dealt to the_wickstar [Td 9c]
mimi93731: folds=20
1tillit1: folds=20
the_wickstar: folds=20
pdilaccio: folds=20
Humanfritz: folds=20
TrueLargen: folds=20
RG&JP5: folds=20
Uncalled bet ($0.01) returned to IceAngel82
IceAngel82 collected $0.02 from pot
IceAngel82: doesn't show hand=20
*** SUMMARY ***
Total pot $0.02 | Rake $0=20
Seat 1: the_wickstar folded before Flop (didn't bet)
Seat 2: pdilaccio folded before Flop (didn't bet)
Seat 3: Humanfritz folded before Flop (didn't bet)
Seat 4: TrueLargen (button) folded before Flop (didn't bet)
Seat 5: RG&JP5 (small blind) folded before Flop
Seat 6: IceAngel82 (big blind) collected ($0.02)
Seat 7: mimi93731 folded before Flop (didn't bet)
Seat 8: 1tillit1 folded before Flop (didn't bet)


*********** # 87 **************
PokerStars Hand #169850897175:  Hold'em No Limit ($0.01/$0.02 USD) - 20=
17/05/02 23:20:40 CUST [2017/05/02 9:20:40 ET]
Table 'Botha' 9-max Seat #2 is the button
Seat 1: IceAngel82 ($2.32 in chips)=20
Seat 2: PAMEGERA ($2.62 in chips)=20
Seat 3: Sprut2013 ($2.52 in chips)=20
Seat 4: Leopoker888 ($2.02 in chips)=20
Seat 5: Tikinh00 ($2.19 in chips)=20
Seat 6: diment76 ($1.91 in chips)=20
Seat 7: the_wickstar ($2.11 in chips)=20
Seat 8: Dooley121 ($1.55 in chips)=20
Seat 9: Demonidze31 ($2 in chips)=20
Sprut2013: posts small blind $0.01
Leopoker888: posts big blind $0.02
*** HOLE CARDS ***
Dealt to the_wickstar [Qd Tc]
Tikinh00: folds=20
diment76: folds=20
the_wickstar: calls $0.02
Dooley121: calls $0.02
Demonidze31: raises $0.02 to $0.04
IceAngel82: raises $0.10 to $0.14
PAMEGERA: folds=20
Sprut2013: folds=20
Leopoker888: folds=20
the_wickstar: folds=20
Dooley121: calls $0.12
Demonidze31: calls $0.10
*** FLOP *** [7c 5s 5c]
Dooley121: checks=20
Demonidze31: checks=20
IceAngel82: bets $0.34
Dooley121: calls $0.34
Demonidze31: folds=20
*** TURN *** [7c 5s 5c] [2d]
Dooley121: bets $1.07 and is all-in
IceAngel82: calls $1.07
*** RIVER *** [7c 5s 5c 2d] [3h]
*** SHOW DOWN ***
Dooley121: shows [8c 8s] (two pair, Eights and Fives)
IceAngel82: shows [Qh Qc] (two pair, Queens and Fives)
IceAngel82 collected $3.17 from pot
*** SUMMARY ***
Total pot $3.29 | Rake $0.12=20
Board [7c 5s 5c 2d 3h]
Seat 1: IceAngel82 showed [Qh Qc] and won ($3.17) with two pair, Queens=
 and Fives
Seat 2: PAMEGERA (button) folded before Flop (didn't bet)
Seat 3: Sprut2013 (small blind) folded before Flop
Seat 4: Leopoker888 (big blind) folded before Flop
Seat 5: Tikinh00 folded before Flop (didn't bet)
Seat 6: diment76 folded before Flop (didn't bet)
Seat 7: the_wickstar folded before Flop
Seat 8: Dooley121 showed [8c 8s] and lost with two pair, Eights and Fiv=
es
Seat 9: Demonidze31 folded on the Flop


*********** # 88 **************
PokerStars Hand #169850896548:  Hold'em No Limit ($0.01/$0.02 USD) - 20=
17/05/02 23:20:39 CUST [2017/05/02 9:20:39 ET]
Table 'Telephus' 9-max Seat #3 is the button
Seat 1: the_wickstar ($1.30 in chips)=20
Seat 2: pdilaccio ($0.83 in chips)=20
Seat 3: Humanfritz ($2 in chips)=20
Seat 4: TrueLargen ($3.18 in chips)=20
Seat 5: RG&JP5 ($0.51 in chips)=20
Seat 6: IceAngel82 ($2.20 in chips)=20
Seat 7: mimi93731 ($1.58 in chips)=20
Seat 8: 1tillit1 ($2.61 in chips)=20
TrueLargen: posts small blind $0.01
RG&JP5: posts big blind $0.02
iskarian: sits out=20
*** HOLE CARDS ***
Dealt to the_wickstar [3c Jd]
IceAngel82: folds=20
mimi93731: folds=20
1tillit1: folds=20
the_wickstar: folds=20
pdilaccio: folds=20
Humanfritz: folds=20
TrueLargen: raises $0.04 to $0.06
RG&JP5: calls $0.04
*** FLOP *** [3s Ac 7h]
TrueLargen: bets $0.46
RG&JP5: calls $0.45 and is all-in
Uncalled bet ($0.01) returned to TrueLargen
*** TURN *** [3s Ac 7h] [7d]
*** RIVER *** [3s Ac 7h 7d] [Ad]
*** SHOW DOWN ***
TrueLargen: shows [9h 9c] (two pair, Aces and Nines)
RG&JP5: shows [Qc 7c] (a full house, Sevens full of Aces)
RG&JP5 collected $0.98 from pot
*** SUMMARY ***
Total pot $1.02 | Rake $0.04=20
Board [3s Ac 7h 7d Ad]
Seat 1: the_wickstar folded before Flop (didn't bet)
Seat 2: pdilaccio folded before Flop (didn't bet)
Seat 3: Humanfritz (button) folded before Flop (didn't bet)
Seat 4: TrueLargen (small blind) showed [9h 9c] and lost with two pair,=
 Aces and Nines
Seat 5: RG&JP5 (big blind) showed [Qc 7c] and won ($0.98) with a full h=
ouse, Sevens full of Aces
Seat 6: IceAngel82 folded before Flop (didn't bet)
Seat 7: mimi93731 folded before Flop (didn't bet)
Seat 8: 1tillit1 folded before Flop (didn't bet)


*********** # 89 **************
PokerStars Hand #169850884332:  Hold'em No Limit ($0.01/$0.02 USD) - 20=
17/05/02 23:20:16 CUST [2017/05/02 9:20:16 ET]
Table 'Telephus' 9-max Seat #2 is the button
Seat 1: the_wickstar ($1.30 in chips)=20
Seat 2: pdilaccio ($0.83 in chips)=20
Seat 3: Humanfritz ($2 in chips)=20
Seat 4: TrueLargen ($3.20 in chips)=20
Seat 5: RG&JP5 ($0.51 in chips)=20
Seat 6: IceAngel82 ($2.17 in chips)=20
Seat 7: mimi93731 ($1.58 in chips)=20
Seat 8: 1tillit1 ($2.61 in chips)=20
Humanfritz: posts small blind $0.01
TrueLargen: posts big blind $0.02
iskarian: sits out=20
*** HOLE CARDS ***
Dealt to the_wickstar [6c 2d]
RG&JP5: folds=20
IceAngel82: raises $0.04 to $0.06
mimi93731: folds=20
1tillit1: folds=20
the_wickstar: folds=20
pdilaccio: folds=20
Humanfritz: folds=20
TrueLargen: folds=20
Uncalled bet ($0.04) returned to IceAngel82
IceAngel82 collected $0.05 from pot
IceAngel82: doesn't show hand=20
*** SUMMARY ***
Total pot $0.05 | Rake $0=20
Seat 1: the_wickstar folded before Flop (didn't bet)
Seat 2: pdilaccio (button) folded before Flop (didn't bet)
Seat 3: Humanfritz (small blind) folded before Flop
Seat 4: TrueLargen (big blind) folded before Flop
Seat 5: RG&JP5 folded before Flop (didn't bet)
Seat 6: IceAngel82 collected ($0.05)
Seat 7: mimi93731 folded before Flop (didn't bet)
Seat 8: 1tillit1 folded before Flop (didn't bet)


*********** # 90 **************
PokerStars Hand #169850873484:  Hold'em No Limit ($0.01/$0.02 USD) - 20=
17/05/02 23:19:55 CUST [2017/05/02 9:19:55 ET]
Table 'Botha' 9-max Seat #1 is the button
Seat 1: IceAngel82 ($2.32 in chips)=20
Seat 2: PAMEGERA ($2.63 in chips)=20
Seat 3: Sprut2013 ($2.58 in chips)=20
Seat 4: Leopoker888 ($2.02 in chips)=20
Seat 5: Tikinh00 ($2.19 in chips)=20
Seat 6: diment76 ($1.91 in chips)=20
Seat 7: the_wickstar ($2.11 in chips)=20
Seat 8: Dooley121 ($1.48 in chips)=20
Seat 9: Demonidze31 ($2 in chips)=20
PAMEGERA: posts small blind $0.01
Sprut2013: posts big blind $0.02
*** HOLE CARDS ***
Dealt to the_wickstar [3s 2h]
Leopoker888: folds=20
Tikinh00: folds=20
diment76: folds=20
the_wickstar: folds=20
Dooley121: calls $0.02
Demonidze31: folds=20
IceAngel82: folds=20
PAMEGERA: folds=20
Sprut2013: checks=20
*** FLOP *** [As 9s 7s]
Sprut2013: bets $0.02
Dooley121: calls $0.02
*** TURN *** [As 9s 7s] [Kh]
Sprut2013: bets $0.02
Dooley121: raises $0.13 to $0.15
Sprut2013: folds=20
Uncalled bet ($0.13) returned to Dooley121
Dooley121 collected $0.13 from pot
*** SUMMARY ***
Total pot $0.13 | Rake $0=20
Board [As 9s 7s Kh]
Seat 1: IceAngel82 (button) folded before Flop (didn't bet)
Seat 2: PAMEGERA (small blind) folded before Flop
Seat 3: Sprut2013 (big blind) folded on the Turn
Seat 4: Leopoker888 folded before Flop (didn't bet)
Seat 5: Tikinh00 folded before Flop (didn't bet)
Seat 6: diment76 folded before Flop (didn't bet)
Seat 7: the_wickstar folded before Flop (didn't bet)
Seat 8: Dooley121 collected ($0.13)
Seat 9: Demonidze31 folded before Flop (didn't bet)


*********** # 91 **************
PokerStars Hand #169850868119:  Hold'em No Limit ($0.01/$0.02 USD) - 20=
17/05/02 23:19:45 CUST [2017/05/02 9:19:45 ET]
Table 'Telephus' 9-max Seat #1 is the button
Seat 1: the_wickstar ($1.30 in chips)=20
Seat 2: pdilaccio ($0.84 in chips)=20
Seat 3: Humanfritz ($2 in chips)=20
Seat 4: TrueLargen ($3.20 in chips)=20
Seat 5: RG&JP5 ($0.51 in chips)=20
Seat 6: IceAngel82 ($2.17 in chips)=20
Seat 7: mimi93731 ($1.55 in chips)=20
Seat 8: 1tillit1 ($2.61 in chips)=20
pdilaccio: posts small blind $0.01
Humanfritz: posts big blind $0.02
iskarian: sits out=20
*** HOLE CARDS ***
Dealt to the_wickstar [6s Qc]
TrueLargen: folds=20
RG&JP5: folds=20
IceAngel82: folds=20
mimi93731: raises $0.06 to $0.08
1tillit1: folds=20
the_wickstar: folds=20
pdilaccio: folds=20
Humanfritz: folds=20
Uncalled bet ($0.06) returned to mimi93731
mimi93731 collected $0.05 from pot
*** SUMMARY ***
Total pot $0.05 | Rake $0=20
Seat 1: the_wickstar (button) folded before Flop (didn't bet)
Seat 2: pdilaccio (small blind) folded before Flop
Seat 3: Humanfritz (big blind) folded before Flop
Seat 4: TrueLargen folded before Flop (didn't bet)
Seat 5: RG&JP5 folded before Flop (didn't bet)
Seat 6: IceAngel82 folded before Flop (didn't bet)
Seat 7: mimi93731 collected ($0.05)
Seat 8: 1tillit1 folded before Flop (didn't bet)


*********** # 92 **************
PokerStars Hand #169850857301:  Hold'em No Limit ($0.01/$0.02 USD) - 20=
17/05/02 23:19:24 CUST [2017/05/02 9:19:24 ET]
Table 'Telephus' 9-max Seat #8 is the button
Seat 1: the_wickstar ($1.31 in chips)=20
Seat 2: pdilaccio ($0.86 in chips)=20
Seat 4: TrueLargen ($3.20 in chips)=20
Seat 5: RG&JP5 ($0.51 in chips)=20
Seat 6: IceAngel82 ($2.17 in chips)=20
Seat 7: mimi93731 ($1.55 in chips)=20
Seat 8: 1tillit1 ($2.58 in chips)=20
iskarian will be allowed to play after the button
the_wickstar: posts small blind $0.01
pdilaccio: posts big blind $0.02
Humanfritz: sits out=20
*** HOLE CARDS ***
Dealt to the_wickstar [8d Ts]
TrueLargen: folds=20
RG&JP5: folds=20
IceAngel82: folds=20
mimi93731: folds=20
1tillit1: raises $0.03 to $0.05
the_wickstar: folds=20
pdilaccio: folds=20
Uncalled bet ($0.03) returned to 1tillit1
1tillit1 collected $0.05 from pot
1tillit1: doesn't show hand=20
*** SUMMARY ***
Total pot $0.05 | Rake $0=20
Seat 1: the_wickstar (small blind) folded before Flop
Seat 2: pdilaccio (big blind) folded before Flop
Seat 4: TrueLargen folded before Flop (didn't bet)
Seat 5: RG&JP5 folded before Flop (didn't bet)
Seat 6: IceAngel82 folded before Flop (didn't bet)
Seat 7: mimi93731 folded before Flop (didn't bet)
Seat 8: 1tillit1 (button) collected ($0.05)


*********** # 93 **************
PokerStars Hand #169850830977:  Hold'em No Limit ($0.01/$0.02 USD) - 20=
17/05/02 23:18:35 CUST [2017/05/02 9:18:35 ET]
Table 'Botha' 9-max Seat #9 is the button
Seat 1: IceAngel82 ($2.33 in chips)=20
Seat 2: PAMEGERA ($2.65 in chips)=20
Seat 3: Sprut2013 ($2.58 in chips)=20
Seat 4: Leopoker888 ($2.02 in chips)=20
Seat 5: Tikinh00 ($2.05 in chips)=20
Seat 6: diment76 ($1.91 in chips)=20
Seat 7: the_wickstar ($2.19 in chips)=20
Seat 8: Dooley121 ($1.50 in chips)=20
Seat 9: Demonidze31 ($2 in chips)=20
IceAngel82: posts small blind $0.01
PAMEGERA: posts big blind $0.02
*** HOLE CARDS ***
Dealt to the_wickstar [9c Ac]
Sprut2013: folds=20
Leopoker888: folds=20
Tikinh00: calls $0.02
diment76: folds=20
the_wickstar: calls $0.02
Dooley121: calls $0.02
Demonidze31: calls $0.02
IceAngel82: folds=20
PAMEGERA: checks=20
*** FLOP *** [4c 5d 7s]
PAMEGERA: checks=20
Tikinh00: checks=20
the_wickstar: checks=20
Dooley121: checks=20
Demonidze31: checks=20
*** TURN *** [4c 5d 7s] [8c]
PAMEGERA: checks=20
Tikinh00: checks=20
the_wickstar: checks=20
Dooley121: checks=20
Demonidze31: checks=20
*** RIVER *** [4c 5d 7s 8c] [5s]
PAMEGERA: checks=20
Tikinh00: checks=20
the_wickstar: bets $0.06
Dooley121: folds=20
Demonidze31: folds=20
PAMEGERA: folds=20
Tikinh00: calls $0.06
*** SHOW DOWN ***
the_wickstar: shows [9c Ac] (a pair of Fives)
Tikinh00: shows [Ah 4h] (two pair, Fives and Fours)
Tikinh00 collected $0.22 from pot
*** SUMMARY ***
Total pot $0.23 | Rake $0.01=20
Board [4c 5d 7s 8c 5s]
Seat 1: IceAngel82 (small blind) folded before Flop
Seat 2: PAMEGERA (big blind) folded on the River
Seat 3: Sprut2013 folded before Flop (didn't bet)
Seat 4: Leopoker888 folded before Flop (didn't bet)
Seat 5: Tikinh00 showed [Ah 4h] and won ($0.22) with two pair, Fives an=
d Fours
Seat 6: diment76 folded before Flop (didn't bet)
Seat 7: the_wickstar showed [9c Ac] and lost with a pair of Fives
Seat 8: Dooley121 folded on the River
Seat 9: Demonidze31 (button) folded on the River


*********** # 94 **************
PokerStars Hand #169850830750:  Hold'em No Limit ($0.01/$0.02 USD) - 20=
17/05/02 23:18:34 CUST [2017/05/02 9:18:34 ET]
Table 'Telephus' 9-max Seat #7 is the button
Seat 1: the_wickstar ($1.33 in chips)=20
Seat 2: pdilaccio ($0.86 in chips)=20
Seat 4: TrueLargen ($3.20 in chips)=20
Seat 5: RG&JP5 ($0.43 in chips)=20
Seat 6: IceAngel82 ($2.17 in chips)=20
Seat 7: mimi93731 ($1.61 in chips)=20
Seat 8: 1tillit1 ($2.59 in chips)=20
1tillit1: posts small blind $0.01
smilie0123: is sitting out=20
smilie0123 leaves the table
the_wickstar: posts big blind $0.02
Humanfritz: sits out=20
*** HOLE CARDS ***
Dealt to the_wickstar [8h 5h]
iskarian joins the table at seat #9=20
pdilaccio has timed out
pdilaccio: folds=20
TrueLargen: folds=20
RG&JP5: raises $0.04 to $0.06
IceAngel82: folds=20
mimi93731: calls $0.06
1tillit1: folds=20
the_wickstar: folds=20
*** FLOP *** [Kc 5s 3h]
RG&JP5: bets $0.06
mimi93731: folds=20
Uncalled bet ($0.06) returned to RG&JP5
RG&JP5 collected $0.14 from pot
RG&JP5: doesn't show hand=20
*** SUMMARY ***
Total pot $0.15 | Rake $0.01=20
Board [Kc 5s 3h]
Seat 1: the_wickstar (big blind) folded before Flop
Seat 2: pdilaccio folded before Flop (didn't bet)
Seat 4: TrueLargen folded before Flop (didn't bet)
Seat 5: RG&JP5 collected ($0.14)
Seat 6: IceAngel82 folded before Flop (didn't bet)
Seat 7: mimi93731 (button) folded on the Flop
Seat 8: 1tillit1 (small blind) folded before Flop


*********** # 95 **************
PokerStars Hand #169850820529:  Hold'em No Limit ($0.01/$0.02 USD) - 20=
17/05/02 23:18:15 CUST [2017/05/02 9:18:15 ET]
Table 'Telephus' 9-max Seat #6 is the button
Seat 1: the_wickstar ($1.33 in chips)=20
Seat 2: pdilaccio ($0.86 in chips)=20
Seat 4: TrueLargen ($3.20 in chips)=20
Seat 5: RG&JP5 ($0.43 in chips)=20
Seat 6: IceAngel82 ($2.17 in chips)=20
Seat 7: mimi93731 ($1.62 in chips)=20
Seat 8: 1tillit1 ($2.58 in chips)=20
Seat 9: smilie0123 ($2.11 in chips)=20
mimi93731: posts small blind $0.01
1tillit1: posts big blind $0.02
Humanfritz: sits out=20
*** HOLE CARDS ***
Dealt to the_wickstar [7h 8s]
smilie0123: folds=20
the_wickstar: folds=20
pdilaccio: folds=20
TrueLargen: folds=20
RG&JP5: folds=20
IceAngel82: folds=20
mimi93731: folds=20
Uncalled bet ($0.01) returned to 1tillit1
1tillit1 collected $0.02 from pot
1tillit1: doesn't show hand=20
*** SUMMARY ***
Total pot $0.02 | Rake $0=20
Seat 1: the_wickstar folded before Flop (didn't bet)
Seat 2: pdilaccio folded before Flop (didn't bet)
Seat 4: TrueLargen folded before Flop (didn't bet)
Seat 5: RG&JP5 folded before Flop (didn't bet)
Seat 6: IceAngel82 (button) folded before Flop (didn't bet)
Seat 7: mimi93731 (small blind) folded before Flop
Seat 8: 1tillit1 (big blind) collected ($0.02)
Seat 9: smilie0123 folded before Flop (didn't bet)


*********** # 96 **************
PokerStars Hand #169850796166:  Hold'em No Limit ($0.01/$0.02 USD) - 20=
17/05/02 23:17:29 CUST [2017/05/02 9:17:29 ET]
Table 'Telephus' 9-max Seat #5 is the button
Seat 1: the_wickstar ($1.33 in chips)=20
Seat 2: pdilaccio ($1 in chips)=20
Seat 4: TrueLargen ($3.20 in chips)=20
Seat 5: RG&JP5 ($0.43 in chips)=20
Seat 6: IceAngel82 ($2.18 in chips)=20
Seat 7: mimi93731 ($1.48 in chips)=20
Seat 8: 1tillit1 ($2.58 in chips)=20
Seat 9: smilie0123 ($2.11 in chips)=20
IceAngel82: posts small blind $0.01
mimi93731: posts big blind $0.02
pdilaccio: posts big blind $0.02
Humanfritz: sits out=20
*** HOLE CARDS ***
Dealt to the_wickstar [5h 3s]
1tillit1: folds=20
smilie0123: folds=20
the_wickstar: folds=20
pdilaccio: checks=20
TrueLargen: folds=20
RG&JP5: folds=20
IceAngel82: folds=20
mimi93731: checks=20
*** FLOP *** [Ks 2d 9c]
mimi93731: bets $0.04
pdilaccio: calls $0.04
*** TURN *** [Ks 2d 9c] [3h]
mimi93731: bets $0.04
pdilaccio: calls $0.04
*** RIVER *** [Ks 2d 9c 3h] [3d]
mimi93731: bets $0.04
pdilaccio: calls $0.04
*** SHOW DOWN ***
mimi93731: shows [7h Kc] (two pair, Kings and Threes)
pdilaccio: mucks hand=20
mimi93731 collected $0.28 from pot
*** SUMMARY ***
Total pot $0.29 | Rake $0.01=20
Board [Ks 2d 9c 3h 3d]
Seat 1: the_wickstar folded before Flop (didn't bet)
Seat 2: pdilaccio mucked [Jh Jc]
Seat 4: TrueLargen folded before Flop (didn't bet)
Seat 5: RG&JP5 (button) folded before Flop (didn't bet)
Seat 6: IceAngel82 (small blind) folded before Flop
Seat 7: mimi93731 (big blind) showed [7h Kc] and won ($0.28) with two p=
air, Kings and Threes
Seat 8: 1tillit1 folded before Flop (didn't bet)
Seat 9: smilie0123 folded before Flop (didn't bet)


*********** # 97 **************
PokerStars Hand #169850788941:  Hold'em No Limit ($0.01/$0.02 USD) - 20=
17/05/02 23:17:15 CUST [2017/05/02 9:17:15 ET]
Table 'Botha' 9-max Seat #8 is the button
Seat 1: IceAngel82 ($2 in chips)=20
Seat 2: PAMEGERA ($2.65 in chips)=20
Seat 3: Sprut2013 ($2.86 in chips)=20
Seat 4: Leopoker888 ($2.02 in chips)=20
Seat 5: Tikinh00 ($2.05 in chips)=20
Seat 6: diment76 ($1.91 in chips)=20
Seat 7: the_wickstar ($2.19 in chips)=20
Seat 8: Dooley121 ($1.50 in chips)=20
Seat 9: Demonidze31 ($2 in chips)=20
Demonidze31: posts small blind $0.01
IceAngel82: posts big blind $0.02
*** HOLE CARDS ***
Dealt to the_wickstar [As 3c]
PAMEGERA: folds=20
Sprut2013: raises $0.05 to $0.07
Leopoker888: folds=20
Tikinh00: folds=20
diment76: folds=20
the_wickstar: folds=20
Dooley121: folds=20
Demonidze31: calls $0.06
IceAngel82: raises $0.21 to $0.28
Sprut2013: calls $0.21
Demonidze31: folds=20
*** FLOP *** [9s 6s Ks]
IceAngel82: checks=20
Sprut2013: checks=20
*** TURN *** [9s 6s Ks] [5d]
IceAngel82: bets $0.41
Sprut2013: folds=20
Uncalled bet ($0.41) returned to IceAngel82
IceAngel82 collected $0.61 from pot
IceAngel82: doesn't show hand=20
*** SUMMARY ***
Total pot $0.63 | Rake $0.02=20
Board [9s 6s Ks 5d]
Seat 1: IceAngel82 (big blind) collected ($0.61)
Seat 2: PAMEGERA folded before Flop (didn't bet)
Seat 3: Sprut2013 folded on the Turn
Seat 4: Leopoker888 folded before Flop (didn't bet)
Seat 5: Tikinh00 folded before Flop (didn't bet)
Seat 6: diment76 folded before Flop (didn't bet)
Seat 7: the_wickstar folded before Flop (didn't bet)
Seat 8: Dooley121 (button) folded before Flop (didn't bet)
Seat 9: Demonidze31 (small blind) folded before Flop


*********** # 98 **************
PokerStars Hand #169850747074:  Hold'em No Limit ($0.01/$0.02 USD) - 20=
17/05/02 23:15:55 CUST [2017/05/02 9:15:55 ET]
Table 'Botha' 9-max Seat #7 is the button
Seat 2: PAMEGERA ($2.65 in chips)=20
Seat 3: Sprut2013 ($2.82 in chips)=20
Seat 4: Leopoker888 ($2.02 in chips)=20
Seat 5: Tikinh00 ($2.05 in chips)=20
Seat 6: diment76 ($1.91 in chips)=20
Seat 7: the_wickstar ($2.19 in chips)=20
Seat 8: Dooley121 ($1.52 in chips)=20
Seat 9: Demonidze31 ($2 in chips)=20
Dooley121: posts small blind $0.01
Demonidze31: posts big blind $0.02
IceAngel82: sits out=20
*** HOLE CARDS ***
Dealt to the_wickstar [4s Qc]
PAMEGERA: folds=20
Sprut2013: calls $0.02
Leopoker888: folds=20
Tikinh00: folds=20
diment76: folds=20
the_wickstar: folds=20
Dooley121: calls $0.01
Demonidze31: checks=20
*** FLOP *** [7s 3s Qh]
Dooley121: checks=20
Demonidze31: checks=20
Sprut2013: checks=20
*** TURN *** [7s 3s Qh] [7d]
Dooley121: checks=20
Demonidze31: checks=20
Sprut2013: bets $0.03
Dooley121: folds=20
Demonidze31: folds=20
Uncalled bet ($0.03) returned to Sprut2013
Sprut2013 collected $0.06 from pot
Sprut2013: doesn't show hand=20
*** SUMMARY ***
Total pot $0.06 | Rake $0=20
Board [7s 3s Qh 7d]
Seat 2: PAMEGERA folded before Flop (didn't bet)
Seat 3: Sprut2013 collected ($0.06)
Seat 4: Leopoker888 folded before Flop (didn't bet)
Seat 5: Tikinh00 folded before Flop (didn't bet)
Seat 6: diment76 folded before Flop (didn't bet)
Seat 7: the_wickstar (button) folded before Flop (didn't bet)
Seat 8: Dooley121 (small blind) folded on the Turn
Seat 9: Demonidze31 (big blind) folded on the Turn


*********** # 99 **************
PokerStars Hand #169850735699:  Hold'em No Limit ($0.01/$0.02 USD) - 20=
17/05/02 23:15:33 CUST [2017/05/02 9:15:33 ET]
Table 'Telephus' 9-max Seat #4 is the button
Seat 1: the_wickstar ($1.33 in chips)=20
Seat 4: TrueLargen ($3.20 in chips)=20
Seat 5: RG&JP5 ($0.44 in chips)=20
Seat 6: IceAngel82 ($2.89 in chips)=20
Seat 7: mimi93731 ($0.71 in chips)=20
Seat 8: 1tillit1 ($2.68 in chips)=20
Seat 9: smilie0123 ($2.11 in chips)=20
RG&JP5: posts small blind $0.01
IceAngel82: posts big blind $0.02
brulterier leaves the table
pdilaccio is disconnected=20
pdilaccio has timed out while disconnected
pdilaccio: is sitting out=20
*** HOLE CARDS ***
Dealt to the_wickstar [8d Jd]
mimi93731: calls $0.02
1tillit1: raises $0.08 to $0.10
Humanfritz joins the table at seat #3=20
smilie0123: folds=20
the_wickstar: folds=20
TrueLargen: folds=20
RG&JP5: folds=20
IceAngel82: calls $0.08
mimi93731: calls $0.08
*** FLOP *** [6s 8s 9c]
IceAngel82: bets $0.23
mimi93731: raises $0.38 to $0.61 and is all-in
1tillit1: folds=20
IceAngel82: calls $0.38
*** TURN *** [6s 8s 9c] [Ah]
*** RIVER *** [6s 8s 9c Ah] [9h]
*** SHOW DOWN ***
IceAngel82: shows [Td Ts] (two pair, Tens and Nines)
mimi93731: shows [6d 6c] (a full house, Sixes full of Nines)
mimi93731 collected $1.48 from pot
*** SUMMARY ***
Total pot $1.53 | Rake $0.05=20
Board [6s 8s 9c Ah 9h]
Seat 1: the_wickstar folded before Flop (didn't bet)
Seat 4: TrueLargen (button) folded before Flop (didn't bet)
Seat 5: RG&JP5 (small blind) folded before Flop
Seat 6: IceAngel82 (big blind) showed [Td Ts] and lost with two pair, T=
ens and Nines
Seat 7: mimi93731 showed [6d 6c] and won ($1.48) with a full house, Six=
es full of Nines
Seat 8: 1tillit1 folded on the Flop
Seat 9: smilie0123 folded before Flop (didn't bet)


*********** # 100 **************
PokerStars Hand #169850715605:  Hold'em No Limit ($0.01/$0.02 USD) - 20=
17/05/02 23:14:54 CUST [2017/05/02 9:14:54 ET]
Table 'Botha' 9-max Seat #6 is the button
Seat 2: PAMEGERA ($2.65 in chips)=20
Seat 3: Sprut2013 ($3.01 in chips)=20
Seat 4: Leopoker888 ($2.02 in chips)=20
Seat 5: Tikinh00 ($2.05 in chips)=20
Seat 6: diment76 ($1.91 in chips)=20
Seat 7: the_wickstar ($1.99 in chips)=20
Seat 8: Dooley121 ($1.54 in chips)=20
Seat 9: Demonidze31 ($2 in chips)=20
the_wickstar: posts small blind $0.01
Dooley121: posts big blind $0.02
IceAngel82: sits out=20
*** HOLE CARDS ***
Dealt to the_wickstar [Ts Td]
Demonidze31: folds=20
PAMEGERA: folds=20
Sprut2013: raises $0.05 to $0.07
Leopoker888: folds=20
Tikinh00: folds=20
diment76: folds=20
the_wickstar: calls $0.06
Dooley121: folds=20
*** FLOP *** [7h Th 2d]
the_wickstar: checks=20
Sprut2013: bets $0.06
the_wickstar: raises $0.06 to $0.12
Sprut2013: calls $0.06
*** TURN *** [7h Th 2d] [9d]
the_wickstar: bets $0.39
Sprut2013: folds=20
Uncalled bet ($0.39) returned to the_wickstar
the_wickstar collected $0.39 from pot
*** SUMMARY ***
Total pot $0.40 | Rake $0.01=20
Board [7h Th 2d 9d]
Seat 2: PAMEGERA folded before Flop (didn't bet)
Seat 3: Sprut2013 folded on the Turn
Seat 4: Leopoker888 folded before Flop (didn't bet)
Seat 5: Tikinh00 folded before Flop (didn't bet)
Seat 6: diment76 (button) folded before Flop (didn't bet)
Seat 7: the_wickstar (small blind) collected ($0.39)
Seat 8: Dooley121 (big blind) folded before Flop
Seat 9: Demonidze31 folded before Flop (didn't bet)


*********** # 101 **************
PokerStars Hand #169850696694:  Hold'em No Limit ($0.01/$0.02 USD) - 20=
17/05/02 23:14:17 CUST [2017/05/02 9:14:17 ET]
Table 'Botha' 9-max Seat #5 is the button
Seat 2: PAMEGERA ($2.65 in chips)=20
Seat 3: Sprut2013 ($3.03 in chips)=20
Seat 4: Leopoker888 ($2.02 in chips)=20
Seat 5: Tikinh00 ($2.05 in chips)=20
Seat 6: diment76 ($1.87 in chips)=20
Seat 7: the_wickstar ($2.01 in chips)=20
Seat 8: Dooley121 ($1.54 in chips)=20
Seat 9: Demonidze31 ($2 in chips)=20
diment76: posts small blind $0.01
the_wickstar: posts big blind $0.02
IceAngel82: sits out=20
*** HOLE CARDS ***
Dealt to the_wickstar [Kc 7d]
Dooley121: folds=20
Demonidze31: folds=20
PAMEGERA: folds=20
Sprut2013: calls $0.02
Leopoker888: folds=20
Tikinh00: folds=20
diment76: raises $0.06 to $0.08
the_wickstar: folds=20
Sprut2013: folds=20
Uncalled bet ($0.06) returned to diment76
diment76 collected $0.06 from pot
*** SUMMARY ***
Total pot $0.06 | Rake $0=20
Seat 2: PAMEGERA folded before Flop (didn't bet)
Seat 3: Sprut2013 folded before Flop
Seat 4: Leopoker888 folded before Flop (didn't bet)
Seat 5: Tikinh00 (button) folded before Flop (didn't bet)
Seat 6: diment76 (small blind) collected ($0.06)
Seat 7: the_wickstar (big blind) folded before Flop
Seat 8: Dooley121 folded before Flop (didn't bet)
Seat 9: Demonidze31 folded before Flop (didn't bet)


*********** # 102 **************
PokerStars Hand #169850677466:  Hold'em No Limit ($0.01/$0.02 USD) - 20=
17/05/02 23:13:40 CUST [2017/05/02 9:13:40 ET]
Table 'Telephus' 9-max Seat #1 is the button
Seat 1: the_wickstar ($1.33 in chips)=20
Seat 2: Maybe qwer ($2.47 in chips)=20
Seat 3: brulterier ($0.70 in chips)=20
Seat 4: TrueLargen ($2.37 in chips)=20
Seat 5: RG&JP5 ($0.44 in chips)=20
Seat 6: IceAngel82 ($2.95 in chips)=20
Seat 7: mimi93731 ($0.77 in chips)=20
Seat 8: 1tillit1 ($2.68 in chips)=20
Seat 9: smilie0123 ($2.17 in chips)=20
Maybe qwer: posts small blind $0.01
brulterier: posts big blind $0.02
*** HOLE CARDS ***
Dealt to the_wickstar [5h Th]
TrueLargen: raises $0.04 to $0.06
RG&JP5: folds=20
IceAngel82: calls $0.06
mimi93731: calls $0.06
1tillit1: folds=20
smilie0123: calls $0.06
the_wickstar: folds=20
Maybe qwer: folds=20
brulterier: calls $0.04
*** FLOP *** [2c 8c 7h]
Maybe qwer leaves the table
brulterier: checks=20
TrueLargen: checks=20
IceAngel82: checks=20
mimi93731: checks=20
smilie0123: checks=20
*** TURN *** [2c 8c 7h] [Qh]
brulterier: checks=20
TrueLargen: bets $0.15
pdilaccio joins the table at seat #2=20
IceAngel82: folds=20
mimi93731: folds=20
smilie0123: folds=20
brulterier: raises $0.15 to $0.30
TrueLargen: raises $0.38 to $0.68
brulterier: calls $0.34 and is all-in
Uncalled bet ($0.04) returned to TrueLargen
*** RIVER *** [2c 8c 7h Qh] [Qc]
*** SHOW DOWN ***
brulterier: shows [Qs Ks] (three of a kind, Queens)
TrueLargen: shows [8h 8d] (a full house, Eights full of Queens)
TrueLargen collected $1.53 from pot
*** SUMMARY ***
Total pot $1.59 | Rake $0.06=20
Board [2c 8c 7h Qh Qc]
Seat 1: the_wickstar (button) folded before Flop (didn't bet)
Seat 2: Maybe qwer (small blind) folded before Flop
Seat 3: brulterier (big blind) showed [Qs Ks] and lost with three of a =
kind, Queens
Seat 4: TrueLargen showed [8h 8d] and won ($1.53) with a full house, Ei=
ghts full of Queens
Seat 5: RG&JP5 folded before Flop (didn't bet)
Seat 6: IceAngel82 folded on the Turn
Seat 7: mimi93731 folded on the Turn
Seat 8: 1tillit1 folded before Flop (didn't bet)
Seat 9: smilie0123 folded on the Turn


*********** # 103 **************
PokerStars Hand #169850650895:  Hold'em No Limit ($0.01/$0.02 USD) - 20=
17/05/02 23:12:48 CUST [2017/05/02 9:12:48 ET]
Table 'Botha' 9-max Seat #4 is the button
Seat 2: PAMEGERA ($2.64 in chips)=20
Seat 3: Sprut2013 ($3.03 in chips)=20
Seat 4: Leopoker888 ($2.02 in chips)=20
Seat 5: Tikinh00 ($2.06 in chips)=20
Seat 6: diment76 ($1.93 in chips)=20
Seat 7: the_wickstar ($2 in chips)=20
Seat 8: Dooley121 ($1.54 in chips)=20
Seat 9: Demonidze31 ($2 in chips)=20
Tikinh00: posts small blind $0.01
diment76: posts big blind $0.02
IceAngel82: sits out=20
*** HOLE CARDS ***
Dealt to the_wickstar [As Kd]
the_wickstar: raises $0.04 to $0.06
Dooley121: folds=20
Demonidze31: folds=20
PAMEGERA: calls $0.06
Sprut2013: folds=20
Leopoker888: folds=20
Tikinh00: folds=20
diment76: calls $0.04
*** FLOP *** [5d Js Ks]
diment76: checks=20
the_wickstar: bets $0.18
PAMEGERA: calls $0.18
diment76: folds=20
*** TURN *** [5d Js Ks] [4d]
the_wickstar: checks=20
PAMEGERA: bets $0.43
the_wickstar: calls $0.43
*** RIVER *** [5d Js Ks 4d] [9s]
the_wickstar: checks=20
PAMEGERA: checks=20
*** SHOW DOWN ***
the_wickstar: shows [As Kd] (a pair of Kings)
PAMEGERA: shows [Kc Ah] (a pair of Kings)
the_wickstar collected $0.68 from pot
PAMEGERA collected $0.68 from pot
*** SUMMARY ***
Total pot $1.41 | Rake $0.05=20
Board [5d Js Ks 4d 9s]
Seat 2: PAMEGERA showed [Kc Ah] and won ($0.68) with a pair of Kings
Seat 3: Sprut2013 folded before Flop (didn't bet)
Seat 4: Leopoker888 (button) folded before Flop (didn't bet)
Seat 5: Tikinh00 (small blind) folded before Flop
Seat 6: diment76 (big blind) folded on the Flop
Seat 7: the_wickstar showed [As Kd] and won ($0.68) with a pair of Kings
Seat 8: Dooley121 folded before Flop (didn't bet)
Seat 9: Demonidze31 folded before Flop (didn't bet)


*********** # 104 **************
PokerStars Hand #169850634665:  Hold'em No Limit ($0.01/$0.02 USD) - 20=
17/05/02 23:12:17 CUST [2017/05/02 9:12:17 ET]
Table 'Telephus' 9-max Seat #9 is the button
Seat 1: the_wickstar ($1.34 in chips)=20
Seat 2: Maybe qwer ($1.59 in chips)=20
Seat 3: brulterier ($0.72 in chips)=20
Seat 4: TrueLargen ($2.37 in chips)=20
Seat 5: RG&JP5 ($1.36 in chips)=20
Seat 6: IceAngel82 ($2.95 in chips)=20
Seat 7: mimi93731 ($0.77 in chips)=20
Seat 8: 1tillit1 ($2.68 in chips)=20
Seat 9: smilie0123 ($2.17 in chips)=20
the_wickstar: posts small blind $0.01
Maybe qwer: posts big blind $0.02
*** HOLE CARDS ***
Dealt to the_wickstar [Kc Qs]
brulterier: calls $0.02
TrueLargen: folds=20
RG&JP5: raises $0.04 to $0.06
IceAngel82: folds=20
mimi93731: folds=20
1tillit1: folds=20
smilie0123: folds=20
the_wickstar: folds=20
Maybe qwer: raises $0.12 to $0.18
brulterier: folds=20
RG&JP5: calls $0.12
*** FLOP *** [5s 3h 8h]
Maybe qwer: bets $0.20
RG&JP5: calls $0.20
*** TURN *** [5s 3h 8h] [4d]
Maybe qwer: bets $0.54
RG&JP5: calls $0.54
*** RIVER *** [5s 3h 8h 4d] [Ac]
Maybe qwer: bets $0.67 and is all-in
RG&JP5: folds=20
Uncalled bet ($0.67) returned to Maybe qwer
Maybe qwer collected $1.80 from pot
*** SUMMARY ***
Total pot $1.87 | Rake $0.07=20
Board [5s 3h 8h 4d Ac]
Seat 1: the_wickstar (small blind) folded before Flop
Seat 2: Maybe qwer (big blind) collected ($1.80)
Seat 3: brulterier folded before Flop
Seat 4: TrueLargen folded before Flop (didn't bet)
Seat 5: RG&JP5 folded on the River
Seat 6: IceAngel82 folded before Flop (didn't bet)
Seat 7: mimi93731 folded before Flop (didn't bet)
Seat 8: 1tillit1 folded before Flop (didn't bet)
Seat 9: smilie0123 (button) folded before Flop (didn't bet)


*********** # 105 **************
PokerStars Hand #169850622453:  Hold'em No Limit ($0.01/$0.02 USD) - 20=
17/05/02 23:11:53 CUST [2017/05/02 9:11:53 ET]
Table 'Botha' 9-max Seat #3 is the button
Seat 2: PAMEGERA ($2.64 in chips)=20
Seat 3: Sprut2013 ($3.03 in chips)=20
Seat 4: Leopoker888 ($2.03 in chips)=20
Seat 5: Tikinh00 ($2.10 in chips)=20
Seat 6: diment76 ($1.93 in chips)=20
Seat 7: the_wickstar ($2 in chips)=20
Seat 8: Dooley121 ($1.49 in chips)=20
Seat 9: Demonidze31 ($2 in chips)=20
Leopoker888: posts small blind $0.01
Tikinh00: posts big blind $0.02
IceAngel82: sits out=20
*** HOLE CARDS ***
Dealt to the_wickstar [5h 3h]
diment76: folds=20
the_wickstar: folds=20
Dooley121: calls $0.02
Demonidze31: folds=20
PAMEGERA: folds=20
Sprut2013: folds=20
Leopoker888: folds=20
Tikinh00: checks=20
*** FLOP *** [Qd 2h 9s]
Tikinh00: checks=20
Dooley121: bets $0.02
Tikinh00: calls $0.02
*** TURN *** [Qd 2h 9s] [7s]
Tikinh00: checks=20
Dooley121: checks=20
*** RIVER *** [Qd 2h 9s 7s] [Td]
Tikinh00: checks=20
Dooley121: checks=20
*** SHOW DOWN ***
Tikinh00: shows [Ah 5c] (high card Ace)
Dooley121: shows [4h 4c] (a pair of Fours)
Dooley121 collected $0.09 from pot
*** SUMMARY ***
Total pot $0.09 | Rake $0=20
Board [Qd 2h 9s 7s Td]
Seat 2: PAMEGERA folded before Flop (didn't bet)
Seat 3: Sprut2013 (button) folded before Flop (didn't bet)
Seat 4: Leopoker888 (small blind) folded before Flop
Seat 5: Tikinh00 (big blind) showed [Ah 5c] and lost with high card Ace
Seat 6: diment76 folded before Flop (didn't bet)
Seat 7: the_wickstar folded before Flop (didn't bet)
Seat 8: Dooley121 showed [4h 4c] and won ($0.09) with a pair of Fours
Seat 9: Demonidze31 folded before Flop (didn't bet)


*********** # 106 **************
PokerStars Hand #169850619213:  Hold'em No Limit ($0.01/$0.02 USD) - 20=
17/05/02 23:11:47 CUST [2017/05/02 9:11:47 ET]
Table 'Telephus' 9-max Seat #8 is the button
Seat 1: the_wickstar ($1.36 in chips)=20
Seat 2: Maybe qwer ($1.53 in chips)=20
Seat 3: brulterier ($0.72 in chips)=20
Seat 4: TrueLargen ($2.37 in chips)=20
Seat 5: RG&JP5 ($1.36 in chips)=20
Seat 6: IceAngel82 ($2.95 in chips)=20
Seat 7: mimi93731 ($0.80 in chips)=20
Seat 8: 1tillit1 ($2.68 in chips)=20
Seat 9: smilie0123 ($2.18 in chips)=20
smilie0123: posts small blind $0.01
the_wickstar: posts big blind $0.02
mimi93731: posts small & big blinds $0.03
*** HOLE CARDS ***
Dealt to the_wickstar [Ks 7s]
Maybe qwer: raises $0.07 to $0.09
brulterier: folds=20
TrueLargen: folds=20
RG&JP5: folds=20
IceAngel82: folds=20
mimi93731: folds=20
1tillit1: folds=20
smilie0123: folds=20
the_wickstar: folds=20
Uncalled bet ($0.07) returned to Maybe qwer
Maybe qwer collected $0.08 from pot
*** SUMMARY ***
Total pot $0.08 | Rake $0=20
Seat 1: the_wickstar (big blind) folded before Flop
Seat 2: Maybe qwer collected ($0.08)
Seat 3: brulterier folded before Flop (didn't bet)
Seat 4: TrueLargen folded before Flop (didn't bet)
Seat 5: RG&JP5 folded before Flop (didn't bet)
Seat 6: IceAngel82 folded before Flop (didn't bet)
Seat 7: mimi93731 folded before Flop
Seat 8: 1tillit1 (button) folded before Flop (didn't bet)
Seat 9: smilie0123 (small blind) folded before Flop


*********** # 107 **************
PokerStars Hand #169850597593:  Hold'em No Limit ($0.01/$0.02 USD) - 20=
17/05/02 23:11:05 CUST [2017/05/02 9:11:05 ET]
Table 'Botha' 9-max Seat #2 is the button
Seat 2: PAMEGERA ($2.58 in chips)=20
Seat 3: Sprut2013 ($3.04 in chips)=20
Seat 4: Leopoker888 ($2.08 in chips)=20
Seat 5: Tikinh00 ($2.10 in chips)=20
Seat 6: diment76 ($1.93 in chips)=20
Seat 7: the_wickstar ($2 in chips)=20
Seat 8: Dooley121 ($1.49 in chips)=20
Seat 9: Demonidze31 ($2 in chips)=20
Sprut2013: posts small blind $0.01
Leopoker888: posts big blind $0.02
IceAngel82: sits out=20
*** HOLE CARDS ***
Dealt to the_wickstar [Qd 8d]
Tikinh00: folds=20
diment76: folds=20
the_wickstar: folds=20
Dooley121: folds=20
Demonidze31: folds=20
PAMEGERA: raises $0.03 to $0.05
Sprut2013: folds=20
Leopoker888: calls $0.03
*** FLOP *** [3h Ts 2d]
Leopoker888: checks=20
PAMEGERA: bets $0.07
Leopoker888: folds=20
Uncalled bet ($0.07) returned to PAMEGERA
PAMEGERA collected $0.11 from pot
PAMEGERA: doesn't show hand=20
*** SUMMARY ***
Total pot $0.11 | Rake $0=20
Board [3h Ts 2d]
Seat 2: PAMEGERA (button) collected ($0.11)
Seat 3: Sprut2013 (small blind) folded before Flop
Seat 4: Leopoker888 (big blind) folded on the Flop
Seat 5: Tikinh00 folded before Flop (didn't bet)
Seat 6: diment76 folded before Flop (didn't bet)
Seat 7: the_wickstar folded before Flop (didn't bet)
Seat 8: Dooley121 folded before Flop (didn't bet)
Seat 9: Demonidze31 folded before Flop (didn't bet)


*********** # 108 **************
PokerStars Hand #169850567423:  Hold'em No Limit ($0.01/$0.02 USD) - 20=
17/05/02 23:10:06 CUST [2017/05/02 9:10:06 ET]
Table 'Botha' 9-max Seat #9 is the button
Seat 2: PAMEGERA ($2.59 in chips)=20
Seat 3: Sprut2013 ($3.06 in chips)=20
Seat 4: Leopoker888 ($2.08 in chips)=20
Seat 5: Tikinh00 ($2.14 in chips)=20
Seat 6: diment76 ($1.93 in chips)=20
Seat 7: the_wickstar ($2 in chips)=20
Seat 8: Dooley121 ($1.40 in chips)=20
Seat 9: Demonidze31 ($2.02 in chips)=20
PAMEGERA: posts small blind $0.01
Sprut2013: posts big blind $0.02
*** HOLE CARDS ***
Dealt to the_wickstar [9h 3s]
Leopoker888: folds=20
Tikinh00: calls $0.02
diment76: folds=20
the_wickstar: folds=20
Dooley121: calls $0.02
Demonidze31: calls $0.02
PAMEGERA: folds=20
Sprut2013: checks=20
*** FLOP *** [Td 3h Qh]
IceAngel82 joins the table at seat #1=20
Sprut2013: checks=20
Tikinh00: checks=20
Dooley121: checks=20
Demonidze31: checks=20
*** TURN *** [Td 3h Qh] [Qc]
Sprut2013: checks=20
Tikinh00: checks=20
Dooley121: bets $0.02
Demonidze31: folds=20
Sprut2013: folds=20
Tikinh00: calls $0.02
*** RIVER *** [Td 3h Qh Qc] [9c]
Tikinh00: checks=20
Dooley121: checks=20
*** SHOW DOWN ***
Tikinh00: shows [3d Kd] (two pair, Queens and Threes)
Dooley121: shows [4c 4h] (two pair, Queens and Fours)
Dooley121 collected $0.13 from pot
*** SUMMARY ***
Total pot $0.13 | Rake $0=20
Board [Td 3h Qh Qc 9c]
Seat 2: PAMEGERA (small blind) folded before Flop
Seat 3: Sprut2013 (big blind) folded on the Turn
Seat 4: Leopoker888 folded before Flop (didn't bet)
Seat 5: Tikinh00 showed [3d Kd] and lost with two pair, Queens and Thre=
es
Seat 6: diment76 folded before Flop (didn't bet)
Seat 7: the_wickstar folded before Flop (didn't bet)
Seat 8: Dooley121 showed [4c 4h] and won ($0.13) with two pair, Queens =
and Fours
Seat 9: Demonidze31 (button) folded on the Turn


*********** # 109 **************
PokerStars Hand #169850560971:  Hold'em No Limit ($0.01/$0.02 USD) - 20=
17/05/02 23:09:54 CUST [2017/05/02 9:09:54 ET]
Table 'Telephus' 9-max Seat #6 is the button
Seat 1: the_wickstar ($1.20 in chips)=20
Seat 2: Maybe qwer ($1.53 in chips)=20
Seat 3: brulterier ($0.72 in chips)=20
Seat 4: TrueLargen ($2.51 in chips)=20
Seat 5: RG&JP5 ($1.36 in chips)=20
Seat 6: IceAngel82 ($2.95 in chips)=20
Seat 8: 1tillit1 ($2.69 in chips)=20
Seat 9: smilie0123 ($2.20 in chips)=20
mimi93731 will be allowed to play after the button
1tillit1: posts small blind $0.01
smilie0123: posts big blind $0.02
*** HOLE CARDS ***
Dealt to the_wickstar [Ad Kh]
the_wickstar: raises $0.04 to $0.06
Maybe qwer: folds=20
brulterier: folds=20
TrueLargen: calls $0.06
RG&JP5: folds=20
IceAngel82: folds=20
1tillit1: folds=20
smilie0123: folds=20
*** FLOP *** [Th 5c 6h]
the_wickstar: checks=20
TrueLargen: checks=20
*** TURN *** [Th 5c 6h] [Qs]
the_wickstar: checks=20
TrueLargen: bets $0.08
the_wickstar: calls $0.08
*** RIVER *** [Th 5c 6h Qs] [4s]
the_wickstar: checks=20
TrueLargen: checks=20
*** SHOW DOWN ***
the_wickstar: shows [Ad Kh] (high card Ace)
TrueLargen: mucks hand=20
the_wickstar collected $0.30 from pot
*** SUMMARY ***
Total pot $0.31 | Rake $0.01=20
Board [Th 5c 6h Qs 4s]
Seat 1: the_wickstar showed [Ad Kh] and won ($0.30) with high card Ace
Seat 2: Maybe qwer folded before Flop (didn't bet)
Seat 3: brulterier folded before Flop (didn't bet)
Seat 4: TrueLargen mucked [Jh Ks]
Seat 5: RG&JP5 folded before Flop (didn't bet)
Seat 6: IceAngel82 (button) folded before Flop (didn't bet)
Seat 8: 1tillit1 (small blind) folded before Flop
Seat 9: smilie0123 (big blind) folded before Flop


*********** # 110 **************
PokerStars Hand #169850557571:  Hold'em No Limit ($0.01/$0.02 USD) - 20=
17/05/02 23:09:47 CUST [2017/05/02 9:09:47 ET]
Table 'Botha' 9-max Seat #8 is the button
Seat 2: PAMEGERA ($2.61 in chips)=20
Seat 3: Sprut2013 ($3.06 in chips)=20
Seat 4: Leopoker888 ($2.08 in chips)=20
Seat 5: Tikinh00 ($2.14 in chips)=20
Seat 6: diment76 ($1.93 in chips)=20
Seat 7: the_wickstar ($2 in chips)=20
Seat 8: Dooley121 ($1.40 in chips)=20
Seat 9: Demonidze31 ($2 in chips)=20
Demonidze31: posts small blind $0.01
zartovskiy: is sitting out=20
PAMEGERA: posts big blind $0.02
zartovskiy leaves the table
*** HOLE CARDS ***
Dealt to the_wickstar [Qd 6c]
Sprut2013: folds=20
Leopoker888: folds=20
Tikinh00: folds=20
diment76: folds=20
the_wickstar: folds=20
Dooley121: folds=20
Demonidze31: raises $0.02 to $0.04
PAMEGERA: folds=20
Uncalled bet ($0.02) returned to Demonidze31
Demonidze31 collected $0.04 from pot
Demonidze31: doesn't show hand=20
*** SUMMARY ***
Total pot $0.04 | Rake $0=20
Seat 2: PAMEGERA (big blind) folded before Flop
Seat 3: Sprut2013 folded before Flop (didn't bet)
Seat 4: Leopoker888 folded before Flop (didn't bet)
Seat 5: Tikinh00 folded before Flop (didn't bet)
Seat 6: diment76 folded before Flop (didn't bet)
Seat 7: the_wickstar folded before Flop (didn't bet)
Seat 8: Dooley121 (button) folded before Flop (didn't bet)
Seat 9: Demonidze31 (small blind) collected ($0.04)


*********** # 111 **************
PokerStars Hand #169850554568:  Hold'em No Limit ($0.01/$0.02 USD) - 20=
17/05/02 23:09:42 CUST [2017/05/02 9:09:42 ET]
Table 'Telephus' 9-max Seat #5 is the button
Seat 1: the_wickstar ($1.20 in chips)=20
Seat 2: Maybe qwer ($1.53 in chips)=20
Seat 3: brulterier ($0.72 in chips)=20
Seat 4: TrueLargen ($2.51 in chips)=20
Seat 5: RG&JP5 ($1.36 in chips)=20
Seat 6: IceAngel82 ($2.96 in chips)=20
Seat 8: 1tillit1 ($2.71 in chips)=20
Seat 9: smilie0123 ($2.17 in chips)=20
IceAngel82: posts small blind $0.01
1tillit1: posts big blind $0.02
*** HOLE CARDS ***
Dealt to the_wickstar [8h Kc]
smilie0123: raises $0.04 to $0.06
the_wickstar: folds=20
Maybe qwer: folds=20
brulterier: folds=20
TrueLargen: folds=20
RG&JP5: folds=20
IceAngel82: folds=20
1tillit1: folds=20
Uncalled bet ($0.04) returned to smilie0123
smilie0123 collected $0.05 from pot
smilie0123: doesn't show hand=20
*** SUMMARY ***
Total pot $0.05 | Rake $0=20
Seat 1: the_wickstar folded before Flop (didn't bet)
Seat 2: Maybe qwer folded before Flop (didn't bet)
Seat 3: brulterier folded before Flop (didn't bet)
Seat 4: TrueLargen folded before Flop (didn't bet)
Seat 5: RG&JP5 (button) folded before Flop (didn't bet)
Seat 6: IceAngel82 (small blind) folded before Flop
Seat 8: 1tillit1 (big blind) folded before Flop
Seat 9: smilie0123 collected ($0.05)


*********** # 112 **************
PokerStars Hand #169850536040:  Hold'em No Limit ($0.01/$0.02 USD) - 20=
17/05/02 23:09:06 CUST [2017/05/02 9:09:06 ET]
Table 'Botha' 9-max Seat #7 is the button
Seat 1: zartovskiy ($2.49 in chips)=20
Seat 2: PAMEGERA ($2.61 in chips)=20
Seat 3: Sprut2013 ($3.14 in chips)=20
Seat 4: Leopoker888 ($2.08 in chips)=20
Seat 5: Tikinh00 ($2.14 in chips)=20
Seat 6: diment76 ($1.93 in chips)=20
Seat 7: the_wickstar ($2 in chips)=20
Seat 8: Dooley121 ($1.41 in chips)=20
Seat 9: Demonidze31 ($2 in chips)=20
Dooley121: posts small blind $0.01
Demonidze31: posts big blind $0.02
*** HOLE CARDS ***
Dealt to the_wickstar [4h 9c]
zartovskiy: raises $0.06 to $0.08
PAMEGERA: folds=20
Sprut2013: calls $0.08
Leopoker888: folds=20
Tikinh00: folds=20
diment76: folds=20
the_wickstar: folds=20
Dooley121: folds=20
Demonidze31: folds=20
*** FLOP *** [Ks 9h 8s]
zartovskiy: bets $0.10
Sprut2013: folds=20
Uncalled bet ($0.10) returned to zartovskiy
zartovskiy collected $0.18 from pot
zartovskiy: doesn't show hand=20
*** SUMMARY ***
Total pot $0.19 | Rake $0.01=20
Board [Ks 9h 8s]
Seat 1: zartovskiy collected ($0.18)
Seat 2: PAMEGERA folded before Flop (didn't bet)
Seat 3: Sprut2013 folded on the Flop
Seat 4: Leopoker888 folded before Flop (didn't bet)
Seat 5: Tikinh00 folded before Flop (didn't bet)
Seat 6: diment76 folded before Flop (didn't bet)
Seat 7: the_wickstar (button) folded before Flop (didn't bet)
Seat 8: Dooley121 (small blind) folded before Flop
Seat 9: Demonidze31 (big blind) folded before Flop


*********** # 113 **************
PokerStars Hand #169850535057:  Hold'em No Limit ($0.01/$0.02 USD) - 20=
17/05/02 23:09:04 CUST [2017/05/02 9:09:04 ET]
Table 'Telephus' 9-max Seat #4 is the button
Seat 1: the_wickstar ($1.20 in chips)=20
Seat 2: Maybe qwer ($1.53 in chips)=20
Seat 3: brulterier ($0.72 in chips)=20
Seat 4: TrueLargen ($2.51 in chips)=20
Seat 5: RG&JP5 ($1.37 in chips)=20
Seat 6: IceAngel82 ($2.98 in chips)=20
Seat 7: mimi93731 ($0.39 in chips)=20
Seat 8: 1tillit1 ($2.32 in chips)=20
Seat 9: smilie0123 ($2.17 in chips)=20
RG&JP5: posts small blind $0.01
IceAngel82: posts big blind $0.02
*** HOLE CARDS ***
Dealt to the_wickstar [2h 8h]
mimi93731: calls $0.02
1tillit1: raises $0.08 to $0.10
smilie0123: folds=20
the_wickstar: folds=20
Maybe qwer: folds=20
brulterier: folds=20
TrueLargen: folds=20
RG&JP5: folds=20
IceAngel82: folds=20
mimi93731: calls $0.08
*** FLOP *** [Qs 8c 9h]
mimi93731: bets $0.29 and is all-in
1tillit1: calls $0.29
*** TURN *** [Qs 8c 9h] [2s]
*** RIVER *** [Qs 8c 9h 2s] [8s]
*** SHOW DOWN ***
mimi93731: shows [9d Kd] (two pair, Nines and Eights)
1tillit1: shows [Qc Ah] (two pair, Queens and Eights)
1tillit1 collected $0.78 from pot
*** SUMMARY ***
Total pot $0.81 | Rake $0.03=20
Board [Qs 8c 9h 2s 8s]
Seat 1: the_wickstar folded before Flop (didn't bet)
Seat 2: Maybe qwer folded before Flop (didn't bet)
Seat 3: brulterier folded before Flop (didn't bet)
Seat 4: TrueLargen (button) folded before Flop (didn't bet)
Seat 5: RG&JP5 (small blind) folded before Flop
Seat 6: IceAngel82 (big blind) folded before Flop
Seat 7: mimi93731 showed [9d Kd] and lost with two pair, Nines and Eigh=
ts
Seat 8: 1tillit1 showed [Qc Ah] and won ($0.78) with two pair, Queens a=
nd Eights
Seat 9: smilie0123 folded before Flop (didn't bet)


*********** # 114 **************
PokerStars Hand #169850521325:  Hold'em No Limit ($0.01/$0.02 USD) - 20=
17/05/02 23:08:37 CUST [2017/05/02 9:08:37 ET]
Table 'Telephus' 9-max Seat #3 is the button
Seat 1: the_wickstar ($1.20 in chips)=20
Seat 2: Maybe qwer ($1.50 in chips)=20
Seat 3: brulterier ($0.72 in chips)=20
Seat 4: TrueLargen ($2.52 in chips)=20
Seat 5: RG&JP5 ($1.39 in chips)=20
Seat 6: IceAngel82 ($2.98 in chips)=20
Seat 7: mimi93731 ($0.39 in chips)=20
Seat 8: 1tillit1 ($2.32 in chips)=20
Seat 9: smilie0123 ($2.17 in chips)=20
TrueLargen: posts small blind $0.01
RG&JP5: posts big blind $0.02
*** HOLE CARDS ***
Dealt to the_wickstar [Th 6s]
IceAngel82: folds=20
mimi93731: folds=20
1tillit1: folds=20
smilie0123: folds=20
the_wickstar: folds=20
Maybe qwer: raises $0.04 to $0.06
brulterier: folds=20
TrueLargen: folds=20
RG&JP5: folds=20
Uncalled bet ($0.04) returned to Maybe qwer
Maybe qwer collected $0.05 from pot
*** SUMMARY ***
Total pot $0.05 | Rake $0=20
Seat 1: the_wickstar folded before Flop (didn't bet)
Seat 2: Maybe qwer collected ($0.05)
Seat 3: brulterier (button) folded before Flop (didn't bet)
Seat 4: TrueLargen (small blind) folded before Flop
Seat 5: RG&JP5 (big blind) folded before Flop
Seat 6: IceAngel82 folded before Flop (didn't bet)
Seat 7: mimi93731 folded before Flop (didn't bet)
Seat 8: 1tillit1 folded before Flop (didn't bet)
Seat 9: smilie0123 folded before Flop (didn't bet)


*********** # 115 **************
PokerStars Hand #169850519017:  Hold'em No Limit ($0.01/$0.02 USD) - 20=
17/05/02 23:08:33 CUST [2017/05/02 9:08:33 ET]
Table 'Botha' 9-max Seat #6 is the button
Seat 1: zartovskiy ($2.49 in chips)=20
Seat 2: PAMEGERA ($2.61 in chips)=20
Seat 3: Sprut2013 ($3.14 in chips)=20
Seat 4: Leopoker888 ($2.05 in chips)=20
Seat 5: Tikinh00 ($2.14 in chips)=20
Seat 6: diment76 ($1.93 in chips)=20
Seat 7: the_wickstar ($2.01 in chips)=20
Seat 8: Dooley121 ($1.43 in chips)=20
Seat 9: Demonidze31 ($2 in chips)=20
the_wickstar: posts small blind $0.01
Dooley121: posts big blind $0.02
*** HOLE CARDS ***
Dealt to the_wickstar [6c 7s]
Demonidze31: folds=20
zartovskiy: folds=20
PAMEGERA: folds=20
Sprut2013: folds=20
Leopoker888: raises $0.08 to $0.10
Tikinh00: folds=20
diment76: folds=20
the_wickstar: folds=20
Dooley121: folds=20
Uncalled bet ($0.08) returned to Leopoker888
Leopoker888 collected $0.05 from pot
Leopoker888: doesn't show hand=20
*** SUMMARY ***
Total pot $0.05 | Rake $0=20
Seat 1: zartovskiy folded before Flop (didn't bet)
Seat 2: PAMEGERA folded before Flop (didn't bet)
Seat 3: Sprut2013 folded before Flop (didn't bet)
Seat 4: Leopoker888 collected ($0.05)
Seat 5: Tikinh00 folded before Flop (didn't bet)
Seat 6: diment76 (button) folded before Flop (didn't bet)
Seat 7: the_wickstar (small blind) folded before Flop
Seat 8: Dooley121 (big blind) folded before Flop
Seat 9: Demonidze31 folded before Flop (didn't bet)


*********** # 116 **************
PokerStars Hand #169850504900:  Hold'em No Limit ($0.01/$0.02 USD) - 20=
17/05/02 23:08:05 CUST [2017/05/02 9:08:05 ET]
Table 'Botha' 9-max Seat #5 is the button
Seat 1: zartovskiy ($2.49 in chips)=20
Seat 2: PAMEGERA ($2.61 in chips)=20
Seat 3: Sprut2013 ($3.14 in chips)=20
Seat 4: Leopoker888 ($2.05 in chips)=20
Seat 5: Tikinh00 ($2.16 in chips)=20
Seat 6: diment76 ($1.89 in chips)=20
Seat 7: the_wickstar ($2.03 in chips)=20
Seat 8: Dooley121 ($1.43 in chips)=20
Seat 9: Demonidze31 ($2 in chips)=20
diment76: posts small blind $0.01
the_wickstar: posts big blind $0.02
*** HOLE CARDS ***
Dealt to the_wickstar [9h 4d]
Dooley121: folds=20
Demonidze31: folds=20
zartovskiy: folds=20
PAMEGERA: folds=20
Sprut2013: folds=20
Leopoker888: folds=20
Tikinh00: calls $0.02
diment76: raises $0.06 to $0.08
the_wickstar: folds=20
Tikinh00: folds=20
Uncalled bet ($0.06) returned to diment76
diment76 collected $0.06 from pot
*** SUMMARY ***
Total pot $0.06 | Rake $0=20
Seat 1: zartovskiy folded before Flop (didn't bet)
Seat 2: PAMEGERA folded before Flop (didn't bet)
Seat 3: Sprut2013 folded before Flop (didn't bet)
Seat 4: Leopoker888 folded before Flop (didn't bet)
Seat 5: Tikinh00 (button) folded before Flop
Seat 6: diment76 (small blind) collected ($0.06)
Seat 7: the_wickstar (big blind) folded before Flop
Seat 8: Dooley121 folded before Flop (didn't bet)
Seat 9: Demonidze31 folded before Flop (didn't bet)


*********** # 117 **************
PokerStars Hand #169850490941:  Hold'em No Limit ($0.01/$0.02 USD) - 20=
17/05/02 23:07:38 CUST [2017/05/02 9:07:38 ET]
Table 'Telephus' 9-max Seat #2 is the button
Seat 1: the_wickstar ($1.22 in chips)=20
Seat 2: Maybe qwer ($1.50 in chips)=20
Seat 3: brulterier ($0.74 in chips)=20
Seat 4: TrueLargen ($2 in chips)=20
Seat 6: IceAngel82 ($2.98 in chips)=20
Seat 7: mimi93731 ($0.91 in chips)=20
Seat 8: 1tillit1 ($2.32 in chips)=20
Seat 9: smilie0123 ($2.17 in chips)=20
brulterier: posts small blind $0.01
TrueLargen: posts big blind $0.02
RG&JP5: sits out=20
*** HOLE CARDS ***
Dealt to the_wickstar [Ad 4s]
IceAngel82: folds=20
mimi93731: calls $0.02
1tillit1: folds=20
smilie0123: folds=20
the_wickstar: calls $0.02
Maybe qwer: folds=20
brulterier: calls $0.01
TrueLargen: raises $0.08 to $0.10
mimi93731: calls $0.08
the_wickstar: folds=20
brulterier: folds=20
*** FLOP *** [7h 6c 6h]
TrueLargen: bets $0.14
mimi93731: calls $0.14
*** TURN *** [7h 6c 6h] [Kc]
TrueLargen: bets $0.28
mimi93731: calls $0.28
*** RIVER *** [7h 6c 6h Kc] [4c]
TrueLargen: bets $0.40
mimi93731: folds=20
Uncalled bet ($0.40) returned to TrueLargen
TrueLargen collected $1.04 from pot
TrueLargen: doesn't show hand=20
*** SUMMARY ***
Total pot $1.08 | Rake $0.04=20
Board [7h 6c 6h Kc 4c]
Seat 1: the_wickstar folded before Flop
Seat 2: Maybe qwer (button) folded before Flop (didn't bet)
Seat 3: brulterier (small blind) folded before Flop
Seat 4: TrueLargen (big blind) collected ($1.04)
Seat 6: IceAngel82 folded before Flop (didn't bet)
Seat 7: mimi93731 folded on the River
Seat 8: 1tillit1 folded before Flop (didn't bet)
Seat 9: smilie0123 folded before Flop (didn't bet)


*********** # 118 **************
PokerStars Hand #169850480928:  Hold'em No Limit ($0.01/$0.02 USD) - 20=
17/05/02 23:07:18 CUST [2017/05/02 9:07:18 ET]
Table 'Botha' 9-max Seat #4 is the button
Seat 1: zartovskiy ($2.49 in chips)=20
Seat 2: PAMEGERA ($2.61 in chips)=20
Seat 3: Sprut2013 ($3.16 in chips)=20
Seat 4: Leopoker888 ($2 in chips)=20
Seat 5: Tikinh00 ($2.17 in chips)=20
Seat 6: diment76 ($1.91 in chips)=20
Seat 7: the_wickstar ($2.03 in chips)=20
Seat 8: Dooley121 ($1.43 in chips)=20
Seat 9: Demonidze31 ($2 in chips)=20
Tikinh00: posts small blind $0.01
diment76: posts big blind $0.02
*** HOLE CARDS ***
Dealt to the_wickstar [6s 5c]
the_wickstar: folds=20
Dooley121: folds=20
Demonidze31: folds=20
zartovskiy: folds=20
PAMEGERA: folds=20
Sprut2013: calls $0.02
Leopoker888: raises $0.06 to $0.08
Tikinh00: folds=20
diment76: folds=20
Sprut2013: folds=20
Uncalled bet ($0.06) returned to Leopoker888
Leopoker888 collected $0.07 from pot
Leopoker888: doesn't show hand=20
*** SUMMARY ***
Total pot $0.07 | Rake $0=20
Seat 1: zartovskiy folded before Flop (didn't bet)
Seat 2: PAMEGERA folded before Flop (didn't bet)
Seat 3: Sprut2013 folded before Flop
Seat 4: Leopoker888 (button) collected ($0.07)
Seat 5: Tikinh00 (small blind) folded before Flop
Seat 6: diment76 (big blind) folded before Flop
Seat 7: the_wickstar folded before Flop (didn't bet)
Seat 8: Dooley121 folded before Flop (didn't bet)
Seat 9: Demonidze31 folded before Flop (didn't bet)


*********** # 119 **************
PokerStars Hand #169850462021:  Hold'em No Limit ($0.01/$0.02 USD) - 20=
17/05/02 23:06:41 CUST [2017/05/02 9:06:41 ET]
Table 'Telephus' 9-max Seat #1 is the button
Seat 1: the_wickstar ($1.22 in chips)=20
Seat 2: Maybe qwer ($1.56 in chips)=20
Seat 3: brulterier ($0.80 in chips)=20
Seat 4: TrueLargen ($2 in chips)=20
Seat 6: IceAngel82 ($2.98 in chips)=20
Seat 7: mimi93731 ($0.91 in chips)=20
Seat 8: 1tillit1 ($2.32 in chips)=20
Seat 9: smilie0123 ($2 in chips)=20
Maybe qwer: posts small blind $0.01
brulterier: posts big blind $0.02
RG&JP5: sits out=20
*** HOLE CARDS ***
Dealt to the_wickstar [6s Ah]
TrueLargen: raises $0.04 to $0.06
IceAngel82: folds=20
mimi93731: folds=20
1tillit1: folds=20
smilie0123: calls $0.06
the_wickstar: folds=20
Maybe qwer: calls $0.05
brulterier: calls $0.04
*** FLOP *** [4s 5h 7d]
Maybe qwer: checks=20
brulterier: checks=20
TrueLargen: checks=20
smilie0123: bets $0.16
Maybe qwer: folds=20
brulterier: folds=20
TrueLargen: folds=20
Uncalled bet ($0.16) returned to smilie0123
smilie0123 collected $0.23 from pot
smilie0123: doesn't show hand=20
*** SUMMARY ***
Total pot $0.24 | Rake $0.01=20
Board [4s 5h 7d]
Seat 1: the_wickstar (button) folded before Flop (didn't bet)
Seat 2: Maybe qwer (small blind) folded on the Flop
Seat 3: brulterier (big blind) folded on the Flop
Seat 4: TrueLargen folded on the Flop
Seat 6: IceAngel82 folded before Flop (didn't bet)
Seat 7: mimi93731 folded before Flop (didn't bet)
Seat 8: 1tillit1 folded before Flop (didn't bet)
Seat 9: smilie0123 collected ($0.23)


*********** # 120 **************
PokerStars Hand #169850448366:  Hold'em No Limit ($0.01/$0.02 USD) - 20=
17/05/02 23:06:15 CUST [2017/05/02 9:06:15 ET]
Table 'Botha' 9-max Seat #3 is the button
Seat 1: zartovskiy ($2.49 in chips)=20
Seat 2: PAMEGERA ($2.61 in chips)=20
Seat 3: Sprut2013 ($3.16 in chips)=20
Seat 4: Leopoker888 ($2 in chips)=20
Seat 5: Tikinh00 ($2.16 in chips)=20
Seat 6: diment76 ($1.91 in chips)=20
Seat 7: the_wickstar ($2.03 in chips)=20
Seat 8: Dooley121 ($1.43 in chips)=20
Seat 9: Demonidze31 ($2 in chips)=20
Leopoker888: posts small blind $0.01
Tikinh00: posts big blind $0.02
*** HOLE CARDS ***
Dealt to the_wickstar [3d 6s]
diment76: folds=20
the_wickstar: folds=20
Dooley121: calls $0.02
Demonidze31: folds=20
zartovskiy: folds=20
PAMEGERA: folds=20
Sprut2013: folds=20
Leopoker888: calls $0.01
Tikinh00: checks=20
*** FLOP *** [6h 8s Td]
Leopoker888: checks=20
Tikinh00: bets $0.03
Dooley121: calls $0.03
Leopoker888: folds=20
*** TURN *** [6h 8s Td] [Ac]
Tikinh00: checks=20
Dooley121: checks=20
*** RIVER *** [6h 8s Td Ac] [8h]
Tikinh00: bets $0.06
Dooley121: calls $0.06
*** SHOW DOWN ***
Tikinh00: shows [Th Kc] (two pair, Tens and Eights)
Dooley121: shows [Tc 9c] (two pair, Tens and Eights)
Tikinh00 collected $0.12 from pot
Dooley121 collected $0.11 from pot
*** SUMMARY ***
Total pot $0.24 | Rake $0.01=20
Board [6h 8s Td Ac 8h]
Seat 1: zartovskiy folded before Flop (didn't bet)
Seat 2: PAMEGERA folded before Flop (didn't bet)
Seat 3: Sprut2013 (button) folded before Flop (didn't bet)
Seat 4: Leopoker888 (small blind) folded on the Flop
Seat 5: Tikinh00 (big blind) showed [Th Kc] and won ($0.12) with two pa=
ir, Tens and Eights
Seat 6: diment76 folded before Flop (didn't bet)
Seat 7: the_wickstar folded before Flop (didn't bet)
Seat 8: Dooley121 showed [Tc 9c] and won ($0.11) with two pair, Tens an=
d Eights
Seat 9: Demonidze31 folded before Flop (didn't bet)


*********** # 121 **************
PokerStars Hand #169850438489:  Hold'em No Limit ($0.01/$0.02 USD) - 20=
17/05/02 23:05:56 CUST [2017/05/02 9:05:56 ET]
Table 'Telephus' 9-max Seat #9 is the button
Seat 1: the_wickstar ($1.23 in chips)=20
Seat 2: Maybe qwer ($1.58 in chips)=20
Seat 4: TrueLargen ($2 in chips)=20
Seat 6: IceAngel82 ($2.98 in chips)=20
Seat 7: mimi93731 ($0.91 in chips)=20
Seat 8: 1tillit1 ($2.29 in chips)=20
Seat 9: smilie0123 ($2 in chips)=20
the_wickstar: posts small blind $0.01
Maybe qwer: posts big blind $0.02
brulterier: sits out=20
RG&JP5: sits out=20
*** HOLE CARDS ***
Dealt to the_wickstar [5d 5c]
TrueLargen: folds=20
IceAngel82: folds=20
mimi93731: folds=20
1tillit1: raises $0.04 to $0.06
smilie0123: folds=20
the_wickstar: folds=20
Maybe qwer: folds=20
Uncalled bet ($0.04) returned to 1tillit1
1tillit1 collected $0.05 from pot
1tillit1: doesn't show hand=20
*** SUMMARY ***
Total pot $0.05 | Rake $0=20
Seat 1: the_wickstar (small blind) folded before Flop
Seat 2: Maybe qwer (big blind) folded before Flop
Seat 4: TrueLargen folded before Flop (didn't bet)
Seat 6: IceAngel82 folded before Flop (didn't bet)
Seat 7: mimi93731 folded before Flop (didn't bet)
Seat 8: 1tillit1 collected ($0.05)
Seat 9: smilie0123 (button) folded before Flop (didn't bet)


*********** # 122 **************
PokerStars Hand #169850429911:  Hold'em No Limit ($0.01/$0.02 USD) - 20=
17/05/02 23:05:39 CUST [2017/05/02 9:05:39 ET]
Table 'Botha' 9-max Seat #2 is the button
Seat 1: zartovskiy ($2.36 in chips)=20
Seat 2: PAMEGERA ($2.61 in chips)=20
Seat 3: Sprut2013 ($3.17 in chips)=20
Seat 4: Leopoker888 ($2 in chips)=20
Seat 5: Tikinh00 ($2.25 in chips)=20
Seat 6: diment76 ($1.91 in chips)=20
Seat 7: the_wickstar ($2.03 in chips)=20
Seat 8: Dooley121 ($1.45 in chips)=20
Seat 9: Demonidze31 ($2 in chips)=20
Sprut2013: posts small blind $0.01
Leopoker888: posts big blind $0.02
*** HOLE CARDS ***
Dealt to the_wickstar [6c 3s]
Tikinh00: calls $0.02
diment76: folds=20
the_wickstar: folds=20
Dooley121: calls $0.02
Demonidze31: folds=20
zartovskiy: raises $0.07 to $0.09
PAMEGERA: folds=20
Sprut2013: folds=20
Leopoker888: folds=20
Tikinh00: calls $0.07
Dooley121: folds=20
*** FLOP *** [3h Tc 6h]
Tikinh00: checks=20
zartovskiy: bets $0.12
Tikinh00: folds=20
Uncalled bet ($0.12) returned to zartovskiy
zartovskiy collected $0.22 from pot
zartovskiy: doesn't show hand=20
*** SUMMARY ***
Total pot $0.23 | Rake $0.01=20
Board [3h Tc 6h]
Seat 1: zartovskiy collected ($0.22)
Seat 2: PAMEGERA (button) folded before Flop (didn't bet)
Seat 3: Sprut2013 (small blind) folded before Flop
Seat 4: Leopoker888 (big blind) folded before Flop
Seat 5: Tikinh00 folded on the Flop
Seat 6: diment76 folded before Flop (didn't bet)
Seat 7: the_wickstar folded before Flop (didn't bet)
Seat 8: Dooley121 folded before Flop
Seat 9: Demonidze31 folded before Flop (didn't bet)


*********** # 123 **************
PokerStars Hand #169850426137:  Hold'em No Limit ($0.01/$0.02 USD) - 20=
17/05/02 23:05:31 CUST [2017/05/02 9:05:31 ET]
Table 'Telephus' 9-max Seat #8 is the button
Seat 1: the_wickstar ($1.25 in chips)=20
Seat 2: Maybe qwer ($1.58 in chips)=20
Seat 4: TrueLargen ($2 in chips)=20
Seat 6: IceAngel82 ($2.98 in chips)=20
Seat 7: mimi93731 ($0.91 in chips)=20
Seat 8: 1tillit1 ($2.26 in chips)=20
Seat 9: smilie0123 ($2 in chips)=20
smilie0123: posts small blind $0.01
the_wickstar: posts big blind $0.02
brulterier: sits out=20
RG&JP5: sits out=20
*** HOLE CARDS ***
Dealt to the_wickstar [Ad 6s]
Maybe qwer: folds=20
TrueLargen: folds=20
IceAngel82: folds=20
mimi93731: folds=20
1tillit1: raises $0.03 to $0.05
smilie0123: folds=20
the_wickstar: folds=20
Uncalled bet ($0.03) returned to 1tillit1
1tillit1 collected $0.05 from pot
1tillit1: doesn't show hand=20
*** SUMMARY ***
Total pot $0.05 | Rake $0=20
Seat 1: the_wickstar (big blind) folded before Flop
Seat 2: Maybe qwer folded before Flop (didn't bet)
Seat 4: TrueLargen folded before Flop (didn't bet)
Seat 6: IceAngel82 folded before Flop (didn't bet)
Seat 7: mimi93731 folded before Flop (didn't bet)
Seat 8: 1tillit1 (button) collected ($0.05)
Seat 9: smilie0123 (small blind) folded before Flop


*********** # 124 **************
PokerStars Hand #169850407242:  Hold'em No Limit ($0.01/$0.02 USD) - 20=
17/05/02 23:04:55 CUST [2017/05/02 9:04:55 ET]
Table 'Telephus' 9-max Seat #7 is the button
Seat 1: the_wickstar ($1.25 in chips)=20
Seat 2: Maybe qwer ($1.58 in chips)=20
Seat 4: TrueLargen ($2 in chips)=20
Seat 6: IceAngel82 ($2.98 in chips)=20
Seat 7: mimi93731 ($0.88 in chips)=20
Seat 8: 1tillit1 ($2.27 in chips)=20
Seat 9: smilie0123 ($2 in chips)=20
1tillit1: posts small blind $0.01
smilie0123: posts big blind $0.02
brulterier: sits out=20
*** HOLE CARDS ***
Dealt to the_wickstar [5c Td]
the_wickstar: folds=20
Maybe qwer: folds=20
TrueLargen: folds=20
IceAngel82: folds=20
mimi93731: raises $0.04 to $0.06
1tillit1: folds=20
smilie0123: folds=20
Uncalled bet ($0.04) returned to mimi93731
mimi93731 collected $0.05 from pot
*** SUMMARY ***
Total pot $0.05 | Rake $0=20
Seat 1: the_wickstar folded before Flop (didn't bet)
Seat 2: Maybe qwer folded before Flop (didn't bet)
Seat 4: TrueLargen folded before Flop (didn't bet)
Seat 6: IceAngel82 folded before Flop (didn't bet)
Seat 7: mimi93731 (button) collected ($0.05)
Seat 8: 1tillit1 (small blind) folded before Flop
Seat 9: smilie0123 (big blind) folded before Flop


*********** # 125 **************
PokerStars Hand #169850402300:  Hold'em No Limit ($0.01/$0.02 USD) - 20=
17/05/02 23:04:45 CUST [2017/05/02 9:04:45 ET]
Table 'Botha' 9-max Seat #1 is the button
Seat 1: zartovskiy ($2.36 in chips)=20
Seat 2: PAMEGERA ($2.62 in chips)=20
Seat 3: Sprut2013 ($3.14 in chips)=20
Seat 5: Tikinh00 ($2.25 in chips)=20
Seat 6: diment76 ($1.93 in chips)=20
Seat 7: the_wickstar ($2.03 in chips)=20
Seat 8: Dooley121 ($1.45 in chips)=20
Seat 9: Demonidze31 ($2 in chips)=20
PAMEGERA: posts small blind $0.01
Sprut2013: posts big blind $0.02
Leopoker888: sits out=20
*** HOLE CARDS ***
Dealt to the_wickstar [2h 4h]
Tikinh00: folds=20
diment76: calls $0.02
the_wickstar: folds=20
Dooley121: folds=20
Demonidze31: folds=20
zartovskiy: folds=20
PAMEGERA: folds=20
Sprut2013: checks=20
*** FLOP *** [8s Kc 5h]
Sprut2013: checks=20
diment76: checks=20
*** TURN *** [8s Kc 5h] [6h]
Sprut2013: bets $0.02
diment76: folds=20
Uncalled bet ($0.02) returned to Sprut2013
Sprut2013 collected $0.05 from pot
Sprut2013: doesn't show hand=20
*** SUMMARY ***
Total pot $0.05 | Rake $0=20
Board [8s Kc 5h 6h]
Seat 1: zartovskiy (button) folded before Flop (didn't bet)
Seat 2: PAMEGERA (small blind) folded before Flop
Seat 3: Sprut2013 (big blind) collected ($0.05)
Seat 5: Tikinh00 folded before Flop (didn't bet)
Seat 6: diment76 folded on the Turn
Seat 7: the_wickstar folded before Flop (didn't bet)
Seat 8: Dooley121 folded before Flop (didn't bet)
Seat 9: Demonidze31 folded before Flop (didn't bet)


*********** # 126 **************
PokerStars Hand #169850384340:  Hold'em No Limit ($0.01/$0.02 USD) - 20=
17/05/02 23:04:10 CUST [2017/05/02 9:04:10 ET]
Table 'Telephus' 9-max Seat #6 is the button
Seat 1: the_wickstar ($1.19 in chips)=20
Seat 2: Maybe qwer ($1.58 in chips)=20
Seat 4: TrueLargen ($2 in chips)=20
Seat 6: IceAngel82 ($2.98 in chips)=20
Seat 7: mimi93731 ($0.89 in chips)=20
Seat 8: 1tillit1 ($2.32 in chips)=20
Seat 9: smilie0123 ($2 in chips)=20
mimi93731: posts small blind $0.01
1tillit1: posts big blind $0.02
brulterier: sits out=20
*** HOLE CARDS ***
Dealt to the_wickstar [Ks Th]
smilie0123: folds=20
the_wickstar: calls $0.02
Maybe qwer: folds=20
TrueLargen: folds=20
IceAngel82: folds=20
mimi93731: folds=20
1tillit1: checks=20
*** FLOP *** [Kd Kh Jd]
1tillit1: bets $0.03
the_wickstar: raises $0.03 to $0.06
1tillit1: folds=20
Uncalled bet ($0.03) returned to the_wickstar
the_wickstar collected $0.11 from pot
*** SUMMARY ***
Total pot $0.11 | Rake $0=20
Board [Kd Kh Jd]
Seat 1: the_wickstar collected ($0.11)
Seat 2: Maybe qwer folded before Flop (didn't bet)
Seat 4: TrueLargen folded before Flop (didn't bet)
Seat 6: IceAngel82 (button) folded before Flop (didn't bet)
Seat 7: mimi93731 (small blind) folded before Flop
Seat 8: 1tillit1 (big blind) folded on the Flop
Seat 9: smilie0123 folded before Flop (didn't bet)


*********** # 127 **************
PokerStars Hand #169850369907:  Hold'em No Limit ($0.01/$0.02 USD) - 20=
17/05/02 23:03:42 CUST [2017/05/02 9:03:42 ET]
Table 'Botha' 9-max Seat #9 is the button
Seat 1: zartovskiy ($2.37 in chips)=20
Seat 2: PAMEGERA ($2.64 in chips)=20
Seat 3: Sprut2013 ($3.18 in chips)=20
Seat 5: Tikinh00 ($2.18 in chips)=20
Seat 6: diment76 ($1.93 in chips)=20
Seat 7: the_wickstar ($2.03 in chips)=20
Seat 8: Dooley121 ($1.45 in chips)=20
Seat 9: Demonidze31 ($2 in chips)=20
zartovskiy: posts small blind $0.01
PAMEGERA: posts big blind $0.02
Leopoker888: sits out=20
*** HOLE CARDS ***
Dealt to the_wickstar [5h 3h]
Sprut2013: calls $0.02
Tikinh00: calls $0.02
diment76: folds=20
the_wickstar: folds=20
Dooley121: folds=20
Demonidze31: folds=20
zartovskiy: folds=20
PAMEGERA: checks=20
*** FLOP *** [2h 8h Ks]
PAMEGERA: checks=20
Sprut2013: checks=20
Tikinh00: checks=20
*** TURN *** [2h 8h Ks] [Qc]
PAMEGERA: checks=20
Sprut2013: checks=20
Tikinh00: bets $0.02
PAMEGERA: folds=20
Sprut2013: calls $0.02
*** RIVER *** [2h 8h Ks Qc] [6c]
Sprut2013: checks=20
Tikinh00: bets $0.06
Sprut2013: folds=20
Uncalled bet ($0.06) returned to Tikinh00
Tikinh00 collected $0.11 from pot
Tikinh00: doesn't show hand=20
*** SUMMARY ***
Total pot $0.11 | Rake $0=20
Board [2h 8h Ks Qc 6c]
Seat 1: zartovskiy (small blind) folded before Flop
Seat 2: PAMEGERA (big blind) folded on the Turn
Seat 3: Sprut2013 folded on the River
Seat 5: Tikinh00 collected ($0.11)
Seat 6: diment76 folded before Flop (didn't bet)
Seat 7: the_wickstar folded before Flop (didn't bet)
Seat 8: Dooley121 folded before Flop (didn't bet)
Seat 9: Demonidze31 (button) folded before Flop (didn't bet)


*********** # 128 **************
PokerStars Hand #169850346816:  Hold'em No Limit ($0.01/$0.02 USD) - 20=
17/05/02 23:02:57 CUST [2017/05/02 9:02:57 ET]
Table 'Telephus' 9-max Seat #4 is the button
Seat 1: the_wickstar ($1.14 in chips)=20
Seat 2: Maybe qwer ($1.60 in chips)=20
Seat 4: TrueLargen ($2 in chips)=20
Seat 6: IceAngel82 ($2.99 in chips)=20
Seat 7: mimi93731 ($0.91 in chips)=20
Seat 8: 1tillit1 ($2.32 in chips)=20
Seat 9: smilie0123 ($2 in chips)=20
RG&JP5 is disconnected=20
RG&JP5 has timed out while disconnected
RG&JP5: is sitting out=20
IceAngel82: posts small blind $0.01
mimi93731: posts big blind $0.02
brulterier: sits out=20
*** HOLE CARDS ***
Dealt to the_wickstar [Jc As]
1tillit1: folds=20
smilie0123: folds=20
the_wickstar: calls $0.02
Maybe qwer: calls $0.02
TrueLargen: folds=20
IceAngel82: folds=20
mimi93731: checks=20
*** FLOP *** [7s 8d 5d]
mimi93731: checks=20
the_wickstar: checks=20
Maybe qwer: checks=20
*** TURN *** [7s 8d 5d] [8h]
mimi93731: checks=20
the_wickstar: checks=20
Maybe qwer: checks=20
*** RIVER *** [7s 8d 5d 8h] [8c]
mimi93731: checks=20
the_wickstar: bets $0.05
Maybe qwer: folds=20
mimi93731: folds=20
Uncalled bet ($0.05) returned to the_wickstar
the_wickstar collected $0.07 from pot
*** SUMMARY ***
Total pot $0.07 | Rake $0=20
Board [7s 8d 5d 8h 8c]
Seat 1: the_wickstar collected ($0.07)
Seat 2: Maybe qwer folded on the River
Seat 4: TrueLargen (button) folded before Flop (didn't bet)
Seat 6: IceAngel82 (small blind) folded before Flop
Seat 7: mimi93731 (big blind) folded on the River
Seat 8: 1tillit1 folded before Flop (didn't bet)
Seat 9: smilie0123 folded before Flop (didn't bet)


*********** # 129 **************
PokerStars Hand #169850340704:  Hold'em No Limit ($0.01/$0.02 USD) - 20=
17/05/02 23:02:45 CUST [2017/05/02 9:02:45 ET]
Table 'Botha' 9-max Seat #8 is the button
Seat 1: zartovskiy ($2.39 in chips)=20
Seat 2: PAMEGERA ($2.64 in chips)=20
Seat 3: Sprut2013 ($3.18 in chips)=20
Seat 4: Vlad1slav S. ($2 in chips)=20
Seat 5: Tikinh00 ($2.18 in chips)=20
Seat 6: diment76 ($1.95 in chips)=20
Seat 7: the_wickstar ($2.03 in chips)=20
Seat 8: Dooley121 ($1.39 in chips)=20
Seat 9: Demonidze31 ($2 in chips)=20
Demonidze31: posts small blind $0.01
zartovskiy: posts big blind $0.02
*** HOLE CARDS ***
Dealt to the_wickstar [Kh 9c]
PAMEGERA: folds=20
Sprut2013: folds=20
Vlad1slav S.: folds=20
Vlad1slav S. leaves the table
Tikinh00: folds=20
diment76: calls $0.02
Leopoker888 joins the table at seat #4=20
the_wickstar: folds=20
Dooley121: calls $0.02
Demonidze31: calls $0.01
zartovskiy: checks=20
*** FLOP *** [8s As 6s]
Demonidze31: checks=20
zartovskiy: checks=20
diment76: checks=20
Dooley121: bets $0.02
Demonidze31: folds=20
zartovskiy: folds=20
diment76: folds=20
Uncalled bet ($0.02) returned to Dooley121
Dooley121 collected $0.08 from pot
*** SUMMARY ***
Total pot $0.08 | Rake $0=20
Board [8s As 6s]
Seat 1: zartovskiy (big blind) folded on the Flop
Seat 2: PAMEGERA folded before Flop (didn't bet)
Seat 3: Sprut2013 folded before Flop (didn't bet)
Seat 4: Vlad1slav S. folded before Flop (didn't bet)
Seat 5: Tikinh00 folded before Flop (didn't bet)
Seat 6: diment76 folded on the Flop
Seat 7: the_wickstar folded before Flop (didn't bet)
Seat 8: Dooley121 (button) collected ($0.08)
Seat 9: Demonidze31 (small blind) folded on the Flop


*********** # 130 **************
PokerStars Hand #169850328784:  Hold'em No Limit ($0.01/$0.02 USD) - 20=
17/05/02 23:02:22 CUST [2017/05/02 9:02:22 ET]
Table 'Telephus' 9-max Seat #2 is the button
Seat 1: the_wickstar ($1.14 in chips)=20
Seat 2: Maybe qwer ($1.74 in chips)=20
Seat 4: TrueLargen ($2 in chips)=20
Seat 5: RG&JP5 ($1.41 in chips)=20
Seat 6: IceAngel82 ($2.99 in chips)=20
Seat 7: mimi93731 ($0.75 in chips)=20
Seat 8: 1tillit1 ($2.32 in chips)=20
Seat 9: smilie0123 ($2 in chips)=20
brulterier will be allowed to play after the button
TrueLargen: posts small blind $0.01
RG&JP5: posts big blind $0.02
*** HOLE CARDS ***
Dealt to the_wickstar [4h 6c]
IceAngel82: folds=20
mimi93731: calls $0.02
1tillit1: folds=20
smilie0123: folds=20
the_wickstar: folds=20
Maybe qwer: raises $0.04 to $0.06
TrueLargen: folds=20
RG&JP5: folds=20
mimi93731: calls $0.04
*** FLOP *** [3d Jc Ts]
mimi93731: checks=20
Maybe qwer: checks=20
*** TURN *** [3d Jc Ts] [Qc]
mimi93731: bets $0.08
Maybe qwer: calls $0.08
*** RIVER *** [3d Jc Ts Qc] [Js]
mimi93731: bets $0.10
Maybe qwer: folds=20
Uncalled bet ($0.10) returned to mimi93731
mimi93731 collected $0.30 from pot
mimi93731: doesn't show hand=20
*** SUMMARY ***
Total pot $0.31 | Rake $0.01=20
Board [3d Jc Ts Qc Js]
Seat 1: the_wickstar folded before Flop (didn't bet)
Seat 2: Maybe qwer (button) folded on the River
Seat 4: TrueLargen (small blind) folded before Flop
Seat 5: RG&JP5 (big blind) folded before Flop
Seat 6: IceAngel82 folded before Flop (didn't bet)
Seat 7: mimi93731 collected ($0.30)
Seat 8: 1tillit1 folded before Flop (didn't bet)
Seat 9: smilie0123 folded before Flop (didn't bet)


*********** # 131 **************
PokerStars Hand #169850306816:  Hold'em No Limit ($0.01/$0.02 USD) - 20=
17/05/02 23:01:37 CUST [2017/05/02 9:01:37 ET]
Table 'Telephus' 9-max Seat #1 is the button
Seat 1: the_wickstar ($1.14 in chips)=20
Seat 2: Maybe qwer ($1.75 in chips)=20
Seat 4: TrueLargen ($2 in chips)=20
Seat 5: RG&JP5 ($1.41 in chips)=20
Seat 6: IceAngel82 ($2.89 in chips)=20
Seat 7: mimi93731 ($0.83 in chips)=20
Seat 8: 1tillit1 ($2.32 in chips)=20
Seat 9: smilie0123 ($2 in chips)=20
Maybe qwer: posts small blind $0.01
TrueLargen: posts big blind $0.02
*** HOLE CARDS ***
Dealt to the_wickstar [3s 2d]
brulterier joins the table at seat #3=20
RG&JP5: folds=20
IceAngel82: raises $0.04 to $0.06
mimi93731: calls $0.06
1tillit1: folds=20
smilie0123: folds=20
the_wickstar: folds=20
Maybe qwer: folds=20
TrueLargen: folds=20
*** FLOP *** [7h As 2s]
IceAngel82: checks=20
mimi93731: checks=20
*** TURN *** [7h As 2s] [6d]
IceAngel82: checks=20
mimi93731: bets $0.02
IceAngel82: calls $0.02
*** RIVER *** [7h As 2s 6d] [Ac]
IceAngel82: checks=20
mimi93731: checks=20
*** SHOW DOWN ***
IceAngel82: shows [Th Td] (two pair, Aces and Tens)
mimi93731: mucks hand=20
IceAngel82 collected $0.18 from pot
*** SUMMARY ***
Total pot $0.19 | Rake $0.01=20
Board [7h As 2s 6d Ac]
Seat 1: the_wickstar (button) folded before Flop (didn't bet)
Seat 2: Maybe qwer (small blind) folded before Flop
Seat 4: TrueLargen (big blind) folded before Flop
Seat 5: RG&JP5 folded before Flop (didn't bet)
Seat 6: IceAngel82 showed [Th Td] and won ($0.18) with two pair, Aces a=
nd Tens
Seat 7: mimi93731 mucked [6h 5h]
Seat 8: 1tillit1 folded before Flop (didn't bet)
Seat 9: smilie0123 folded before Flop (didn't bet)


*********** # 132 **************
PokerStars Hand #169850304905:  Hold'em No Limit ($0.01/$0.02 USD) - 20=
17/05/02 23:01:33 CUST [2017/05/02 9:01:33 ET]
Table 'Botha' 9-max Seat #7 is the button
Seat 1: zartovskiy ($2.57 in chips)=20
Seat 2: PAMEGERA ($2.64 in chips)=20
Seat 3: Sprut2013 ($2.98 in chips)=20
Seat 4: Vlad1slav S. ($2 in chips)=20
Seat 5: Tikinh00 ($2.18 in chips)=20
Seat 6: diment76 ($1.95 in chips)=20
Seat 7: the_wickstar ($2.03 in chips)=20
Seat 8: Dooley121 ($1.40 in chips)=20
Seat 9: Demonidze31 ($2 in chips)=20
Dooley121: posts small blind $0.01
Demonidze31: posts big blind $0.02
*** HOLE CARDS ***
Dealt to the_wickstar [Kd 4s]
zartovskiy: raises $0.06 to $0.08
PAMEGERA: folds=20
Sprut2013: calls $0.08
Vlad1slav S.: folds=20
Tikinh00: folds=20
diment76: folds=20
the_wickstar: folds=20
Dooley121: folds=20
Demonidze31: folds=20
*** FLOP *** [5s Td 8s]
zartovskiy: bets $0.10
Sprut2013: calls $0.10
*** TURN *** [5s Td 8s] [4d]
zartovskiy: checks=20
Sprut2013: bets $0.19
zartovskiy: folds=20
Uncalled bet ($0.19) returned to Sprut2013
Sprut2013 collected $0.38 from pot
Sprut2013: doesn't show hand=20
*** SUMMARY ***
Total pot $0.39 | Rake $0.01=20
Board [5s Td 8s 4d]
Seat 1: zartovskiy folded on the Turn
Seat 2: PAMEGERA folded before Flop (didn't bet)
Seat 3: Sprut2013 collected ($0.38)
Seat 4: Vlad1slav S. folded before Flop (didn't bet)
Seat 5: Tikinh00 folded before Flop (didn't bet)
Seat 6: diment76 folded before Flop (didn't bet)
Seat 7: the_wickstar (button) folded before Flop (didn't bet)
Seat 8: Dooley121 (small blind) folded before Flop
Seat 9: Demonidze31 (big blind) folded before Flop


*********** # 133 **************
PokerStars Hand #169850294541:  Hold'em No Limit ($0.01/$0.02 USD) - 20=
17/05/02 23:01:12 CUST [2017/05/02 9:01:12 ET]
Table 'Telephus' 9-max Seat #9 is the button
Seat 1: the_wickstar ($1.15 in chips)=20
Seat 2: Maybe qwer ($1.74 in chips)=20
Seat 3: ILbIO4A ($5.37 in chips)=20
Seat 4: TrueLargen ($2 in chips)=20
Seat 5: RG&JP5 ($1.41 in chips)=20
Seat 6: IceAngel82 ($2.89 in chips)=20
Seat 7: mimi93731 ($0.83 in chips)=20
Seat 8: 1tillit1 ($2.32 in chips)=20
Seat 9: smilie0123 ($2 in chips)=20
the_wickstar: posts small blind $0.01
Maybe qwer: posts big blind $0.02
*** HOLE CARDS ***
Dealt to the_wickstar [As 9c]
ILbIO4A: folds=20
ILbIO4A leaves the table
TrueLargen: folds=20
RG&JP5: folds=20
IceAngel82: folds=20
mimi93731: folds=20
1tillit1: folds=20
smilie0123: folds=20
the_wickstar: folds=20
Uncalled bet ($0.01) returned to Maybe qwer
Maybe qwer collected $0.02 from pot
*** SUMMARY ***
Total pot $0.02 | Rake $0=20
Seat 1: the_wickstar (small blind) folded before Flop
Seat 2: Maybe qwer (big blind) collected ($0.02)
Seat 3: ILbIO4A folded before Flop (didn't bet)
Seat 4: TrueLargen folded before Flop (didn't bet)
Seat 5: RG&JP5 folded before Flop (didn't bet)
Seat 6: IceAngel82 folded before Flop (didn't bet)
Seat 7: mimi93731 folded before Flop (didn't bet)
Seat 8: 1tillit1 folded before Flop (didn't bet)
Seat 9: smilie0123 (button) folded before Flop (didn't bet)


*********** # 134 **************
PokerStars Hand #169850289358:  Hold'em No Limit ($0.01/$0.02 USD) - 20=
17/05/02 23:01:02 CUST [2017/05/02 9:01:02 ET]
Table 'Botha' 9-max Seat #6 is the button
Seat 1: zartovskiy ($2.57 in chips)=20
Seat 2: PAMEGERA ($2.64 in chips)=20
Seat 3: Sprut2013 ($2.98 in chips)=20
Seat 4: Vlad1slav S. ($2.05 in chips)=20
Seat 5: Tikinh00 ($2.18 in chips)=20
Seat 6: diment76 ($1.95 in chips)=20
Seat 7: the_wickstar ($2.04 in chips)=20
Seat 8: Dooley121 ($1.33 in chips)=20
the_wickstar: posts small blind $0.01
Dooley121: posts big blind $0.02
Demonidze31: sits out=20
*** HOLE CARDS ***
Dealt to the_wickstar [5h 7s]
zartovskiy: folds=20
PAMEGERA: folds=20
Sprut2013: folds=20
Vlad1slav S.: raises $0.04 to $0.06
Tikinh00: folds=20
diment76: folds=20
the_wickstar: folds=20
Dooley121: calls $0.04
*** FLOP *** [Qc Js Kc]
Dooley121: bets $1.27 and is all-in
Vlad1slav S.: folds=20
Uncalled bet ($1.27) returned to Dooley121
Dooley121 collected $0.13 from pot
*** SUMMARY ***
Total pot $0.13 | Rake $0=20
Board [Qc Js Kc]
Seat 1: zartovskiy folded before Flop (didn't bet)
Seat 2: PAMEGERA folded before Flop (didn't bet)
Seat 3: Sprut2013 folded before Flop (didn't bet)
Seat 4: Vlad1slav S. folded on the Flop
Seat 5: Tikinh00 folded before Flop (didn't bet)
Seat 6: diment76 (button) folded before Flop (didn't bet)
Seat 7: the_wickstar (small blind) folded before Flop
Seat 8: Dooley121 (big blind) collected ($0.13)


*********** # 135 **************
PokerStars Hand #169850280255:  Hold'em No Limit ($0.01/$0.02 USD) - 20=
17/05/02 23:00:43 CUST [2017/05/02 9:00:43 ET]
Table 'Telephus' 9-max Seat #8 is the button
Seat 1: the_wickstar ($1.14 in chips)=20
Seat 2: Maybe qwer ($1.74 in chips)=20
Seat 3: ILbIO4A ($5.37 in chips)=20
Seat 4: TrueLargen ($2 in chips)=20
Seat 5: RG&JP5 ($1.41 in chips)=20
Seat 6: IceAngel82 ($2.89 in chips)=20
Seat 7: mimi93731 ($0.83 in chips)=20
Seat 8: 1tillit1 ($2.32 in chips)=20
Seat 9: smilie0123 ($2 in chips)=20
smilie0123: posts small blind $0.01
the_wickstar: posts big blind $0.02
*** HOLE CARDS ***
Dealt to the_wickstar [3s 7c]
Maybe qwer: folds=20
ILbIO4A: folds=20
TrueLargen: folds=20
RG&JP5: folds=20
IceAngel82: folds=20
mimi93731: folds=20
1tillit1: folds=20
smilie0123: folds=20
Uncalled bet ($0.01) returned to the_wickstar
the_wickstar collected $0.02 from pot
*** SUMMARY ***
Total pot $0.02 | Rake $0=20
Seat 1: the_wickstar (big blind) collected ($0.02)
Seat 2: Maybe qwer folded before Flop (didn't bet)
Seat 3: ILbIO4A folded before Flop (didn't bet)
Seat 4: TrueLargen folded before Flop (didn't bet)
Seat 5: RG&JP5 folded before Flop (didn't bet)
Seat 6: IceAngel82 folded before Flop (didn't bet)
Seat 7: mimi93731 folded before Flop (didn't bet)
Seat 8: 1tillit1 (button) folded before Flop (didn't bet)
Seat 9: smilie0123 (small blind) folded before Flop


*********** # 136 **************
PokerStars Hand #169850274342:  Hold'em No Limit ($0.01/$0.02 USD) - 20=
17/05/02 23:00:30 CUST [2017/05/02 9:00:30 ET]
Table 'Botha' 9-max Seat #5 is the button
Seat 1: zartovskiy ($2.57 in chips)=20
Seat 2: PAMEGERA ($2.64 in chips)=20
Seat 3: Sprut2013 ($2.95 in chips)=20
Seat 4: Vlad1slav S. ($2.05 in chips)=20
Seat 5: Tikinh00 ($2.18 in chips)=20
Seat 6: diment76 ($1.96 in chips)=20
Seat 7: the_wickstar ($2.06 in chips)=20
Seat 8: Dooley121 ($1.33 in chips)=20
diment76: posts small blind $0.01
the_wickstar: posts big blind $0.02
Demonidze31: sits out=20
*** HOLE CARDS ***
Dealt to the_wickstar [Th 2c]
Dooley121: folds=20
zartovskiy: folds=20
PAMEGERA: folds=20
Sprut2013: raises $0.04 to $0.06
Vlad1slav S.: folds=20
Tikinh00: folds=20
diment76: folds=20
the_wickstar: folds=20
Uncalled bet ($0.04) returned to Sprut2013
Sprut2013 collected $0.05 from pot
Sprut2013: doesn't show hand=20
*** SUMMARY ***
Total pot $0.05 | Rake $0=20
Seat 1: zartovskiy folded before Flop (didn't bet)
Seat 2: PAMEGERA folded before Flop (didn't bet)
Seat 3: Sprut2013 collected ($0.05)
Seat 4: Vlad1slav S. folded before Flop (didn't bet)
Seat 5: Tikinh00 (button) folded before Flop (didn't bet)
Seat 6: diment76 (small blind) folded before Flop
Seat 7: the_wickstar (big blind) folded before Flop
Seat 8: Dooley121 folded before Flop (didn't bet)


*********** # 137 **************
PokerStars Hand #169850244781:  Hold'em No Limit ($0.01/$0.02 USD) - 20=
17/05/02 22:59:25 CUST [2017/05/02 8:59:25 ET]
Table 'Botha' 9-max Seat #4 is the button
Seat 1: zartovskiy ($2.57 in chips)=20
Seat 2: PAMEGERA ($2.64 in chips)=20
Seat 3: Sprut2013 ($2.95 in chips)=20
Seat 4: Vlad1slav S. ($2.05 in chips)=20
Seat 5: Tikinh00 ($2.20 in chips)=20
Seat 6: diment76 ($1.90 in chips)=20
Seat 7: the_wickstar ($2.06 in chips)=20
Seat 8: Dooley121 ($1.37 in chips)=20
Tikinh00: posts small blind $0.01
diment76: posts big blind $0.02
Demonidze31: sits out=20
*** HOLE CARDS ***
Dealt to the_wickstar [6s Tc]
the_wickstar: folds=20
Dooley121: calls $0.02
zartovskiy: folds=20
PAMEGERA: folds=20
Sprut2013: folds=20
Vlad1slav S.: folds=20
Tikinh00: calls $0.01
diment76: checks=20
*** FLOP *** [Kh Th Ac]
Tikinh00: checks=20
diment76: checks=20
Dooley121: bets $0.02
Tikinh00: folds=20
diment76: calls $0.02
*** TURN *** [Kh Th Ac] [9c]
diment76: checks=20
Dooley121: checks=20
*** RIVER *** [Kh Th Ac 9c] [9d]
diment76: checks=20
Dooley121: checks=20
*** SHOW DOWN ***
diment76: shows [5h Kd] (two pair, Kings and Nines)
Dooley121: mucks hand=20
diment76 collected $0.10 from pot
*** SUMMARY ***
Total pot $0.10 | Rake $0=20
Board [Kh Th Ac 9c 9d]
Seat 1: zartovskiy folded before Flop (didn't bet)
Seat 2: PAMEGERA folded before Flop (didn't bet)
Seat 3: Sprut2013 folded before Flop (didn't bet)
Seat 4: Vlad1slav S. (button) folded before Flop (didn't bet)
Seat 5: Tikinh00 (small blind) folded on the Flop
Seat 6: diment76 (big blind) showed [5h Kd] and won ($0.10) with two pa=
ir, Kings and Nines
Seat 7: the_wickstar folded before Flop (didn't bet)
Seat 8: Dooley121 mucked [Jh 7c]


*********** # 138 **************
PokerStars Hand #169850244102:  Hold'em No Limit ($0.01/$0.02 USD) - 20=
17/05/02 22:59:24 CUST [2017/05/02 8:59:24 ET]
Table 'Telephus' 9-max Seat #7 is the button
Seat 1: the_wickstar ($1.16 in chips)=20
Seat 2: Maybe qwer ($1.74 in chips)=20
Seat 3: ILbIO4A ($5.37 in chips)=20
Seat 4: TrueLargen ($2 in chips)=20
Seat 5: RG&JP5 ($1.41 in chips)=20
Seat 6: IceAngel82 ($2.91 in chips)=20
Seat 7: mimi93731 ($0.74 in chips)=20
Seat 8: 1tillit1 ($2.33 in chips)=20
Seat 9: smilie0123 ($2 in chips)=20
1tillit1: posts small blind $0.01
smilie0123: posts big blind $0.02
TrueLargen: posts big blind $0.02
*** HOLE CARDS ***
Dealt to the_wickstar [Js As]
the_wickstar: calls $0.02
Maybe qwer: folds=20
ILbIO4A: folds=20
TrueLargen: checks=20
RG&JP5 is connected=20
RG&JP5: folds=20
IceAngel82: calls $0.02
mimi93731: raises $0.10 to $0.12
1tillit1: folds=20
smilie0123: folds=20
the_wickstar: folds=20
TrueLargen: folds=20
IceAngel82: folds=20
Uncalled bet ($0.10) returned to mimi93731
mimi93731 collected $0.11 from pot
*** SUMMARY ***
Total pot $0.11 | Rake $0=20
Seat 1: the_wickstar folded before Flop
Seat 2: Maybe qwer folded before Flop (didn't bet)
Seat 3: ILbIO4A folded before Flop (didn't bet)
Seat 4: TrueLargen folded before Flop
Seat 5: RG&JP5 folded before Flop (didn't bet)
Seat 6: IceAngel82 folded before Flop
Seat 7: mimi93731 (button) collected ($0.11)
Seat 8: 1tillit1 (small blind) folded before Flop
Seat 9: smilie0123 (big blind) folded before Flop


*********** # 139 **************
PokerStars Hand #169850221570:  Hold'em No Limit ($0.01/$0.02 USD) - 20=
17/05/02 22:58:34 CUST [2017/05/02 8:58:34 ET]
Table 'Telephus' 9-max Seat #6 is the button
Seat 1: the_wickstar ($1.12 in chips)=20
Seat 2: Maybe qwer ($1.74 in chips)=20
Seat 3: ILbIO4A ($5.37 in chips)=20
Seat 5: RG&JP5 ($1.41 in chips)=20
Seat 6: IceAngel82 ($2.91 in chips)=20
Seat 7: mimi93731 ($0.76 in chips)=20
Seat 8: 1tillit1 ($2.35 in chips)=20
mimi93731: posts small blind $0.01
1tillit1: posts big blind $0.02
smilie0123: sits out=20
TrueLargen: sits out=20
*** HOLE CARDS ***
Dealt to the_wickstar [Qs Kc]
the_wickstar: calls $0.02
Maybe qwer: folds=20
ILbIO4A: folds=20
RG&JP5: folds=20
IceAngel82: folds=20
mimi93731: calls $0.01
1tillit1: checks=20
*** FLOP *** [Jd 3h Ks]
mimi93731: checks=20
1tillit1: checks=20
the_wickstar: bets $0.06
mimi93731: folds=20
1tillit1: folds=20
Uncalled bet ($0.06) returned to the_wickstar
the_wickstar collected $0.06 from pot
*** SUMMARY ***
Total pot $0.06 | Rake $0=20
Board [Jd 3h Ks]
Seat 1: the_wickstar collected ($0.06)
Seat 2: Maybe qwer folded before Flop (didn't bet)
Seat 3: ILbIO4A folded before Flop (didn't bet)
Seat 5: RG&JP5 folded before Flop (didn't bet)
Seat 6: IceAngel82 (button) folded before Flop (didn't bet)
Seat 7: mimi93731 (small blind) folded on the Flop
Seat 8: 1tillit1 (big blind) folded on the Flop


*********** # 140 **************
PokerStars Hand #169850209504:  Hold'em No Limit ($0.01/$0.02 USD) - 20=
17/05/02 22:58:07 CUST [2017/05/02 8:58:07 ET]
Table 'Botha' 9-max Seat #3 is the button
Seat 1: zartovskiy ($2.57 in chips)=20
Seat 2: PAMEGERA ($2.74 in chips)=20
Seat 3: Sprut2013 ($2.95 in chips)=20
Seat 4: Vlad1slav S. ($2.06 in chips)=20
Seat 5: Tikinh00 ($1.31 in chips)=20
Seat 6: diment76 ($1.90 in chips)=20
Seat 7: the_wickstar ($2.06 in chips)=20
Seat 8: Dooley121 ($2.21 in chips)=20
Vlad1slav S.: posts small blind $0.01
Tikinh00: posts big blind $0.02
Demonidze31: sits out=20
*** HOLE CARDS ***
Dealt to the_wickstar [8s Ad]
diment76: folds=20
the_wickstar: folds=20
Dooley121: calls $0.02
zartovskiy: folds=20
PAMEGERA: raises $0.08 to $0.10
Sprut2013: folds=20
Vlad1slav S.: folds=20
Tikinh00: calls $0.08
Dooley121: calls $0.08
*** FLOP *** [5h 6h Js]
Tikinh00: checks=20
Dooley121: checks=20
PAMEGERA: checks=20
*** TURN *** [5h 6h Js] [4h]
Tikinh00: checks=20
Dooley121: bets $0.15
PAMEGERA: folds=20
Tikinh00: calls $0.15
*** RIVER *** [5h 6h Js 4h] [6d]
Tikinh00: checks=20
Dooley121: bets $0.59
Tikinh00: calls $0.59
*** SHOW DOWN ***
Dooley121: shows [Tc Kh] (a pair of Sixes)
Tikinh00: shows [9s 9h] (two pair, Nines and Sixes)
Tikinh00 collected $1.73 from pot
*** SUMMARY ***
Total pot $1.79 | Rake $0.06=20
Board [5h 6h Js 4h 6d]
Seat 1: zartovskiy folded before Flop (didn't bet)
Seat 2: PAMEGERA folded on the Turn
Seat 3: Sprut2013 (button) folded before Flop (didn't bet)
Seat 4: Vlad1slav S. (small blind) folded before Flop
Seat 5: Tikinh00 (big blind) showed [9s 9h] and won ($1.73) with two pa=
ir, Nines and Sixes
Seat 6: diment76 folded before Flop (didn't bet)
Seat 7: the_wickstar folded before Flop (didn't bet)
Seat 8: Dooley121 showed [Tc Kh] and lost with a pair of Sixes


*********** # 141 **************
PokerStars Hand #169850192167:  Hold'em No Limit ($0.01/$0.02 USD) - 20=
17/05/02 22:57:29 CUST [2017/05/02 8:57:29 ET]
Table 'Telephus' 9-max Seat #5 is the button
Seat 1: the_wickstar ($1.12 in chips)=20
Seat 2: Maybe qwer ($1.74 in chips)=20
Seat 3: ILbIO4A ($5.37 in chips)=20
Seat 5: RG&JP5 ($2.37 in chips)=20
Seat 6: IceAngel82 ($2 in chips)=20
Seat 7: mimi93731 ($0.78 in chips)=20
Seat 8: 1tillit1 ($2.35 in chips)=20
IceAngel82: posts small blind $0.01
mimi93731: posts big blind $0.02
smilie0123: sits out=20
LiLZhiMiNG: sits out=20
*** HOLE CARDS ***
Dealt to the_wickstar [5d 9c]
1tillit1: folds=20
the_wickstar: folds=20
Maybe qwer: folds=20
ILbIO4A: folds=20
RG&JP5: raises $0.04 to $0.06
LiLZhiMiNG leaves the table
IceAngel82: calls $0.05
mimi93731: folds=20
*** FLOP *** [7d As Js]
IceAngel82: checks=20
RG&JP5: bets $0.06
IceAngel82: calls $0.06
*** TURN *** [7d As Js] [6d]
IceAngel82: checks=20
RG&JP5: bets $0.12
IceAngel82: calls $0.12
*** RIVER *** [7d As Js 6d] [8d]
IceAngel82: checks=20
RG&JP5: bets $0.24
TrueLargen joins the table at seat #4=20
IceAngel82: raises $0.48 to $0.72
RG&JP5: calls $0.48
*** SHOW DOWN ***
IceAngel82: shows [Jd Kd] (a flush, King high)
RG&JP5: mucks hand=20
IceAngel82 collected $1.87 from pot
*** SUMMARY ***
Total pot $1.94 | Rake $0.07=20
Board [7d As Js 6d 8d]
Seat 1: the_wickstar folded before Flop (didn't bet)
Seat 2: Maybe qwer folded before Flop (didn't bet)
Seat 3: ILbIO4A folded before Flop (didn't bet)
Seat 5: RG&JP5 (button) mucked [8c 7c]
Seat 6: IceAngel82 (small blind) showed [Jd Kd] and won ($1.87) with a =
flush, King high
Seat 7: mimi93731 (big blind) folded before Flop
Seat 8: 1tillit1 folded before Flop (didn't bet)


*********** # 142 **************
PokerStars Hand #169850177817:  Hold'em No Limit ($0.01/$0.02 USD) - 20=
17/05/02 22:56:56 CUST [2017/05/02 8:56:56 ET]
Table 'Botha' 9-max Seat #2 is the button
Seat 1: zartovskiy ($2.46 in chips)=20
Seat 2: PAMEGERA ($2.74 in chips)=20
Seat 3: Sprut2013 ($2.96 in chips)=20
Seat 4: Vlad1slav S. ($2.15 in chips)=20
Seat 5: Tikinh00 ($1.33 in chips)=20
Seat 6: diment76 ($1.90 in chips)=20
Seat 7: the_wickstar ($2.06 in chips)=20
Seat 8: Dooley121 ($2.21 in chips)=20
Sprut2013: posts small blind $0.01
Vlad1slav S.: posts big blind $0.02
Demonidze31: sits out=20
*** HOLE CARDS ***
Dealt to the_wickstar [3s 9h]
Tikinh00: calls $0.02
diment76: folds=20
the_wickstar has timed out
the_wickstar: folds=20
Dooley121: folds=20
zartovskiy: raises $0.07 to $0.09
PAMEGERA: folds=20
Sprut2013: folds=20
Vlad1slav S.: calls $0.07
Tikinh00: folds=20
*** FLOP *** [Qh 4d 6h]
Vlad1slav S.: checks=20
zartovskiy: bets $0.15
Vlad1slav S.: folds=20
Uncalled bet ($0.15) returned to zartovskiy
zartovskiy collected $0.20 from pot
zartovskiy: doesn't show hand=20
*** SUMMARY ***
Total pot $0.21 | Rake $0.01=20
Board [Qh 4d 6h]
Seat 1: zartovskiy collected ($0.20)
Seat 2: PAMEGERA (button) folded before Flop (didn't bet)
Seat 3: Sprut2013 (small blind) folded before Flop
Seat 4: Vlad1slav S. (big blind) folded on the Flop
Seat 5: Tikinh00 folded before Flop
Seat 6: diment76 folded before Flop (didn't bet)
Seat 7: the_wickstar folded before Flop (didn't bet)
Seat 8: Dooley121 folded before Flop (didn't bet)


*********** # 143 **************
PokerStars Hand #169850168420:  Hold'em No Limit ($0.01/$0.02 USD) - 20=
17/05/02 22:56:35 CUST [2017/05/02 8:56:35 ET]
Table 'Telephus' 9-max Seat #3 is the button
Seat 1: the_wickstar ($1.12 in chips)=20
Seat 2: Maybe qwer ($1.74 in chips)=20
Seat 3: ILbIO4A ($5.37 in chips)=20
Seat 5: RG&JP5 ($2.38 in chips)=20
Seat 6: IceAngel82 ($2 in chips)=20
Seat 7: mimi93731 ($0.78 in chips)=20
Seat 8: 1tillit1 ($2.32 in chips)=20
LiLZhiMiNG will be allowed to play after the button
RG&JP5: posts small blind $0.01
IceAngel82: posts big blind $0.02
smilie0123: sits out=20
*** HOLE CARDS ***
Dealt to the_wickstar [Jd 5c]
mimi93731: folds=20
1tillit1: raises $0.05 to $0.07
the_wickstar: folds=20
Maybe qwer: folds=20
ILbIO4A: folds=20
RG&JP5: folds=20
IceAngel82: folds=20
Uncalled bet ($0.05) returned to 1tillit1
1tillit1 collected $0.05 from pot
1tillit1: doesn't show hand=20
*** SUMMARY ***
Total pot $0.05 | Rake $0=20
Seat 1: the_wickstar folded before Flop (didn't bet)
Seat 2: Maybe qwer folded before Flop (didn't bet)
Seat 3: ILbIO4A (button) folded before Flop (didn't bet)
Seat 5: RG&JP5 (small blind) folded before Flop
Seat 6: IceAngel82 (big blind) folded before Flop
Seat 7: mimi93731 folded before Flop (didn't bet)
Seat 8: 1tillit1 collected ($0.05)


*********** # 144 **************
PokerStars Hand #169850147290:  Hold'em No Limit ($0.01/$0.02 USD) - 20=
17/05/02 22:55:47 CUST [2017/05/02 8:55:47 ET]
Table 'Telephus' 9-max Seat #2 is the button
Seat 1: the_wickstar ($1.12 in chips)=20
Seat 2: Maybe qwer ($1.74 in chips)=20
Seat 3: ILbIO4A ($5.42 in chips)=20
Seat 5: RG&JP5 ($2.33 in chips)=20
Seat 6: IceAngel82 ($2 in chips)=20
Seat 7: mimi93731 ($0.78 in chips)=20
Seat 8: 1tillit1 ($2.32 in chips)=20
ILbIO4A: posts small blind $0.01
wilmago17: is sitting out=20
RG&JP5: posts big blind $0.02
wilmago17 leaves the table
smilie0123: sits out=20
*** HOLE CARDS ***
Dealt to the_wickstar [Kc 7s]
IceAngel82: folds=20
LiLZhiMiNG joins the table at seat #4=20
mimi93731: folds=20
1tillit1: folds=20
the_wickstar: folds=20
Maybe qwer: folds=20
ILbIO4A: raises $0.03 to $0.05
RG&JP5: calls $0.03
*** FLOP *** [4h Js 4s]
ILbIO4A: checks=20
RG&JP5: checks=20
*** TURN *** [4h Js 4s] [2h]
ILbIO4A: checks=20
RG&JP5: bets $0.04
ILbIO4A: folds=20
Uncalled bet ($0.04) returned to RG&JP5
RG&JP5 collected $0.10 from pot
RG&JP5: doesn't show hand=20
*** SUMMARY ***
Total pot $0.10 | Rake $0=20
Board [4h Js 4s 2h]
Seat 1: the_wickstar folded before Flop (didn't bet)
Seat 2: Maybe qwer (button) folded before Flop (didn't bet)
Seat 3: ILbIO4A (small blind) folded on the Turn
Seat 5: RG&JP5 (big blind) collected ($0.10)
Seat 6: IceAngel82 folded before Flop (didn't bet)
Seat 7: mimi93731 folded before Flop (didn't bet)
Seat 8: 1tillit1 folded before Flop (didn't bet)


*********** # 145 **************
PokerStars Hand #169850145951:  Hold'em No Limit ($0.01/$0.02 USD) - 20=
17/05/02 22:55:44 CUST [2017/05/02 8:55:44 ET]
Table 'Botha' 9-max Seat #1 is the button
Seat 1: zartovskiy ($2.46 in chips)=20
Seat 2: PAMEGERA ($2.75 in chips)=20
Seat 3: Sprut2013 ($2.98 in chips)=20
Seat 4: Vlad1slav S. ($2.15 in chips)=20
Seat 5: Tikinh00 ($1.65 in chips)=20
Seat 6: diment76 ($1.90 in chips)=20
Seat 7: the_wickstar ($1.71 in chips)=20
Seat 8: Dooley121 ($2.23 in chips)=20
PAMEGERA: posts small blind $0.01
Sprut2013: posts big blind $0.02
Demonidze31: sits out=20
*** HOLE CARDS ***
Dealt to the_wickstar [Jc Tc]
Vlad1slav S.: folds=20
Tikinh00: calls $0.02
diment76: folds=20
the_wickstar: calls $0.02
Dooley121: calls $0.02
zartovskiy: folds=20
PAMEGERA: folds=20
Sprut2013: checks=20
*** FLOP *** [2c 8s 7d]
Sprut2013: checks=20
Tikinh00: checks=20
the_wickstar: checks=20
Dooley121: checks=20
*** TURN *** [2c 8s 7d] [9c]
Sprut2013: checks=20
Tikinh00: bets $0.05
the_wickstar: raises $0.05 to $0.10
Dooley121: folds=20
Sprut2013: folds=20
Tikinh00: calls $0.05
*** RIVER *** [2c 8s 7d 9c] [Jh]
Tikinh00: checks=20
the_wickstar: bets $0.20
Tikinh00: calls $0.20
*** SHOW DOWN ***
the_wickstar: shows [Jc Tc] (a straight, Seven to Jack)
Tikinh00: mucks hand=20
the_wickstar collected $0.67 from pot
*** SUMMARY ***
Total pot $0.69 | Rake $0.02=20
Board [2c 8s 7d 9c Jh]
Seat 1: zartovskiy (button) folded before Flop (didn't bet)
Seat 2: PAMEGERA (small blind) folded before Flop
Seat 3: Sprut2013 (big blind) folded on the Turn
Seat 4: Vlad1slav S. folded before Flop (didn't bet)
Seat 5: Tikinh00 mucked [2h 2s]
Seat 6: diment76 folded before Flop (didn't bet)
Seat 7: the_wickstar showed [Jc Tc] and won ($0.67) with a straight, Se=
ven to Jack
Seat 8: Dooley121 folded on the Turn


*********** # 146 **************
PokerStars Hand #169850131263:  Hold'em No Limit ($0.01/$0.02 USD) - 20=
17/05/02 22:55:11 CUST [2017/05/02 8:55:11 ET]
Table 'Telephus' 9-max Seat #1 is the button
Seat 1: the_wickstar ($1.12 in chips)=20
Seat 2: Maybe qwer ($1.70 in chips)=20
Seat 3: ILbIO4A ($5.44 in chips)=20
Seat 4: wilmago17 ($2.08 in chips)=20
Seat 5: RG&JP5 ($2.33 in chips)=20
Seat 6: IceAngel82 ($2 in chips)=20
Seat 7: mimi93731 ($0.80 in chips)=20
Seat 8: 1tillit1 ($2.32 in chips)=20
Maybe qwer: posts small blind $0.01
ILbIO4A: posts big blind $0.02
mimi93731: posts big blind $0.02
*** HOLE CARDS ***
Dealt to the_wickstar [8d 2h]
wilmago17: folds=20
RG&JP5: folds=20
IceAngel82: folds=20
mimi93731: checks=20
1tillit1: folds=20
the_wickstar: folds=20
smilie0123 joins the table at seat #9=20
Maybe qwer: raises $0.02 to $0.04
ILbIO4A: folds=20
mimi93731: folds=20
Uncalled bet ($0.02) returned to Maybe qwer
Maybe qwer collected $0.06 from pot
*** SUMMARY ***
Total pot $0.06 | Rake $0=20
Seat 1: the_wickstar (button) folded before Flop (didn't bet)
Seat 2: Maybe qwer (small blind) collected ($0.06)
Seat 3: ILbIO4A (big blind) folded before Flop
Seat 4: wilmago17 folded before Flop (didn't bet)
Seat 5: RG&JP5 folded before Flop (didn't bet)
Seat 6: IceAngel82 folded before Flop (didn't bet)
Seat 7: mimi93731 folded before Flop
Seat 8: 1tillit1 folded before Flop (didn't bet)


*********** # 147 **************
PokerStars Hand #169850113497:  Hold'em No Limit ($0.01/$0.02 USD) - 20=
17/05/02 22:54:36 CUST [2017/05/02 8:54:36 ET]
Table 'Telephus' 9-max Seat #8 is the button
Seat 1: the_wickstar ($1.13 in chips)=20
Seat 2: Maybe qwer ($1.72 in chips)=20
Seat 3: ILbIO4A ($5.44 in chips)=20
Seat 4: wilmago17 ($2.08 in chips)=20
Seat 5: RG&JP5 ($2.33 in chips)=20
Seat 6: IceAngel82 ($2 in chips)=20
Seat 8: 1tillit1 ($2.29 in chips)=20
the_wickstar: posts small blind $0.01
Maybe qwer: posts big blind $0.02
*** HOLE CARDS ***
Dealt to the_wickstar [Jc 9h]
ILbIO4A: folds=20
wilmago17: folds=20
RG&JP5: folds=20
mimi93731 joins the table at seat #7=20
IceAngel82: folds=20
1tillit1: raises $0.03 to $0.05
the_wickstar: folds=20
Maybe qwer: folds=20
Uncalled bet ($0.03) returned to 1tillit1
1tillit1 collected $0.05 from pot
1tillit1: doesn't show hand=20
*** SUMMARY ***
Total pot $0.05 | Rake $0=20
Seat 1: the_wickstar (small blind) folded before Flop
Seat 2: Maybe qwer (big blind) folded before Flop
Seat 3: ILbIO4A folded before Flop (didn't bet)
Seat 4: wilmago17 folded before Flop (didn't bet)
Seat 5: RG&JP5 folded before Flop (didn't bet)
Seat 6: IceAngel82 folded before Flop (didn't bet)
Seat 8: 1tillit1 (button) collected ($0.05)


*********** # 148 **************
PokerStars Hand #169850107966:  Hold'em No Limit ($0.01/$0.02 USD) - 20=
17/05/02 22:54:25 CUST [2017/05/02 8:54:25 ET]
Table 'Botha' 9-max Seat #8 is the button
Seat 1: zartovskiy ($2.47 in chips)=20
Seat 2: PAMEGERA ($2.77 in chips)=20
Seat 3: Sprut2013 ($2.98 in chips)=20
Seat 4: Vlad1slav S. ($2.15 in chips)=20
Seat 5: Tikinh00 ($1.65 in chips)=20
Seat 6: diment76 ($1.97 in chips)=20
Seat 7: the_wickstar ($1.62 in chips)=20
Seat 8: Dooley121 ($2.23 in chips)=20
Demonidze31 will be allowed to play after the button
zartovskiy: posts small blind $0.01
PAMEGERA: posts big blind $0.02
*** HOLE CARDS ***
Dealt to the_wickstar [Kd Jh]
Sprut2013: folds=20
Vlad1slav S.: folds=20
Tikinh00: folds=20
diment76: calls $0.02
the_wickstar: calls $0.02
Dooley121: folds=20
zartovskiy: folds=20
PAMEGERA: checks=20
*** FLOP *** [9s 6h 3s]
PAMEGERA: checks=20
diment76: checks=20
the_wickstar: bets $0.05
PAMEGERA: folds=20
diment76: calls $0.05
*** TURN *** [9s 6h 3s] [Tc]
diment76: checks=20
the_wickstar: checks=20
*** RIVER *** [9s 6h 3s Tc] [Kh]
diment76: checks=20
the_wickstar: bets $0.08
diment76: folds=20
Uncalled bet ($0.08) returned to the_wickstar
the_wickstar collected $0.16 from pot
*** SUMMARY ***
Total pot $0.17 | Rake $0.01=20
Board [9s 6h 3s Tc Kh]
Seat 1: zartovskiy (small blind) folded before Flop
Seat 2: PAMEGERA (big blind) folded on the Flop
Seat 3: Sprut2013 folded before Flop (didn't bet)
Seat 4: Vlad1slav S. folded before Flop (didn't bet)
Seat 5: Tikinh00 folded before Flop (didn't bet)
Seat 6: diment76 folded on the River
Seat 7: the_wickstar collected ($0.16)
Seat 8: Dooley121 (button) folded before Flop (didn't bet)


*********** # 149 **************
PokerStars Hand #169850103341:  Hold'em No Limit ($0.01/$0.02 USD) - 20=
17/05/02 22:54:16 CUST [2017/05/02 8:54:16 ET]
Table 'Telephus' 9-max Seat #6 is the button
Seat 1: the_wickstar ($1.15 in chips)=20
Seat 2: Maybe qwer ($1.69 in chips)=20
Seat 3: ILbIO4A ($5.44 in chips)=20
Seat 4: wilmago17 ($2.08 in chips)=20
Seat 5: RG&JP5 ($2.33 in chips)=20
Seat 6: IceAngel82 ($2 in chips)=20
Seat 8: 1tillit1 ($2.30 in chips)=20
czuwi will be allowed to play after the button
1tillit1: posts small blind $0.01
Mielchon: is sitting out=20
the_wickstar: posts big blind $0.02
*** HOLE CARDS ***
Dealt to the_wickstar [2s 3c]
Mielchon leaves the table
Maybe qwer: raises $0.02 to $0.04
ILbIO4A: folds=20
wilmago17: folds=20
RG&JP5: folds=20
czuwi leaves the table
IceAngel82: folds=20
1tillit1: folds=20
the_wickstar: folds=20
Uncalled bet ($0.02) returned to Maybe qwer
Maybe qwer collected $0.05 from pot
*** SUMMARY ***
Total pot $0.05 | Rake $0=20
Seat 1: the_wickstar (big blind) folded before Flop
Seat 2: Maybe qwer collected ($0.05)
Seat 3: ILbIO4A folded before Flop (didn't bet)
Seat 4: wilmago17 folded before Flop (didn't bet)
Seat 5: RG&JP5 folded before Flop (didn't bet)
Seat 6: IceAngel82 (button) folded before Flop (didn't bet)
Seat 8: 1tillit1 (small blind) folded before Flop


*********** # 150 **************
PokerStars Hand #169850091892:  Hold'em No Limit ($0.01/$0.02 USD) - 20=
17/05/02 22:53:53 CUST [2017/05/02 8:53:53 ET]
Table 'Telephus' 9-max Seat #5 is the button
Seat 1: the_wickstar ($1.15 in chips)=20
Seat 2: Maybe qwer ($1.69 in chips)=20
Seat 3: ILbIO4A ($5.41 in chips)=20
Seat 4: wilmago17 ($2.08 in chips)=20
Seat 5: RG&JP5 ($2.33 in chips)=20
Seat 6: IceAngel82 ($2.01 in chips)=20
Seat 8: 1tillit1 ($2.32 in chips)=20
Seat 9: Mielchon ($1.28 in chips)=20
IceAngel82: posts small blind $0.01
1tillit1: posts big blind $0.02
*** HOLE CARDS ***
Dealt to the_wickstar [6h 7s]
Mielchon: folds=20
the_wickstar: folds=20
Maybe qwer: folds=20
ILbIO4A: raises $0.03 to $0.05
wilmago17: folds=20
czuwi joins the table at seat #7=20
RG&JP5: folds=20
IceAngel82: folds=20
1tillit1: folds=20
Uncalled bet ($0.03) returned to ILbIO4A
ILbIO4A collected $0.05 from pot
ILbIO4A: doesn't show hand=20
*** SUMMARY ***
Total pot $0.05 | Rake $0=20
Seat 1: the_wickstar folded before Flop (didn't bet)
Seat 2: Maybe qwer folded before Flop (didn't bet)
Seat 3: ILbIO4A collected ($0.05)
Seat 4: wilmago17 folded before Flop (didn't bet)
Seat 5: RG&JP5 (button) folded before Flop (didn't bet)
Seat 6: IceAngel82 (small blind) folded before Flop
Seat 8: 1tillit1 (big blind) folded before Flop
Seat 9: Mielchon folded before Flop (didn't bet)


*********** # 151 **************
PokerStars Hand #169850081338:  Hold'em No Limit ($0.01/$0.02 USD) - 20=
17/05/02 22:53:32 CUST [2017/05/02 8:53:32 ET]
Table 'Telephus' 9-max Seat #4 is the button
Seat 1: the_wickstar ($1.15 in chips)=20
Seat 2: Maybe qwer ($1.69 in chips)=20
Seat 3: ILbIO4A ($5.38 in chips)=20
Seat 4: wilmago17 ($2.08 in chips)=20
Seat 5: RG&JP5 ($2.34 in chips)=20
Seat 6: IceAngel82 ($2.03 in chips)=20
Seat 7: Savinf ($2.15 in chips)=20
Seat 8: 1tillit1 ($2.32 in chips)=20
Seat 9: Mielchon ($1.28 in chips)=20
RG&JP5: posts small blind $0.01
IceAngel82: posts big blind $0.02
*** HOLE CARDS ***
Dealt to the_wickstar [7s Td]
Savinf: folds=20
Savinf leaves the table
1tillit1: folds=20
Mielchon: folds=20
the_wickstar: folds=20
Maybe qwer: folds=20
ILbIO4A: raises $0.03 to $0.05
wilmago17: folds=20
RG&JP5: folds=20
IceAngel82: folds=20
Uncalled bet ($0.03) returned to ILbIO4A
ILbIO4A collected $0.05 from pot
ILbIO4A: doesn't show hand=20
*** SUMMARY ***
Total pot $0.05 | Rake $0=20
Seat 1: the_wickstar folded before Flop (didn't bet)
Seat 2: Maybe qwer folded before Flop (didn't bet)
Seat 3: ILbIO4A collected ($0.05)
Seat 4: wilmago17 (button) folded before Flop (didn't bet)
Seat 5: RG&JP5 (small blind) folded before Flop
Seat 6: IceAngel82 (big blind) folded before Flop
Seat 7: Savinf folded before Flop (didn't bet)
Seat 8: 1tillit1 folded before Flop (didn't bet)
Seat 9: Mielchon folded before Flop (didn't bet)


*********** # 152 **************
PokerStars Hand #169850072792:  Hold'em No Limit ($0.01/$0.02 USD) - 20=
17/05/02 22:53:14 CUST [2017/05/02 8:53:14 ET]
Table 'Botha' 9-max Seat #7 is the button
Seat 1: zartovskiy ($2.49 in chips)=20
Seat 2: PAMEGERA ($2.77 in chips)=20
Seat 3: Sprut2013 ($2.98 in chips)=20
Seat 4: Vlad1slav S. ($2.15 in chips)=20
Seat 5: Tikinh00 ($1.21 in chips)=20
Seat 6: diment76 ($1.99 in chips)=20
Seat 7: the_wickstar ($1.62 in chips)=20
Seat 8: Dooley121 ($2.66 in chips)=20
Dooley121: posts small blind $0.01
obama552: is sitting out=20
zartovskiy: posts big blind $0.02
*** HOLE CARDS ***
Dealt to the_wickstar [6d 4s]
obama552 leaves the table
Demonidze31 joins the table at seat #9=20
PAMEGERA: folds=20
Sprut2013: folds=20
Vlad1slav S.: folds=20
Tikinh00: calls $0.02
diment76: calls $0.02
the_wickstar: folds=20
Dooley121: calls $0.01
zartovskiy: checks=20
*** FLOP *** [2c 4h 9s]
Dooley121: bets $0.04
zartovskiy: folds=20
Tikinh00: calls $0.04
diment76: folds=20
*** TURN *** [2c 4h 9s] [6c]
Dooley121: bets $0.15
Tikinh00: calls $0.15
*** RIVER *** [2c 4h 9s 6c] [Tc]
Dooley121: bets $0.22
Tikinh00: calls $0.22
*** SHOW DOWN ***
Dooley121: shows [Td 9d] (two pair, Tens and Nines)
Tikinh00: shows [2s 2h] (three of a kind, Deuces)
Tikinh00 collected $0.87 from pot
*** SUMMARY ***
Total pot $0.90 | Rake $0.03=20
Board [2c 4h 9s 6c Tc]
Seat 1: zartovskiy (big blind) folded on the Flop
Seat 2: PAMEGERA folded before Flop (didn't bet)
Seat 3: Sprut2013 folded before Flop (didn't bet)
Seat 4: Vlad1slav S. folded before Flop (didn't bet)
Seat 5: Tikinh00 showed [2s 2h] and won ($0.87) with three of a kind, D=
euces
Seat 6: diment76 folded on the Flop
Seat 7: the_wickstar (button) folded before Flop (didn't bet)
Seat 8: Dooley121 (small blind) showed [Td 9d] and lost with two pair, =
Tens and Nines


*********** # 153 **************
PokerStars Hand #169850066924:  Hold'em No Limit ($0.01/$0.02 USD) - 20=
17/05/02 22:53:03 CUST [2017/05/02 8:53:03 ET]
Table 'Telephus' 9-max Seat #3 is the button
Seat 1: the_wickstar ($1.15 in chips)=20
Seat 2: Maybe qwer ($1.69 in chips)=20
Seat 3: ILbIO4A ($5.38 in chips)=20
Seat 4: wilmago17 ($2.09 in chips)=20
Seat 5: RG&JP5 ($2.36 in chips)=20
Seat 6: IceAngel82 ($2.03 in chips)=20
Seat 7: Savinf ($2.15 in chips)=20
Seat 8: 1tillit1 ($2.29 in chips)=20
Seat 9: Mielchon ($1.28 in chips)=20
wilmago17: posts small blind $0.01
RG&JP5: posts big blind $0.02
*** HOLE CARDS ***
Dealt to the_wickstar [5d 4s]
IceAngel82: folds=20
Savinf: folds=20
1tillit1: raises $0.05 to $0.07
Mielchon: folds=20
the_wickstar: folds=20
Maybe qwer: folds=20
ILbIO4A: folds=20
wilmago17: folds=20
RG&JP5: folds=20
Uncalled bet ($0.05) returned to 1tillit1
1tillit1 collected $0.05 from pot
1tillit1: doesn't show hand=20
*** SUMMARY ***
Total pot $0.05 | Rake $0=20
Seat 1: the_wickstar folded before Flop (didn't bet)
Seat 2: Maybe qwer folded before Flop (didn't bet)
Seat 3: ILbIO4A (button) folded before Flop (didn't bet)
Seat 4: wilmago17 (small blind) folded before Flop
Seat 5: RG&JP5 (big blind) folded before Flop
Seat 6: IceAngel82 folded before Flop (didn't bet)
Seat 7: Savinf folded before Flop (didn't bet)
Seat 8: 1tillit1 collected ($0.05)
Seat 9: Mielchon folded before Flop (didn't bet)


*********** # 154 **************
PokerStars Hand #169850043685:  Hold'em No Limit ($0.01/$0.02 USD) - 20=
17/05/02 22:52:17 CUST [2017/05/02 8:52:17 ET]
Table 'Telephus' 9-max Seat #2 is the button
Seat 1: the_wickstar ($1.21 in chips)=20
Seat 2: Maybe qwer ($1.60 in chips)=20
Seat 3: ILbIO4A ($5.39 in chips)=20
Seat 4: wilmago17 ($2.11 in chips)=20
Seat 5: RG&JP5 ($2.36 in chips)=20
Seat 6: IceAngel82 ($2.03 in chips)=20
Seat 7: Savinf ($2.15 in chips)=20
Seat 8: 1tillit1 ($2.29 in chips)=20
Seat 9: Mielchon ($1.28 in chips)=20
ILbIO4A: posts small blind $0.01
wilmago17: posts big blind $0.02
*** HOLE CARDS ***
Dealt to the_wickstar [Th Qh]
RG&JP5: folds=20
IceAngel82: folds=20
Savinf: folds=20
1tillit1: folds=20
Mielchon: folds=20
the_wickstar: raises $0.04 to $0.06
Maybe qwer: raises $0.12 to $0.18
ILbIO4A: folds=20
wilmago17: folds=20
the_wickstar: folds=20
Uncalled bet ($0.12) returned to Maybe qwer
Maybe qwer collected $0.15 from pot
*** SUMMARY ***
Total pot $0.15 | Rake $0=20
Seat 1: the_wickstar folded before Flop
Seat 2: Maybe qwer (button) collected ($0.15)
Seat 3: ILbIO4A (small blind) folded before Flop
Seat 4: wilmago17 (big blind) folded before Flop
Seat 5: RG&JP5 folded before Flop (didn't bet)
Seat 6: IceAngel82 folded before Flop (didn't bet)
Seat 7: Savinf folded before Flop (didn't bet)
Seat 8: 1tillit1 folded before Flop (didn't bet)
Seat 9: Mielchon folded before Flop (didn't bet)


*********** # 155 **************
PokerStars Hand #169850041364:  Hold'em No Limit ($0.01/$0.02 USD) - 20=
17/05/02 22:52:12 CUST [2017/05/02 8:52:12 ET]
Table 'Botha' 9-max Seat #6 is the button
Seat 1: zartovskiy ($2.49 in chips)=20
Seat 2: PAMEGERA ($2.77 in chips)=20
Seat 3: Sprut2013 ($2.85 in chips)=20
Seat 4: Vlad1slav S. ($2.15 in chips)=20
Seat 5: Tikinh00 ($1.21 in chips)=20
Seat 6: diment76 ($1.99 in chips)=20
Seat 7: the_wickstar ($1.63 in chips)=20
Seat 8: Dooley121 ($2.79 in chips)=20
Seat 9: obama552 ($2.10 in chips)=20
the_wickstar: posts small blind $0.01
Dooley121: posts big blind $0.02
*** HOLE CARDS ***
Dealt to the_wickstar [2c Jh]
obama552: folds=20
zartovskiy: folds=20
PAMEGERA: folds=20
Sprut2013: calls $0.02
Vlad1slav S.: folds=20
Tikinh00: folds=20
diment76: folds=20
the_wickstar: folds=20
Dooley121: checks=20
*** FLOP *** [As 4d Kc]
Dooley121: checks=20
Sprut2013: bets $0.02
Dooley121: calls $0.02
*** TURN *** [As 4d Kc] [6h]
Dooley121: checks=20
Sprut2013: bets $0.05
Dooley121: calls $0.05
*** RIVER *** [As 4d Kc 6h] [8d]
Dooley121: checks=20
Sprut2013: bets $0.04
Dooley121: calls $0.04
*** SHOW DOWN ***
Sprut2013: shows [Tc Ks] (a pair of Kings)
Dooley121: mucks hand=20
Sprut2013 collected $0.26 from pot
*** SUMMARY ***
Total pot $0.27 | Rake $0.01=20
Board [As 4d Kc 6h 8d]
Seat 1: zartovskiy folded before Flop (didn't bet)
Seat 2: PAMEGERA folded before Flop (didn't bet)
Seat 3: Sprut2013 showed [Tc Ks] and won ($0.26) with a pair of Kings
Seat 4: Vlad1slav S. folded before Flop (didn't bet)
Seat 5: Tikinh00 folded before Flop (didn't bet)
Seat 6: diment76 (button) folded before Flop (didn't bet)
Seat 7: the_wickstar (small blind) folded before Flop
Seat 8: Dooley121 (big blind) mucked [7d Kd]
Seat 9: obama552 folded before Flop (didn't bet)


*********** # 156 **************
PokerStars Hand #169850019191:  Hold'em No Limit ($0.01/$0.02 USD) - 20=
17/05/02 22:51:28 CUST [2017/05/02 8:51:28 ET]
Table 'Telephus' 9-max Seat #1 is the button
Seat 1: the_wickstar ($1.18 in chips)=20
Seat 2: Maybe qwer ($1.61 in chips)=20
Seat 3: ILbIO4A ($5.41 in chips)=20
Seat 4: wilmago17 ($2.11 in chips)=20
Seat 5: RG&JP5 ($2.36 in chips)=20
Seat 6: IceAngel82 ($2.03 in chips)=20
Seat 7: Savinf ($2.15 in chips)=20
Seat 8: 1tillit1 ($2.29 in chips)=20
Seat 9: Mielchon ($1.28 in chips)=20
Maybe qwer: posts small blind $0.01
ILbIO4A: posts big blind $0.02
*** HOLE CARDS ***
Dealt to the_wickstar [As 7s]
wilmago17: folds=20
RG&JP5: folds=20
IceAngel82: folds=20
Savinf: folds=20
1tillit1: folds=20
Mielchon: folds=20
the_wickstar: raises $0.04 to $0.06
Maybe qwer: folds=20
ILbIO4A: folds=20
Uncalled bet ($0.04) returned to the_wickstar
the_wickstar collected $0.05 from pot
*** SUMMARY ***
Total pot $0.05 | Rake $0=20
Seat 1: the_wickstar (button) collected ($0.05)
Seat 2: Maybe qwer (small blind) folded before Flop
Seat 3: ILbIO4A (big blind) folded before Flop
Seat 4: wilmago17 folded before Flop (didn't bet)
Seat 5: RG&JP5 folded before Flop (didn't bet)
Seat 6: IceAngel82 folded before Flop (didn't bet)
Seat 7: Savinf folded before Flop (didn't bet)
Seat 8: 1tillit1 folded before Flop (didn't bet)
Seat 9: Mielchon folded before Flop (didn't bet)


*********** # 157 **************
PokerStars Hand #169850017378:  Hold'em No Limit ($0.01/$0.02 USD) - 20=
17/05/02 22:51:25 CUST [2017/05/02 8:51:25 ET]
Table 'Botha' 9-max Seat #5 is the button
Seat 1: zartovskiy ($2.44 in chips)=20
Seat 2: PAMEGERA ($2.77 in chips)=20
Seat 3: Sprut2013 ($2.85 in chips)=20
Seat 4: Vlad1slav S. ($2.15 in chips)=20
Seat 5: Tikinh00 ($1.21 in chips)=20
Seat 6: diment76 ($2 in chips)=20
Seat 7: the_wickstar ($1.65 in chips)=20
Seat 8: Dooley121 ($2.81 in chips)=20
Seat 9: obama552 ($2.10 in chips)=20
diment76: posts small blind $0.01
the_wickstar: posts big blind $0.02
*** HOLE CARDS ***
Dealt to the_wickstar [4d Kd]
Dooley121: calls $0.02
obama552: folds=20
zartovskiy: raises $0.07 to $0.09
PAMEGERA: folds=20
Sprut2013: folds=20
Vlad1slav S.: folds=20
Tikinh00: folds=20
diment76: folds=20
the_wickstar: folds=20
Dooley121: folds=20
Uncalled bet ($0.07) returned to zartovskiy
zartovskiy collected $0.07 from pot
zartovskiy: doesn't show hand=20
*** SUMMARY ***
Total pot $0.07 | Rake $0=20
Seat 1: zartovskiy collected ($0.07)
Seat 2: PAMEGERA folded before Flop (didn't bet)
Seat 3: Sprut2013 folded before Flop (didn't bet)
Seat 4: Vlad1slav S. folded before Flop (didn't bet)
Seat 5: Tikinh00 (button) folded before Flop (didn't bet)
Seat 6: diment76 (small blind) folded before Flop
Seat 7: the_wickstar (big blind) folded before Flop
Seat 8: Dooley121 folded before Flop
Seat 9: obama552 folded before Flop (didn't bet)


*********** # 158 **************
PokerStars Hand #169849998006:  Hold'em No Limit ($0.01/$0.02 USD) - 20=
17/05/02 22:50:47 CUST [2017/05/02 8:50:47 ET]
Table 'Botha' 9-max Seat #4 is the button
Seat 1: zartovskiy ($2.44 in chips)=20
Seat 2: PAMEGERA ($2.87 in chips)=20
Seat 3: Sprut2013 ($2.85 in chips)=20
Seat 4: Vlad1slav S. ($2 in chips)=20
Seat 5: Tikinh00 ($1.22 in chips)=20
Seat 6: diment76 ($1.25 in chips)=20
Seat 7: the_wickstar ($1.65 in chips)=20
Seat 8: Dooley121 ($2.83 in chips)=20
Seat 9: obama552 ($2.10 in chips)=20
Tikinh00: posts small blind $0.01
diment76: posts big blind $0.02
*** HOLE CARDS ***
Dealt to the_wickstar [6d 5c]
the_wickstar: folds=20
Dooley121: calls $0.02
obama552: folds=20
zartovskiy: folds=20
PAMEGERA: raises $0.08 to $0.10
Sprut2013: folds=20
Vlad1slav S.: raises $0.14 to $0.24
Tikinh00: folds=20
diment76: folds=20
Dooley121: folds=20
PAMEGERA: folds=20
Uncalled bet ($0.14) returned to Vlad1slav S.
Vlad1slav S. collected $0.25 from pot
Vlad1slav S.: doesn't show hand=20
*** SUMMARY ***
Total pot $0.25 | Rake $0=20
Seat 1: zartovskiy folded before Flop (didn't bet)
Seat 2: PAMEGERA folded before Flop
Seat 3: Sprut2013 folded before Flop (didn't bet)
Seat 4: Vlad1slav S. (button) collected ($0.25)
Seat 5: Tikinh00 (small blind) folded before Flop
Seat 6: diment76 (big blind) folded before Flop
Seat 7: the_wickstar folded before Flop (didn't bet)
Seat 8: Dooley121 folded before Flop
Seat 9: obama552 folded before Flop (didn't bet)


*********** # 159 **************
PokerStars Hand #169849969308:  Hold'em No Limit ($0.01/$0.02 USD) - 20=
17/05/02 22:49:50 CUST [2017/05/02 8:49:50 ET]
Table 'Botha' 9-max Seat #3 is the button
Seat 1: zartovskiy ($2.44 in chips)=20
Seat 2: PAMEGERA ($2.68 in chips)=20
Seat 3: Sprut2013 ($2.85 in chips)=20
Seat 4: Vlad1slav S. ($2 in chips)=20
Seat 5: Tikinh00 ($1.24 in chips)=20
Seat 6: diment76 ($1.42 in chips)=20
Seat 7: the_wickstar ($1.65 in chips)=20
Seat 8: Dooley121 ($2.83 in chips)=20
Seat 9: obama552 ($2.10 in chips)=20
Vlad1slav S.: posts small blind $0.01
Tikinh00: posts big blind $0.02
*** HOLE CARDS ***
Dealt to the_wickstar [Qd 2h]
diment76: raises $0.04 to $0.06
the_wickstar: folds=20
Dooley121: folds=20
obama552: folds=20
zartovskiy: folds=20
PAMEGERA: calls $0.06
Sprut2013: folds=20
Vlad1slav S.: folds=20
Tikinh00: folds=20
*** FLOP *** [6d 3h 5d]
diment76: checks=20
PAMEGERA: bets $0.11
diment76: calls $0.11
*** TURN *** [6d 3h 5d] [4h]
diment76: checks=20
PAMEGERA: bets $0.29
diment76: folds=20
Uncalled bet ($0.29) returned to PAMEGERA
PAMEGERA collected $0.36 from pot
PAMEGERA: doesn't show hand=20
*** SUMMARY ***
Total pot $0.37 | Rake $0.01=20
Board [6d 3h 5d 4h]
Seat 1: zartovskiy folded before Flop (didn't bet)
Seat 2: PAMEGERA collected ($0.36)
Seat 3: Sprut2013 (button) folded before Flop (didn't bet)
Seat 4: Vlad1slav S. (small blind) folded before Flop
Seat 5: Tikinh00 (big blind) folded before Flop
Seat 6: diment76 folded on the Turn
Seat 7: the_wickstar folded before Flop (didn't bet)
Seat 8: Dooley121 folded before Flop (didn't bet)
Seat 9: obama552 folded before Flop (didn't bet)


*********** # 160 **************
PokerStars Hand #169849948189:  Hold'em No Limit ($0.01/$0.02 USD) - 20=
17/05/02 22:49:08 CUST [2017/05/02 8:49:08 ET]
Table 'Telephus' 9-max Seat #9 is the button
Seat 1: the_wickstar ($1.19 in chips)=20
Seat 2: Maybe qwer ($1.87 in chips)=20
Seat 3: ILbIO4A ($5.41 in chips)=20
Seat 4: wilmago17 ($2.11 in chips)=20
Seat 5: RG&JP5 ($1.56 in chips)=20
Seat 6: IceAngel82 ($2.03 in chips)=20
Seat 7: Savinf ($2.15 in chips)=20
Seat 8: 1tillit1 ($2.29 in chips)=20
Seat 9: Mielchon ($1.86 in chips)=20
the_wickstar: posts small blind $0.01
Maybe qwer: posts big blind $0.02
*** HOLE CARDS ***
Dealt to the_wickstar [5s 7s]
ILbIO4A: folds=20
wilmago17: folds=20
RG&JP5: raises $0.04 to $0.06
IceAngel82: folds=20
Savinf: folds=20
1tillit1: folds=20
Mielchon: calls $0.06
the_wickstar: folds=20
Maybe qwer: calls $0.04
*** FLOP *** [2s 8c 8h]
Maybe qwer: checks=20
RG&JP5: bets $0.10
Mielchon: raises $0.10 to $0.20
Maybe qwer: calls $0.20
RG&JP5: calls $0.10
*** TURN *** [2s 8c 8h] [6d]
Maybe qwer: checks=20
RG&JP5: checks=20
Mielchon: bets $0.32
Maybe qwer: folds=20
RG&JP5: calls $0.32
*** RIVER *** [2s 8c 8h 6d] [As]
RG&JP5: checks=20
Mielchon: checks=20
*** SHOW DOWN ***
RG&JP5: shows [Tc Ts] (two pair, Tens and Eights)
Mielchon: mucks hand=20
RG&JP5 collected $1.38 from pot
*** SUMMARY ***
Total pot $1.43 | Rake $0.05=20
Board [2s 8c 8h 6d As]
Seat 1: the_wickstar (small blind) folded before Flop
Seat 2: Maybe qwer (big blind) folded on the Turn
Seat 3: ILbIO4A folded before Flop (didn't bet)
Seat 4: wilmago17 folded before Flop (didn't bet)
Seat 5: RG&JP5 showed [Tc Ts] and won ($1.38) with two pair, Tens and E=
ights
Seat 6: IceAngel82 folded before Flop (didn't bet)
Seat 7: Savinf folded before Flop (didn't bet)
Seat 8: 1tillit1 folded before Flop (didn't bet)
Seat 9: Mielchon (button) mucked [9d 9c]


*********** # 161 **************
PokerStars Hand #169849933637:  Hold'em No Limit ($0.01/$0.02 USD) - 20=
17/05/02 22:48:39 CUST [2017/05/02 8:48:39 ET]
Table 'Botha' 9-max Seat #2 is the button
Seat 1: zartovskiy ($2.44 in chips)=20
Seat 2: PAMEGERA ($2.68 in chips)=20
Seat 3: Sprut2013 ($2.86 in chips)=20
Seat 4: Vlad1slav S. ($2 in chips)=20
Seat 5: Tikinh00 ($1.24 in chips)=20
Seat 6: diment76 ($1.42 in chips)=20
Seat 7: the_wickstar ($1.67 in chips)=20
Seat 8: Dooley121 ($2.83 in chips)=20
Seat 9: obama552 ($2.05 in chips)=20
Sprut2013: posts small blind $0.01
Vlad1slav S.: posts big blind $0.02
*** HOLE CARDS ***
Dealt to the_wickstar [Js Qc]
Tikinh00: folds=20
diment76: folds=20
the_wickstar: calls $0.02
Dooley121: folds=20
obama552: raises $0.06 to $0.08
zartovskiy: folds=20
PAMEGERA: folds=20
Sprut2013: folds=20
Vlad1slav S.: folds=20
the_wickstar: folds=20
Uncalled bet ($0.06) returned to obama552
obama552 collected $0.07 from pot
obama552: doesn't show hand=20
*** SUMMARY ***
Total pot $0.07 | Rake $0=20
Seat 1: zartovskiy folded before Flop (didn't bet)
Seat 2: PAMEGERA (button) folded before Flop (didn't bet)
Seat 3: Sprut2013 (small blind) folded before Flop
Seat 4: Vlad1slav S. (big blind) folded before Flop
Seat 5: Tikinh00 folded before Flop (didn't bet)
Seat 6: diment76 folded before Flop (didn't bet)
Seat 7: the_wickstar folded before Flop
Seat 8: Dooley121 folded before Flop (didn't bet)
Seat 9: obama552 collected ($0.07)


*********** # 162 **************
PokerStars Hand #169849927320:  Hold'em No Limit ($0.01/$0.02 USD) - 20=
17/05/02 22:48:26 CUST [2017/05/02 8:48:26 ET]
Table 'Telephus' 9-max Seat #8 is the button
Seat 1: the_wickstar ($1.21 in chips)=20
Seat 2: Maybe qwer ($1.87 in chips)=20
Seat 3: ILbIO4A ($5.41 in chips)=20
Seat 4: wilmago17 ($2.11 in chips)=20
Seat 5: RG&JP5 ($1.56 in chips)=20
Seat 6: IceAngel82 ($2.03 in chips)=20
Seat 7: Savinf ($2.15 in chips)=20
Seat 8: 1tillit1 ($2.29 in chips)=20
Seat 9: Mielchon ($1.84 in chips)=20
Mielchon: posts small blind $0.01
the_wickstar: posts big blind $0.02
*** HOLE CARDS ***
Dealt to the_wickstar [Js 3s]
Maybe qwer: folds=20
ILbIO4A: folds=20
wilmago17: folds=20
RG&JP5: folds=20
IceAngel82: folds=20
Savinf: folds=20
1tillit1: folds=20
Mielchon: raises $0.04 to $0.06
the_wickstar: folds=20
Uncalled bet ($0.04) returned to Mielchon
Mielchon collected $0.04 from pot
*** SUMMARY ***
Total pot $0.04 | Rake $0=20
Seat 1: the_wickstar (big blind) folded before Flop
Seat 2: Maybe qwer folded before Flop (didn't bet)
Seat 3: ILbIO4A folded before Flop (didn't bet)
Seat 4: wilmago17 folded before Flop (didn't bet)
Seat 5: RG&JP5 folded before Flop (didn't bet)
Seat 6: IceAngel82 folded before Flop (didn't bet)
Seat 7: Savinf folded before Flop (didn't bet)
Seat 8: 1tillit1 (button) folded before Flop (didn't bet)
Seat 9: Mielchon (small blind) collected ($0.04)


*********** # 163 **************
PokerStars Hand #169849907328:  Hold'em No Limit ($0.01/$0.02 USD) - 20=
17/05/02 22:47:46 CUST [2017/05/02 8:47:46 ET]
Table 'Botha' 9-max Seat #1 is the button
Seat 1: zartovskiy ($2.44 in chips)=20
Seat 2: PAMEGERA ($2.69 in chips)=20
Seat 3: Sprut2013 ($2.74 in chips)=20
Seat 5: Tikinh00 ($1.30 in chips)=20
Seat 6: diment76 ($1.42 in chips)=20
Seat 7: the_wickstar ($1.67 in chips)=20
Seat 8: Dooley121 ($2.89 in chips)=20
Seat 9: obama552 ($2.05 in chips)=20
PAMEGERA: posts small blind $0.01
Sprut2013: posts big blind $0.02
Vlad1slav S.: sits out=20
*** HOLE CARDS ***
Dealt to the_wickstar [Qh 3c]
Tikinh00: calls $0.02
diment76: folds=20
the_wickstar: folds=20
Dooley121: calls $0.02
obama552: folds=20
zartovskiy: folds=20
PAMEGERA: folds=20
Sprut2013: raises $0.04 to $0.06
Tikinh00: calls $0.04
Dooley121: calls $0.04
*** FLOP *** [3h 4d 4h]
Sprut2013: bets $0.09
Tikinh00: folds=20
Dooley121: folds=20
Uncalled bet ($0.09) returned to Sprut2013
Sprut2013 collected $0.18 from pot
Sprut2013: doesn't show hand=20
*** SUMMARY ***
Total pot $0.19 | Rake $0.01=20
Board [3h 4d 4h]
Seat 1: zartovskiy (button) folded before Flop (didn't bet)
Seat 2: PAMEGERA (small blind) folded before Flop
Seat 3: Sprut2013 (big blind) collected ($0.18)
Seat 5: Tikinh00 folded on the Flop
Seat 6: diment76 folded before Flop (didn't bet)
Seat 7: the_wickstar folded before Flop (didn't bet)
Seat 8: Dooley121 folded on the Flop
Seat 9: obama552 folded before Flop (didn't bet)


*********** # 164 **************
PokerStars Hand #169849894659:  Hold'em No Limit ($0.01/$0.02 USD) - 20=
17/05/02 22:47:20 CUST [2017/05/02 8:47:20 ET]
Table 'Telephus' 9-max Seat #7 is the button
Seat 1: the_wickstar ($1.21 in chips)=20
Seat 2: Maybe qwer ($1.87 in chips)=20
Seat 3: ILbIO4A ($5.54 in chips)=20
Seat 4: wilmago17 ($2.11 in chips)=20
Seat 5: RG&JP5 ($1.56 in chips)=20
Seat 6: IceAngel82 ($2.03 in chips)=20
Seat 7: Savinf ($2 in chips)=20
Seat 8: 1tillit1 ($2.30 in chips)=20
Seat 9: Mielchon ($1.86 in chips)=20
1tillit1: posts small blind $0.01
Mielchon: posts big blind $0.02
*** HOLE CARDS ***
Dealt to the_wickstar [2c 8d]
the_wickstar has timed out
the_wickstar: folds=20
Maybe qwer: folds=20
ILbIO4A: raises $0.03 to $0.05
wilmago17: folds=20
RG&JP5: folds=20
IceAngel82: folds=20
Savinf: calls $0.05
1tillit1: folds=20
Mielchon: folds=20
*** FLOP *** [Jc 4d 2s]
ILbIO4A: checks=20
Savinf: bets $0.08
ILbIO4A: calls $0.08
*** TURN *** [Jc 4d 2s] [Js]
ILbIO4A: checks=20
Savinf: bets $0.17
ILbIO4A: folds=20
Uncalled bet ($0.17) returned to Savinf
Savinf collected $0.28 from pot
Savinf: doesn't show hand=20
*** SUMMARY ***
Total pot $0.29 | Rake $0.01=20
Board [Jc 4d 2s Js]
Seat 1: the_wickstar folded before Flop (didn't bet)
Seat 2: Maybe qwer folded before Flop (didn't bet)
Seat 3: ILbIO4A folded on the Turn
Seat 4: wilmago17 folded before Flop (didn't bet)
Seat 5: RG&JP5 folded before Flop (didn't bet)
Seat 6: IceAngel82 folded before Flop (didn't bet)
Seat 7: Savinf (button) collected ($0.28)
Seat 8: 1tillit1 (small blind) folded before Flop
Seat 9: Mielchon (big blind) folded before Flop


*********** # 165 **************
PokerStars Hand #169849869660:  Hold'em No Limit ($0.01/$0.02 USD) - 20=
17/05/02 22:46:30 CUST [2017/05/02 8:46:30 ET]
Table 'Botha' 9-max Seat #9 is the button
Seat 1: zartovskiy ($2.45 in chips)=20
Seat 2: PAMEGERA ($2.58 in chips)=20
Seat 3: Sprut2013 ($2.74 in chips)=20
Seat 5: Tikinh00 ($1.32 in chips)=20
Seat 6: diment76 ($1.42 in chips)=20
Seat 7: the_wickstar ($1.74 in chips)=20
Seat 8: Dooley121 ($2.91 in chips)=20
Seat 9: obama552 ($2.05 in chips)=20
zartovskiy: posts small blind $0.01
PAMEGERA: posts big blind $0.02
Vlad1slav S.: sits out=20
*** HOLE CARDS ***
Dealt to the_wickstar [Ac 9h]
Sprut2013: folds=20
Tikinh00: calls $0.02
diment76: folds=20
the_wickstar: calls $0.02
Dooley121: calls $0.02
obama552: folds=20
zartovskiy: folds=20
PAMEGERA: checks=20
*** FLOP *** [Ks Jc 7c]
PAMEGERA: bets $0.05
Tikinh00: folds=20
the_wickstar: calls $0.05
Dooley121: folds=20
*** TURN *** [Ks Jc 7c] [Ts]
PAMEGERA: bets $0.09
the_wickstar: folds=20
Uncalled bet ($0.09) returned to PAMEGERA
PAMEGERA collected $0.18 from pot
PAMEGERA: doesn't show hand=20
*** SUMMARY ***
Total pot $0.19 | Rake $0.01=20
Board [Ks Jc 7c Ts]
Seat 1: zartovskiy (small blind) folded before Flop
Seat 2: PAMEGERA (big blind) collected ($0.18)
Seat 3: Sprut2013 folded before Flop (didn't bet)
Seat 5: Tikinh00 folded on the Flop
Seat 6: diment76 folded before Flop (didn't bet)
Seat 7: the_wickstar folded on the Turn
Seat 8: Dooley121 folded on the Flop
Seat 9: obama552 (button) folded before Flop (didn't bet)


*********** # 166 **************
PokerStars Hand #169849858739:  Hold'em No Limit ($0.01/$0.02 USD) - 20=
17/05/02 22:46:08 CUST [2017/05/02 8:46:08 ET]
Table 'Telephus' 9-max Seat #6 is the button
Seat 1: the_wickstar ($1.16 in chips)=20
Seat 2: Maybe qwer ($1.87 in chips)=20
Seat 3: ILbIO4A ($5.54 in chips)=20
Seat 4: wilmago17 ($2.11 in chips)=20
Seat 5: RG&JP5 ($1.56 in chips)=20
Seat 6: IceAngel82 ($2.03 in chips)=20
Seat 7: Savinf ($2.01 in chips)=20
Seat 8: 1tillit1 ($2.34 in chips)=20
Seat 9: Mielchon ($1.86 in chips)=20
Savinf: posts small blind $0.01
1tillit1: posts big blind $0.02
*** HOLE CARDS ***
Dealt to the_wickstar [6h 6s]
Mielchon: folds=20
the_wickstar: raises $0.02 to $0.04
Maybe qwer: folds=20
ILbIO4A: folds=20
wilmago17: folds=20
RG&JP5: folds=20
IceAngel82: folds=20
Savinf: folds=20
1tillit1: calls $0.02
*** FLOP *** [9c Ah 5d]
1tillit1: checks=20
the_wickstar: bets $0.05
1tillit1: folds=20
Uncalled bet ($0.05) returned to the_wickstar
the_wickstar collected $0.09 from pot
*** SUMMARY ***
Total pot $0.09 | Rake $0=20
Board [9c Ah 5d]
Seat 1: the_wickstar collected ($0.09)
Seat 2: Maybe qwer folded before Flop (didn't bet)
Seat 3: ILbIO4A folded before Flop (didn't bet)
Seat 4: wilmago17 folded before Flop (didn't bet)
Seat 5: RG&JP5 folded before Flop (didn't bet)
Seat 6: IceAngel82 (button) folded before Flop (didn't bet)
Seat 7: Savinf (small blind) folded before Flop
Seat 8: 1tillit1 (big blind) folded on the Flop
Seat 9: Mielchon folded before Flop (didn't bet)


*********** # 167 **************
PokerStars Hand #169849843703:  Hold'em No Limit ($0.01/$0.02 USD) - 20=
17/05/02 22:45:38 CUST [2017/05/02 8:45:38 ET]
Table 'Telephus' 9-max Seat #5 is the button
Seat 1: the_wickstar ($1.18 in chips)=20
Seat 2: Maybe qwer ($1.87 in chips)=20
Seat 3: ILbIO4A ($5.49 in chips)=20
Seat 4: wilmago17 ($2.11 in chips)=20
Seat 5: RG&JP5 ($1.56 in chips)=20
Seat 6: IceAngel82 ($2.04 in chips)=20
Seat 7: Savinf ($2.03 in chips)=20
Seat 8: 1tillit1 ($2.34 in chips)=20
Seat 9: Mielchon ($1.86 in chips)=20
IceAngel82: posts small blind $0.01
Savinf: posts big blind $0.02
*** HOLE CARDS ***
Dealt to the_wickstar [6s Ad]
1tillit1: folds=20
Mielchon: folds=20
the_wickstar: calls $0.02
Maybe qwer: folds=20
ILbIO4A: raises $0.03 to $0.05
wilmago17: folds=20
RG&JP5: folds=20
IceAngel82: folds=20
Savinf: folds=20
the_wickstar: folds=20
Uncalled bet ($0.03) returned to ILbIO4A
ILbIO4A collected $0.07 from pot
ILbIO4A: doesn't show hand=20
*** SUMMARY ***
Total pot $0.07 | Rake $0=20
Seat 1: the_wickstar folded before Flop
Seat 2: Maybe qwer folded before Flop (didn't bet)
Seat 3: ILbIO4A collected ($0.07)
Seat 4: wilmago17 folded before Flop (didn't bet)
Seat 5: RG&JP5 (button) folded before Flop (didn't bet)
Seat 6: IceAngel82 (small blind) folded before Flop
Seat 7: Savinf (big blind) folded before Flop
Seat 8: 1tillit1 folded before Flop (didn't bet)
Seat 9: Mielchon folded before Flop (didn't bet)


*********** # 168 **************
PokerStars Hand #169849830145:  Hold'em No Limit ($0.01/$0.02 USD) - 20=
17/05/02 22:45:11 CUST [2017/05/02 8:45:11 ET]
Table 'Botha' 9-max Seat #8 is the button
Seat 1: zartovskiy ($2.47 in chips)=20
Seat 5: Tikinh00 ($1.24 in chips)=20
Seat 6: diment76 ($1.42 in chips)=20
Seat 7: the_wickstar ($1.74 in chips)=20
Seat 8: Dooley121 ($2.97 in chips)=20
Seat 9: obama552 ($2.06 in chips)=20
obama552: posts small blind $0.01
zartovskiy: posts big blind $0.02
PAMEGERA: sits out=20
Vlad1slav S.: sits out=20
*** HOLE CARDS ***
Dealt to the_wickstar [4d 5c]
Tikinh00: calls $0.02
diment76: folds=20
the_wickstar: folds=20
Dooley121: calls $0.02
obama552: folds=20
zartovskiy: checks=20
*** FLOP *** [Jd 8s 2h]
zartovskiy: checks=20
Tikinh00: checks=20
Dooley121: bets $0.04
zartovskiy: folds=20
Tikinh00: calls $0.04
*** TURN *** [Jd 8s 2h] [5s]
Tikinh00: bets $0.04
Dooley121: folds=20
Uncalled bet ($0.04) returned to Tikinh00
Tikinh00 collected $0.14 from pot
*** SUMMARY ***
Total pot $0.15 | Rake $0.01=20
Board [Jd 8s 2h 5s]
Seat 1: zartovskiy (big blind) folded on the Flop
Seat 5: Tikinh00 collected ($0.14)
Seat 6: diment76 folded before Flop (didn't bet)
Seat 7: the_wickstar folded before Flop (didn't bet)
Seat 8: Dooley121 (button) folded on the Turn
Seat 9: obama552 (small blind) folded before Flop


*********** # 169 **************
PokerStars Hand #169849810897:  Hold'em No Limit ($0.01/$0.02 USD) - 20=
17/05/02 22:44:32 CUST [2017/05/02 8:44:32 ET]
Table 'Telephus' 9-max Seat #4 is the button
Seat 1: the_wickstar ($1.18 in chips)=20
Seat 2: Maybe qwer ($1.71 in chips)=20
Seat 3: ILbIO4A ($5.49 in chips)=20
Seat 4: wilmago17 ($2.11 in chips)=20
Seat 5: RG&JP5 ($1.57 in chips)=20
Seat 6: IceAngel82 ($2.06 in chips)=20
Seat 7: Savinf ($2.03 in chips)=20
Seat 8: 1tillit1 ($2.34 in chips)=20
Seat 9: Mielchon ($2 in chips)=20
RG&JP5: posts small blind $0.01
IceAngel82: posts big blind $0.02
*** HOLE CARDS ***
Dealt to the_wickstar [4c 5c]
Savinf: folds=20
1tillit1: folds=20
Mielchon: raises $0.04 to $0.06
the_wickstar: folds=20
Maybe qwer: calls $0.06
ILbIO4A: folds=20
wilmago17: folds=20
RG&JP5: folds=20
IceAngel82: folds=20
*** FLOP *** [2c 8d 3h]
Mielchon: bets $0.08
Maybe qwer: calls $0.08
*** TURN *** [2c 8d 3h] [2h]
Mielchon: checks=20
Maybe qwer: checks=20
*** RIVER *** [2c 8d 3h 2h] [Tc]
Mielchon: checks=20
Maybe qwer: checks=20
*** SHOW DOWN ***
Mielchon: shows [Ad Js] (a pair of Deuces)
Maybe qwer: shows [Ac Ks] (a pair of Deuces - Ace+King kicker)
Maybe qwer collected $0.30 from pot
*** SUMMARY ***
Total pot $0.31 | Rake $0.01=20
Board [2c 8d 3h 2h Tc]
Seat 1: the_wickstar folded before Flop (didn't bet)
Seat 2: Maybe qwer showed [Ac Ks] and won ($0.30) with a pair of Deuces
Seat 3: ILbIO4A folded before Flop (didn't bet)
Seat 4: wilmago17 (button) folded before Flop (didn't bet)
Seat 5: RG&JP5 (small blind) folded before Flop
Seat 6: IceAngel82 (big blind) folded before Flop
Seat 7: Savinf folded before Flop (didn't bet)
Seat 8: 1tillit1 folded before Flop (didn't bet)
Seat 9: Mielchon showed [Ad Js] and lost with a pair of Deuces


*********** # 170 **************
PokerStars Hand #169849806244:  Hold'em No Limit ($0.01/$0.02 USD) - 20=
17/05/02 22:44:22 CUST [2017/05/02 8:44:22 ET]
Table 'Botha' 9-max Seat #7 is the button
Seat 1: zartovskiy ($2.47 in chips)=20
Seat 5: Tikinh00 ($1.26 in chips)=20
Seat 6: diment76 ($1.46 in chips)=20
Seat 7: the_wickstar ($1.55 in chips)=20
Seat 8: Dooley121 ($3.09 in chips)=20
Seat 9: obama552 ($2.08 in chips)=20
Dooley121: posts small blind $0.01
obama552: posts big blind $0.02
PAMEGERA: sits out=20
Vlad1slav S.: sits out=20
*** HOLE CARDS ***
Dealt to the_wickstar [Kc Kh]
zartovskiy: folds=20
Tikinh00: calls $0.02
diment76: raises $0.02 to $0.04
the_wickstar: raises $0.08 to $0.12
Dooley121: calls $0.11
obama552: folds=20
Tikinh00: folds=20
diment76: folds=20
*** FLOP *** [5c Qd Kd]
Dooley121: checks=20
the_wickstar: bets $0.31
Dooley121: folds=20
Uncalled bet ($0.31) returned to the_wickstar
the_wickstar collected $0.31 from pot
*** SUMMARY ***
Total pot $0.32 | Rake $0.01=20
Board [5c Qd Kd]
Seat 1: zartovskiy folded before Flop (didn't bet)
Seat 5: Tikinh00 folded before Flop
Seat 6: diment76 folded before Flop
Seat 7: the_wickstar (button) collected ($0.31)
Seat 8: Dooley121 (small blind) folded on the Flop
Seat 9: obama552 (big blind) folded before Flop


*********** # 171 **************
PokerStars Hand #169849794942:  Hold'em No Limit ($0.01/$0.02 USD) - 20=
17/05/02 22:43:59 CUST [2017/05/02 8:43:59 ET]
Table 'Botha' 9-max Seat #6 is the button
Seat 1: zartovskiy ($2.47 in chips)=20
Seat 5: Tikinh00 ($1.26 in chips)=20
Seat 6: diment76 ($1.43 in chips)=20
Seat 7: the_wickstar ($1.56 in chips)=20
Seat 8: Dooley121 ($3.11 in chips)=20
Seat 9: obama552 ($2.08 in chips)=20
the_wickstar: posts small blind $0.01
Dooley121: posts big blind $0.02
PAMEGERA: sits out=20
Vlad1slav S.: sits out=20
*** HOLE CARDS ***
Dealt to the_wickstar [3d Qd]
obama552: folds=20
zartovskiy: folds=20
Tikinh00: folds=20
diment76: raises $0.04 to $0.06
the_wickstar: folds=20
Dooley121: folds=20
Uncalled bet ($0.04) returned to diment76
diment76 collected $0.05 from pot
*** SUMMARY ***
Total pot $0.05 | Rake $0=20
Seat 1: zartovskiy folded before Flop (didn't bet)
Seat 5: Tikinh00 folded before Flop (didn't bet)
Seat 6: diment76 (button) collected ($0.05)
Seat 7: the_wickstar (small blind) folded before Flop
Seat 8: Dooley121 (big blind) folded before Flop
Seat 9: obama552 folded before Flop (didn't bet)


*********** # 172 **************
PokerStars Hand #169849793283:  Hold'em No Limit ($0.01/$0.02 USD) - 20=
17/05/02 22:43:56 CUST [2017/05/02 8:43:56 ET]
Table 'Telephus' 9-max Seat #3 is the button
Seat 1: the_wickstar ($1.18 in chips)=20
Seat 2: Maybe qwer ($1.71 in chips)=20
Seat 3: ILbIO4A ($5.49 in chips)=20
Seat 4: wilmago17 ($2.12 in chips)=20
Seat 5: RG&JP5 ($1.56 in chips)=20
Seat 6: IceAngel82 ($2.06 in chips)=20
Seat 7: Savinf ($2.03 in chips)=20
Seat 8: 1tillit1 ($2.34 in chips)=20
Seat 9: Mielchon ($2 in chips)=20
wilmago17: posts small blind $0.01
RG&JP5: posts big blind $0.02
*** HOLE CARDS ***
Dealt to the_wickstar [5h Ks]
IceAngel82: folds=20
Savinf: folds=20
1tillit1: folds=20
Mielchon: folds=20
the_wickstar: folds=20
Maybe qwer: folds=20
ILbIO4A: folds=20
wilmago17: folds=20
Uncalled bet ($0.01) returned to RG&JP5
RG&JP5 collected $0.02 from pot
RG&JP5: doesn't show hand=20
*** SUMMARY ***
Total pot $0.02 | Rake $0=20
Seat 1: the_wickstar folded before Flop (didn't bet)
Seat 2: Maybe qwer folded before Flop (didn't bet)
Seat 3: ILbIO4A (button) folded before Flop (didn't bet)
Seat 4: wilmago17 (small blind) folded before Flop
Seat 5: RG&JP5 (big blind) collected ($0.02)
Seat 6: IceAngel82 folded before Flop (didn't bet)
Seat 7: Savinf folded before Flop (didn't bet)
Seat 8: 1tillit1 folded before Flop (didn't bet)
Seat 9: Mielchon folded before Flop (didn't bet)


*********** # 173 **************
PokerStars Hand #169849784213:  Hold'em No Limit ($0.01/$0.02 USD) - 20=
17/05/02 22:43:37 CUST [2017/05/02 8:43:37 ET]
Table 'Botha' 9-max Seat #5 is the button
Seat 1: zartovskiy ($2.47 in chips)=20
Seat 5: Tikinh00 ($1.26 in chips)=20
Seat 6: diment76 ($1.44 in chips)=20
Seat 7: the_wickstar ($1.58 in chips)=20
Seat 8: Dooley121 ($3.11 in chips)=20
Seat 9: obama552 ($2.05 in chips)=20
diment76: posts small blind $0.01
the_wickstar: posts big blind $0.02
PAMEGERA: sits out=20
Vlad1slav S.: sits out=20
*** HOLE CARDS ***
Dealt to the_wickstar [Jd 8d]
Dooley121: folds=20
obama552: raises $0.04 to $0.06
zartovskiy: folds=20
Tikinh00: folds=20
diment76: folds=20
the_wickstar: folds=20
Uncalled bet ($0.04) returned to obama552
obama552 collected $0.05 from pot
obama552: doesn't show hand=20
*** SUMMARY ***
Total pot $0.05 | Rake $0=20
Seat 1: zartovskiy folded before Flop (didn't bet)
Seat 5: Tikinh00 (button) folded before Flop (didn't bet)
Seat 6: diment76 (small blind) folded before Flop
Seat 7: the_wickstar (big blind) folded before Flop
Seat 8: Dooley121 folded before Flop (didn't bet)
Seat 9: obama552 collected ($0.05)


*********** # 174 **************
PokerStars Hand #169849783815:  Hold'em No Limit ($0.01/$0.02 USD) - 20=
17/05/02 22:43:36 CUST [2017/05/02 8:43:36 ET]
Table 'Telephus' 9-max Seat #2 is the button
Seat 1: the_wickstar ($1.18 in chips)=20
Seat 2: Maybe qwer ($1.71 in chips)=20
Seat 3: ILbIO4A ($5.50 in chips)=20
Seat 4: wilmago17 ($2.14 in chips)=20
Seat 5: RG&JP5 ($1.56 in chips)=20
Seat 6: IceAngel82 ($2.03 in chips)=20
Seat 7: Savinf ($2.03 in chips)=20
Seat 8: 1tillit1 ($2.34 in chips)=20
Seat 9: Mielchon ($2 in chips)=20
ILbIO4A: posts small blind $0.01
wilmago17: posts big blind $0.02
*** HOLE CARDS ***
Dealt to the_wickstar [7h 9s]
RG&JP5: folds=20
IceAngel82: raises $0.04 to $0.06
Savinf: folds=20
1tillit1: folds=20
Mielchon: folds=20
the_wickstar: folds=20
Maybe qwer: folds=20
ILbIO4A: folds=20
wilmago17: folds=20
Uncalled bet ($0.04) returned to IceAngel82
IceAngel82 collected $0.05 from pot
IceAngel82: doesn't show hand=20
*** SUMMARY ***
Total pot $0.05 | Rake $0=20
Seat 1: the_wickstar folded before Flop (didn't bet)
Seat 2: Maybe qwer (button) folded before Flop (didn't bet)
Seat 3: ILbIO4A (small blind) folded before Flop
Seat 4: wilmago17 (big blind) folded before Flop
Seat 5: RG&JP5 folded before Flop (didn't bet)
Seat 6: IceAngel82 collected ($0.05)
Seat 7: Savinf folded before Flop (didn't bet)
Seat 8: 1tillit1 folded before Flop (didn't bet)
Seat 9: Mielchon folded before Flop (didn't bet)


*********** # 175 **************
PokerStars Hand #169849755960:  Hold'em No Limit ($0.01/$0.02 USD) - 20=
17/05/02 22:42:57 CUST [2017/05/02 8:42:57 ET]
Table 'Telephus' 9-max Seat #1 is the button
Seat 1: the_wickstar ($1.15 in chips)=20
Seat 2: Maybe qwer ($1.72 in chips)=20
Seat 3: ILbIO4A ($5.52 in chips)=20
Seat 4: wilmago17 ($2.14 in chips)=20
Seat 5: RG&JP5 ($1.56 in chips)=20
Seat 6: IceAngel82 ($2.03 in chips)=20
Seat 7: Savinf ($2.03 in chips)=20
Seat 8: 1tillit1 ($2.34 in chips)=20
Seat 9: Mielchon ($2 in chips)=20
Maybe qwer: posts small blind $0.01
ILbIO4A: posts big blind $0.02
*** HOLE CARDS ***
Dealt to the_wickstar [Ac 8h]
wilmago17: folds=20
RG&JP5: folds=20
IceAngel82: folds=20
Savinf: folds=20
1tillit1: folds=20
Mielchon: folds=20
the_wickstar: calls $0.02
Maybe qwer: folds=20
ILbIO4A: checks=20
*** FLOP *** [4h Ah 8d]
ILbIO4A: checks=20
the_wickstar: bets $0.02
ILbIO4A: folds=20
Uncalled bet ($0.02) returned to the_wickstar
the_wickstar collected $0.05 from pot
*** SUMMARY ***
Total pot $0.05 | Rake $0=20
Board [4h Ah 8d]
Seat 1: the_wickstar (button) collected ($0.05)
Seat 2: Maybe qwer (small blind) folded before Flop
Seat 3: ILbIO4A (big blind) folded on the Flop
Seat 4: wilmago17 folded before Flop (didn't bet)
Seat 5: RG&JP5 folded before Flop (didn't bet)
Seat 6: IceAngel82 folded before Flop (didn't bet)
Seat 7: Savinf folded before Flop (didn't bet)
Seat 8: 1tillit1 folded before Flop (didn't bet)
Seat 9: Mielchon folded before Flop (didn't bet)


*********** # 176 **************
PokerStars Hand #169849742573:  Hold'em No Limit ($0.01/$0.02 USD) - 20=
17/05/02 22:42:29 CUST [2017/05/02 8:42:29 ET]
Table 'Telephus' 9-max Seat #9 is the button
Seat 1: the_wickstar ($1.16 in chips)=20
Seat 2: Maybe qwer ($1.74 in chips)=20
Seat 3: ILbIO4A ($5.52 in chips)=20
Seat 4: wilmago17 ($2.11 in chips)=20
Seat 5: RG&JP5 ($1.56 in chips)=20
Seat 6: IceAngel82 ($2.03 in chips)=20
Seat 7: Savinf ($2.03 in chips)=20
Seat 8: 1tillit1 ($2.34 in chips)=20
Seat 9: Mielchon ($2 in chips)=20
the_wickstar: posts small blind $0.01
Maybe qwer: posts big blind $0.02
*** HOLE CARDS ***
Dealt to the_wickstar [Qh 5s]
ILbIO4A: folds=20
wilmago17: raises $0.06 to $0.08
RG&JP5: folds=20
IceAngel82: folds=20
Savinf: folds=20
1tillit1: folds=20
Mielchon: folds=20
the_wickstar: folds=20
Maybe qwer: folds=20
Uncalled bet ($0.06) returned to wilmago17
wilmago17 collected $0.05 from pot
wilmago17: doesn't show hand=20
*** SUMMARY ***
Total pot $0.05 | Rake $0=20
Seat 1: the_wickstar (small blind) folded before Flop
Seat 2: Maybe qwer (big blind) folded before Flop
Seat 3: ILbIO4A folded before Flop (didn't bet)
Seat 4: wilmago17 collected ($0.05)
Seat 5: RG&JP5 folded before Flop (didn't bet)
Seat 6: IceAngel82 folded before Flop (didn't bet)
Seat 7: Savinf folded before Flop (didn't bet)
Seat 8: 1tillit1 folded before Flop (didn't bet)
Seat 9: Mielchon (button) folded before Flop (didn't bet)


*********** # 177 **************
PokerStars Hand #169849721015:  Hold'em No Limit ($0.01/$0.02 USD) - 20=
17/05/02 22:41:45 CUST [2017/05/02 8:41:45 ET]
Table 'Botha' 9-max Seat #3 is the button
Seat 1: zartovskiy ($2.83 in chips)=20
Seat 3: Sprut2013 ($2.80 in chips)=20
Seat 5: Tikinh00 ($0.85 in chips)=20
Seat 6: diment76 ($1.46 in chips)=20
Seat 7: the_wickstar ($1.58 in chips)=20
Seat 8: Dooley121 ($3.11 in chips)=20
Seat 9: obama552 ($2.05 in chips)=20
Vlad1slav S. will be allowed to play after the button
Tikinh00: posts small blind $0.01
diment76: posts big blind $0.02
PAMEGERA: sits out=20
*** HOLE CARDS ***
Dealt to the_wickstar [As 5s]
the_wickstar: folds=20
Dooley121: folds=20
obama552: folds=20
zartovskiy: raises $0.04 to $0.06
Sprut2013: calls $0.06
Tikinh00: calls $0.05
diment76: folds=20
*** FLOP *** [2s 4c Ad]
Tikinh00: checks=20
zartovskiy: bets $0.10
Sprut2013: folds=20
Tikinh00: calls $0.10
*** TURN *** [2s 4c Ad] [Kd]
Tikinh00: checks=20
zartovskiy: bets $0.20
Tikinh00: calls $0.20
*** RIVER *** [2s 4c Ad Kd] [2h]
Tikinh00: checks=20
zartovskiy: checks=20
*** SHOW DOWN ***
Tikinh00: shows [9h 9c] (two pair, Nines and Deuces)
zartovskiy: mucks hand=20
Tikinh00 collected $0.77 from pot
*** SUMMARY ***
Total pot $0.80 | Rake $0.03=20
Board [2s 4c Ad Kd 2h]
Seat 1: zartovskiy mucked [Td Qs]
Seat 3: Sprut2013 (button) folded on the Flop
Seat 5: Tikinh00 (small blind) showed [9h 9c] and won ($0.77) with two =
pair, Nines and Deuces
Seat 6: diment76 (big blind) folded before Flop
Seat 7: the_wickstar folded before Flop (didn't bet)
Seat 8: Dooley121 folded before Flop (didn't bet)
Seat 9: obama552 folded before Flop (didn't bet)


*********** # 178 **************
PokerStars Hand #169849714611:  Hold'em No Limit ($0.01/$0.02 USD) - 20=
17/05/02 22:41:32 CUST [2017/05/02 8:41:32 ET]
Table 'Telephus' 9-max Seat #8 is the button
Seat 1: the_wickstar ($1.10 in chips)=20
Seat 2: Maybe qwer ($1.74 in chips)=20
Seat 3: ILbIO4A ($5.52 in chips)=20
Seat 4: wilmago17 ($2.11 in chips)=20
Seat 5: RG&JP5 ($1.56 in chips)=20
Seat 6: IceAngel82 ($2.03 in chips)=20
Seat 7: Savinf ($2.03 in chips)=20
Seat 8: 1tillit1 ($2.39 in chips)=20
Seat 9: Mielchon ($2.01 in chips)=20
Mielchon: posts small blind $0.01
the_wickstar: posts big blind $0.02
*** HOLE CARDS ***
Dealt to the_wickstar [Th Td]
Maybe qwer: folds=20
ILbIO4A: folds=20
wilmago17: folds=20
RG&JP5: folds=20
IceAngel82: folds=20
Savinf: folds=20
1tillit1: raises $0.03 to $0.05
Mielchon: folds=20
the_wickstar: calls $0.03
*** FLOP *** [3c 6d Jh]
the_wickstar: bets $0.06
1tillit1: folds=20
Uncalled bet ($0.06) returned to the_wickstar
the_wickstar collected $0.11 from pot
*** SUMMARY ***
Total pot $0.11 | Rake $0=20
Board [3c 6d Jh]
Seat 1: the_wickstar (big blind) collected ($0.11)
Seat 2: Maybe qwer folded before Flop (didn't bet)
Seat 3: ILbIO4A folded before Flop (didn't bet)
Seat 4: wilmago17 folded before Flop (didn't bet)
Seat 5: RG&JP5 folded before Flop (didn't bet)
Seat 6: IceAngel82 folded before Flop (didn't bet)
Seat 7: Savinf folded before Flop (didn't bet)
Seat 8: 1tillit1 (button) folded on the Flop
Seat 9: Mielchon (small blind) folded before Flop


*********** # 179 **************
PokerStars Hand #169849678522:  Hold'em No Limit ($0.01/$0.02 USD) - 20=
17/05/02 22:40:19 CUST [2017/05/02 8:40:19 ET]
Table 'Botha' 9-max Seat #1 is the button
Seat 1: zartovskiy ($2.83 in chips)=20
Seat 3: Sprut2013 ($2.82 in chips)=20
Seat 5: Tikinh00 ($0.87 in chips)=20
Seat 6: diment76 ($1.46 in chips)=20
Seat 7: the_wickstar ($1.64 in chips)=20
Seat 8: Dooley121 ($3.02 in chips)=20
Seat 9: obama552 ($2.05 in chips)=20
PAMEGERA will be allowed to play after the button
Sprut2013: posts small blind $0.01
WebCamSasha: is sitting out=20
Tikinh00: posts big blind $0.02
*** HOLE CARDS ***
Dealt to the_wickstar [6h 6c]
diment76: folds=20
WebCamSasha leaves the table
the_wickstar: calls $0.02
Dooley121: calls $0.02
obama552 has timed out
obama552: folds=20
Vlad1slav S. joins the table at seat #4=20
zartovskiy: folds=20
Sprut2013: calls $0.01
Tikinh00: checks=20
*** FLOP *** [8h 4s Qh]
Sprut2013: checks=20
Tikinh00: checks=20
the_wickstar: checks=20
Dooley121: checks=20
*** TURN *** [8h 4s Qh] [Ad]
Sprut2013: checks=20
Tikinh00: checks=20
the_wickstar: checks=20
Dooley121: bets $0.04
Sprut2013: folds=20
Tikinh00: folds=20
the_wickstar: calls $0.04
*** RIVER *** [8h 4s Qh Ad] [9h]
the_wickstar: checks=20
Dooley121: checks=20
*** SHOW DOWN ***
the_wickstar: shows [6h 6c] (a pair of Sixes)
Dooley121: shows [As 2s] (a pair of Aces)
Dooley121 collected $0.15 from pot
*** SUMMARY ***
Total pot $0.16 | Rake $0.01=20
Board [8h 4s Qh Ad 9h]
Seat 1: zartovskiy (button) folded before Flop (didn't bet)
Seat 3: Sprut2013 (small blind) folded on the Turn
Seat 5: Tikinh00 (big blind) folded on the Turn
Seat 6: diment76 folded before Flop (didn't bet)
Seat 7: the_wickstar showed [6h 6c] and lost with a pair of Sixes
Seat 8: Dooley121 showed [As 2s] and won ($0.15) with a pair of Aces
Seat 9: obama552 folded before Flop (didn't bet)


*********** # 180 **************
PokerStars Hand #169849633424:  Hold'em No Limit ($0.01/$0.02 USD) - 20=
17/05/02 22:38:46 CUST [2017/05/02 8:38:46 ET]
Table 'Botha' 9-max Seat #9 is the button
Seat 1: zartovskiy ($2.84 in chips)=20
Seat 3: Sprut2013 ($2.84 in chips)=20
Seat 4: WebCamSasha ($2 in chips)=20
Seat 5: Tikinh00 ($0.79 in chips)=20
Seat 6: diment76 ($1.46 in chips)=20
Seat 7: the_wickstar ($1.70 in chips)=20
Seat 8: Dooley121 ($3.02 in chips)=20
Seat 9: obama552 ($2.05 in chips)=20
zartovskiy: posts small blind $0.01
Sprut2013: posts big blind $0.02
*** HOLE CARDS ***
Dealt to the_wickstar [Kd 9h]
WebCamSasha: folds=20
Tikinh00: calls $0.02
diment76: folds=20
the_wickstar: calls $0.02
Dooley121: folds=20
obama552: folds=20
zartovskiy: folds=20
Sprut2013: checks=20
*** FLOP *** [Jc As 5d]
Sprut2013: checks=20
Tikinh00: checks=20
the_wickstar: bets $0.04
Sprut2013: folds=20
Tikinh00: calls $0.04
*** TURN *** [Jc As 5d] [4h]
Tikinh00: checks=20
the_wickstar: checks=20
*** RIVER *** [Jc As 5d 4h] [Qs]
Tikinh00: bets $0.07
the_wickstar: folds=20
Uncalled bet ($0.07) returned to Tikinh00
Tikinh00 collected $0.14 from pot
Tikinh00: doesn't show hand=20
*** SUMMARY ***
Total pot $0.15 | Rake $0.01=20
Board [Jc As 5d 4h Qs]
Seat 1: zartovskiy (small blind) folded before Flop
Seat 3: Sprut2013 (big blind) folded on the Flop
Seat 4: WebCamSasha folded before Flop (didn't bet)
Seat 5: Tikinh00 collected ($0.14)
Seat 6: diment76 folded before Flop (didn't bet)
Seat 7: the_wickstar folded on the River
Seat 8: Dooley121 folded before Flop (didn't bet)
Seat 9: obama552 (button) folded before Flop (didn't bet)


*********** # 181 **************
PokerStars Hand #169849598394:  Hold'em No Limit ($0.01/$0.02 USD) - 20=
17/05/02 22:37:35 CUST [2017/05/02 8:37:35 ET]
Table 'Botha' 9-max Seat #8 is the button
Seat 1: zartovskiy ($2.79 in chips)=20
Seat 3: Sprut2013 ($2.84 in chips)=20
Seat 4: WebCamSasha ($2 in chips)=20
Seat 5: Tikinh00 ($0.79 in chips)=20
Seat 6: diment76 ($1.48 in chips)=20
Seat 7: the_wickstar ($1.70 in chips)=20
Seat 8: Dooley121 ($3.04 in chips)=20
Seat 9: obama552 ($2.06 in chips)=20
obama552: posts small blind $0.01
zartovskiy: posts big blind $0.02
*** HOLE CARDS ***
Dealt to the_wickstar [Kd 8h]
Sprut2013: folds=20
WebCamSasha: folds=20
Tikinh00: folds=20
diment76: calls $0.02
the_wickstar has timed out
the_wickstar: folds=20
Dooley121: calls $0.02
obama552: folds=20
zartovskiy: raises $0.08 to $0.10
diment76: folds=20
Dooley121: folds=20
Uncalled bet ($0.08) returned to zartovskiy
zartovskiy collected $0.07 from pot
zartovskiy: doesn't show hand=20
*** SUMMARY ***
Total pot $0.07 | Rake $0=20
Seat 1: zartovskiy (big blind) collected ($0.07)
Seat 3: Sprut2013 folded before Flop (didn't bet)
Seat 4: WebCamSasha folded before Flop (didn't bet)
Seat 5: Tikinh00 folded before Flop (didn't bet)
Seat 6: diment76 folded before Flop
Seat 7: the_wickstar folded before Flop (didn't bet)
Seat 8: Dooley121 (button) folded before Flop
Seat 9: obama552 (small blind) folded before Flop


*********** # 182 **************
PokerStars Hand #169849564515:  Hold'em No Limit ($0.01/$0.02 USD) - 20=
17/05/02 22:36:25 CUST [2017/05/02 8:36:25 ET]
Table 'Botha' 9-max Seat #7 is the button
Seat 1: zartovskiy ($2.79 in chips)=20
Seat 3: Sprut2013 ($2.84 in chips)=20
Seat 4: WebCamSasha ($2 in chips)=20
Seat 5: Tikinh00 ($0.79 in chips)=20
Seat 6: diment76 ($1.48 in chips)=20
Seat 7: the_wickstar ($1.70 in chips)=20
Seat 8: Dooley121 ($2.95 in chips)=20
Seat 9: obama552 ($2.16 in chips)=20
Dooley121: posts small blind $0.01
obama552: posts big blind $0.02
*** HOLE CARDS ***
Dealt to the_wickstar [Ts 8d]
zartovskiy has timed out
zartovskiy: folds=20
Sprut2013: folds=20
WebCamSasha: folds=20
Tikinh00: folds=20
diment76: folds=20
the_wickstar: folds=20
Dooley121: raises $0.04 to $0.06
obama552: calls $0.04
*** FLOP *** [Qs 9c 3c]
Dooley121: bets $0.02
obama552: calls $0.02
*** TURN *** [Qs 9c 3c] [5d]
Dooley121: bets $0.02
obama552: calls $0.02
*** RIVER *** [Qs 9c 3c 5d] [Kc]
Dooley121: bets $0.19
obama552: folds=20
Uncalled bet ($0.19) returned to Dooley121
Dooley121 collected $0.19 from pot
*** SUMMARY ***
Total pot $0.20 | Rake $0.01=20
Board [Qs 9c 3c 5d Kc]
Seat 1: zartovskiy folded before Flop (didn't bet)
Seat 3: Sprut2013 folded before Flop (didn't bet)
Seat 4: WebCamSasha folded before Flop (didn't bet)
Seat 5: Tikinh00 folded before Flop (didn't bet)
Seat 6: diment76 folded before Flop (didn't bet)
Seat 7: the_wickstar (button) folded before Flop (didn't bet)
Seat 8: Dooley121 (small blind) collected ($0.19)
Seat 9: obama552 (big blind) folded on the River


*********** # 183 **************
PokerStars Hand #169849556858:  Hold'em No Limit ($0.01/$0.02 USD) - 20=
17/05/02 22:36:09 CUST [2017/05/02 8:36:09 ET]
Table 'Telephus' 9-max Seat #7 is the button
Seat 1: the_wickstar ($0.46 in chips)=20
Seat 2: Maybe qwer ($1.27 in chips)=20
Seat 3: ILbIO4A ($5.47 in chips)=20
Seat 4: wilmago17 ($2.19 in chips)=20
Seat 6: IceAngel82 ($2.06 in chips)=20
Seat 7: Savinf ($2 in chips)=20
Seat 8: 1tillit1 ($2.40 in chips)=20
Seat 9: Mielchon ($1.60 in chips)=20
1tillit1: posts small blind $0.01
Mielchon: posts big blind $0.02
*** HOLE CARDS ***
Dealt to the_wickstar [4d 4h]
the_wickstar: calls $0.02
Maybe qwer: folds=20
ILbIO4A: folds=20
wilmago17: folds=20
IceAngel82: folds=20
Savinf: folds=20
1tillit1: folds=20
Mielchon: checks=20
*** FLOP *** [3h 2h 2s]
Mielchon: bets $0.05
the_wickstar: calls $0.05
*** TURN *** [3h 2h 2s] [7s]
Mielchon: bets $0.07
the_wickstar: calls $0.07
*** RIVER *** [3h 2h 2s 7s] [Ah]
Mielchon: checks=20
the_wickstar: bets $0.32 and is all-in
Mielchon: calls $0.32
*** SHOW DOWN ***
the_wickstar: shows [4d 4h] (two pair, Fours and Deuces)
Mielchon: shows [7h Qs] (two pair, Sevens and Deuces)
Mielchon collected $0.90 from pot
*** SUMMARY ***
Total pot $0.93 | Rake $0.03=20
Board [3h 2h 2s 7s Ah]
Seat 1: the_wickstar showed [4d 4h] and lost with two pair, Fours and D=
euces
Seat 2: Maybe qwer folded before Flop (didn't bet)
Seat 3: ILbIO4A folded before Flop (didn't bet)
Seat 4: wilmago17 folded before Flop (didn't bet)
Seat 6: IceAngel82 folded before Flop (didn't bet)
Seat 7: Savinf (button) folded before Flop (didn't bet)
Seat 8: 1tillit1 (small blind) folded before Flop
Seat 9: Mielchon (big blind) showed [7h Qs] and won ($0.90) with two pa=
ir, Sevens and Deuces


*********** # 184 **************
PokerStars Hand #169849535347:  Hold'em No Limit ($0.01/$0.02 USD) - 20=
17/05/02 22:35:25 CUST [2017/05/02 8:35:25 ET]
Table 'Telephus' 9-max Seat #6 is the button
Seat 1: the_wickstar ($0.43 in chips)=20
Seat 2: Maybe qwer ($1.27 in chips)=20
Seat 3: ILbIO4A ($5.47 in chips)=20
Seat 4: wilmago17 ($2.19 in chips)=20
Seat 6: IceAngel82 ($2.06 in chips)=20
Seat 7: Savinf ($2 in chips)=20
Seat 8: 1tillit1 ($2.42 in chips)=20
Seat 9: Mielchon ($1.60 in chips)=20
Savinf: posts small blind $0.01
1tillit1: posts big blind $0.02
*** HOLE CARDS ***
Dealt to the_wickstar [3d 3c]
Mielchon: folds=20
the_wickstar: calls $0.02
Maybe qwer: folds=20
ILbIO4A: folds=20
wilmago17: folds=20
IceAngel82: folds=20
Savinf: folds=20
1tillit1: checks=20
*** FLOP *** [Jd Js 4s]
1tillit1: checks=20
the_wickstar: checks=20
*** TURN *** [Jd Js 4s] [2s]
1tillit1: checks=20
the_wickstar: checks=20
*** RIVER *** [Jd Js 4s 2s] [3h]
1tillit1: checks=20
the_wickstar: bets $0.02
1tillit1: folds=20
Uncalled bet ($0.02) returned to the_wickstar
the_wickstar collected $0.05 from pot
*** SUMMARY ***
Total pot $0.05 | Rake $0=20
Board [Jd Js 4s 2s 3h]
Seat 1: the_wickstar collected ($0.05)
Seat 2: Maybe qwer folded before Flop (didn't bet)
Seat 3: ILbIO4A folded before Flop (didn't bet)
Seat 4: wilmago17 folded before Flop (didn't bet)
Seat 6: IceAngel82 (button) folded before Flop (didn't bet)
Seat 7: Savinf (small blind) folded before Flop
Seat 8: 1tillit1 (big blind) folded on the River
Seat 9: Mielchon folded before Flop (didn't bet)


*********** # 185 **************
PokerStars Hand #169849525024:  Hold'em No Limit ($0.01/$0.02 USD) - 20=
17/05/02 22:35:03 CUST [2017/05/02 8:35:03 ET]
Table 'Telephus' 9-max Seat #4 is the button
Seat 1: the_wickstar ($0.43 in chips)=20
Seat 2: Maybe qwer ($1.27 in chips)=20
Seat 3: ILbIO4A ($5.47 in chips)=20
Seat 4: wilmago17 ($2.16 in chips)=20
Seat 6: IceAngel82 ($2.07 in chips)=20
Seat 7: Savinf ($2 in chips)=20
Seat 8: 1tillit1 ($2.42 in chips)=20
Seat 9: Mielchon ($1.60 in chips)=20
IceAngel82: posts small blind $0.01
Savinf: posts big blind $0.02
*** HOLE CARDS ***
Dealt to the_wickstar [6c Kc]
1tillit1: folds=20
Mielchon: folds=20
the_wickstar: folds=20
Maybe qwer: folds=20
ILbIO4A: folds=20
wilmago17: raises $0.03 to $0.05
IceAngel82: folds=20
Savinf: folds=20
Uncalled bet ($0.03) returned to wilmago17
wilmago17 collected $0.05 from pot
wilmago17: doesn't show hand=20
*** SUMMARY ***
Total pot $0.05 | Rake $0=20
Seat 1: the_wickstar folded before Flop (didn't bet)
Seat 2: Maybe qwer folded before Flop (didn't bet)
Seat 3: ILbIO4A folded before Flop (didn't bet)
Seat 4: wilmago17 (button) collected ($0.05)
Seat 6: IceAngel82 (small blind) folded before Flop
Seat 7: Savinf (big blind) folded before Flop
Seat 8: 1tillit1 folded before Flop (didn't bet)
Seat 9: Mielchon folded before Flop (didn't bet)


*********** # 186 **************
PokerStars Hand #169849524189:  Hold'em No Limit ($0.01/$0.02 USD) - 20=
17/05/02 22:35:02 CUST [2017/05/02 8:35:02 ET]
Table 'Botha' 9-max Seat #6 is the button
Seat 1: zartovskiy ($2.95 in chips)=20
Seat 3: Sprut2013 ($2.62 in chips)=20
Seat 4: WebCamSasha ($2 in chips)=20
Seat 5: Tikinh00 ($0.79 in chips)=20
Seat 6: diment76 ($1.48 in chips)=20
Seat 7: the_wickstar ($1.71 in chips)=20
Seat 8: Dooley121 ($3.01 in chips)=20
Seat 9: obama552 ($2.16 in chips)=20
the_wickstar: posts small blind $0.01
Dooley121: posts big blind $0.02
*** HOLE CARDS ***
Dealt to the_wickstar [3h 2d]
obama552: folds=20
zartovskiy: raises $0.04 to $0.06
Sprut2013: calls $0.06
WebCamSasha: folds=20
Tikinh00: folds=20
diment76: folds=20
the_wickstar: folds=20
Dooley121: calls $0.04
*** FLOP *** [Qh 2s Kd]
Dooley121: checks=20
zartovskiy: bets $0.10
Sprut2013: calls $0.10
Dooley121: folds=20
*** TURN *** [Qh 2s Kd] [6h]
zartovskiy: checks=20
Sprut2013: checks=20
*** RIVER *** [Qh 2s Kd 6h] [9s]
zartovskiy: checks=20
Sprut2013: bets $0.19
zartovskiy: folds=20
Uncalled bet ($0.19) returned to Sprut2013
Sprut2013 collected $0.38 from pot
Sprut2013: doesn't show hand=20
*** SUMMARY ***
Total pot $0.39 | Rake $0.01=20
Board [Qh 2s Kd 6h 9s]
Seat 1: zartovskiy folded on the River
Seat 3: Sprut2013 collected ($0.38)
Seat 4: WebCamSasha folded before Flop (didn't bet)
Seat 5: Tikinh00 folded before Flop (didn't bet)
Seat 6: diment76 (button) folded before Flop (didn't bet)
Seat 7: the_wickstar (small blind) folded before Flop
Seat 8: Dooley121 (big blind) folded on the Flop
Seat 9: obama552 folded before Flop (didn't bet)


*********** # 187 **************
PokerStars Hand #169849512868:  Hold'em No Limit ($0.01/$0.02 USD) - 20=
17/05/02 22:34:38 CUST [2017/05/02 8:34:38 ET]
Table 'Telephus' 9-max Seat #3 is the button
Seat 1: the_wickstar ($0.43 in chips)=20
Seat 2: Maybe qwer ($1.27 in chips)=20
Seat 3: ILbIO4A ($5.47 in chips)=20
Seat 4: wilmago17 ($2.08 in chips)=20
Seat 6: IceAngel82 ($2.09 in chips)=20
Seat 8: 1tillit1 ($2.42 in chips)=20
Seat 9: Mielchon ($1.66 in chips)=20
wilmago17: posts small blind $0.01
IceAngel82: posts big blind $0.02
Savinf: sits out=20
*** HOLE CARDS ***
Dealt to the_wickstar [8c 6c]
1tillit1: folds=20
Mielchon: raises $0.04 to $0.06
the_wickstar: folds=20
Maybe qwer: folds=20
ILbIO4A: folds=20
wilmago17: raises $0.14 to $0.20
IceAngel82: folds=20
Mielchon: folds=20
Uncalled bet ($0.14) returned to wilmago17
wilmago17 collected $0.14 from pot
wilmago17: doesn't show hand=20
*** SUMMARY ***
Total pot $0.14 | Rake $0=20
Seat 1: the_wickstar folded before Flop (didn't bet)
Seat 2: Maybe qwer folded before Flop (didn't bet)
Seat 3: ILbIO4A (button) folded before Flop (didn't bet)
Seat 4: wilmago17 (small blind) collected ($0.14)
Seat 6: IceAngel82 (big blind) folded before Flop
Seat 8: 1tillit1 folded before Flop (didn't bet)
Seat 9: Mielchon folded before Flop


*********** # 188 **************
PokerStars Hand #169849507643:  Hold'em No Limit ($0.01/$0.02 USD) - 20=
17/05/02 22:34:27 CUST [2017/05/02 8:34:27 ET]
Table 'Botha' 9-max Seat #5 is the button
Seat 1: zartovskiy ($2.95 in chips)=20
Seat 3: Sprut2013 ($2.59 in chips)=20
Seat 4: WebCamSasha ($2 in chips)=20
Seat 5: Tikinh00 ($0.79 in chips)=20
Seat 6: diment76 ($1.49 in chips)=20
Seat 7: the_wickstar ($1.73 in chips)=20
Seat 8: Dooley121 ($3.01 in chips)=20
Seat 9: obama552 ($2.16 in chips)=20
diment76: posts small blind $0.01
the_wickstar: posts big blind $0.02
*** HOLE CARDS ***
Dealt to the_wickstar [Jc 6h]
Dooley121: folds=20
obama552: folds=20
zartovskiy: folds=20
Sprut2013: raises $0.06 to $0.08
WebCamSasha: folds=20
Tikinh00: folds=20
diment76: folds=20
the_wickstar: folds=20
Uncalled bet ($0.06) returned to Sprut2013
Sprut2013 collected $0.05 from pot
Sprut2013: doesn't show hand=20
*** SUMMARY ***
Total pot $0.05 | Rake $0=20
Seat 1: zartovskiy folded before Flop (didn't bet)
Seat 3: Sprut2013 collected ($0.05)
Seat 4: WebCamSasha folded before Flop (didn't bet)
Seat 5: Tikinh00 (button) folded before Flop (didn't bet)
Seat 6: diment76 (small blind) folded before Flop
Seat 7: the_wickstar (big blind) folded before Flop
Seat 8: Dooley121 folded before Flop (didn't bet)
Seat 9: obama552 folded before Flop (didn't bet)


*********** # 189 **************
PokerStars Hand #169849500599:  Hold'em No Limit ($0.01/$0.02 USD) - 20=
17/05/02 22:34:12 CUST [2017/05/02 8:34:12 ET]
Table 'Telephus' 9-max Seat #2 is the button
Seat 1: the_wickstar ($0.43 in chips)=20
Seat 2: Maybe qwer ($1.24 in chips)=20
Seat 3: ILbIO4A ($5.48 in chips)=20
Seat 4: wilmago17 ($2.10 in chips)=20
Seat 6: IceAngel82 ($2.09 in chips)=20
Seat 8: 1tillit1 ($2.42 in chips)=20
Seat 9: Mielchon ($1.66 in chips)=20
ILbIO4A: posts small blind $0.01
wilmago17: posts big blind $0.02
Savinf: sits out=20
*** HOLE CARDS ***
Dealt to the_wickstar [As 6s]
IceAngel82: folds=20
1tillit1: folds=20
Mielchon: folds=20
the_wickstar: folds=20
Maybe qwer: raises $0.02 to $0.04
ILbIO4A: folds=20
wilmago17: folds=20
Uncalled bet ($0.02) returned to Maybe qwer
Maybe qwer collected $0.05 from pot
*** SUMMARY ***
Total pot $0.05 | Rake $0=20
Seat 1: the_wickstar folded before Flop (didn't bet)
Seat 2: Maybe qwer (button) collected ($0.05)
Seat 3: ILbIO4A (small blind) folded before Flop
Seat 4: wilmago17 (big blind) folded before Flop
Seat 6: IceAngel82 folded before Flop (didn't bet)
Seat 8: 1tillit1 folded before Flop (didn't bet)
Seat 9: Mielchon folded before Flop (didn't bet)


*********** # 190 **************
PokerStars Hand #169849472842:  Hold'em No Limit ($0.01/$0.02 USD) - 20=
17/05/02 22:33:15 CUST [2017/05/02 8:33:15 ET]
Table 'Botha' 9-max Seat #4 is the button
Seat 1: zartovskiy ($2.95 in chips)=20
Seat 3: Sprut2013 ($2.59 in chips)=20
Seat 4: WebCamSasha ($2 in chips)=20
Seat 5: Tikinh00 ($0.75 in chips)=20
Seat 6: diment76 ($1.53 in chips)=20
Seat 7: the_wickstar ($1.73 in chips)=20
Seat 8: Dooley121 ($3.01 in chips)=20
Seat 9: obama552 ($2.16 in chips)=20
Tikinh00: posts small blind $0.01
diment76: posts big blind $0.02
*** HOLE CARDS ***
Dealt to the_wickstar [6d 9d]
the_wickstar: folds=20
Dooley121: folds=20
obama552: folds=20
zartovskiy: folds=20
Sprut2013: folds=20
WebCamSasha has timed out
WebCamSasha: folds=20
Tikinh00: calls $0.01
diment76: checks=20
*** FLOP *** [9s Jh Ts]
Tikinh00: bets $0.02
diment76: calls $0.02
*** TURN *** [9s Jh Ts] [5s]
Tikinh00: checks=20
diment76: checks=20
*** RIVER *** [9s Jh Ts 5s] [3s]
Tikinh00: checks=20
diment76: checks=20
*** SHOW DOWN ***
Tikinh00: shows [Jd Th] (two pair, Jacks and Tens)
diment76: mucks hand=20
Tikinh00 collected $0.08 from pot
*** SUMMARY ***
Total pot $0.08 | Rake $0=20
Board [9s Jh Ts 5s 3s]
Seat 1: zartovskiy folded before Flop (didn't bet)
Seat 3: Sprut2013 folded before Flop (didn't bet)
Seat 4: WebCamSasha (button) folded before Flop (didn't bet)
Seat 5: Tikinh00 (small blind) showed [Jd Th] and won ($0.08) with two =
pair, Jacks and Tens
Seat 6: diment76 (big blind) mucked [3h Qh]
Seat 7: the_wickstar folded before Flop (didn't bet)
Seat 8: Dooley121 folded before Flop (didn't bet)
Seat 9: obama552 folded before Flop (didn't bet)


*********** # 191 **************
PokerStars Hand #169849468271:  Hold'em No Limit ($0.01/$0.02 USD) - 20=
17/05/02 22:33:05 CUST [2017/05/02 8:33:05 ET]
Table 'Telephus' 9-max Seat #1 is the button
Seat 1: the_wickstar ($0.43 in chips)=20
Seat 2: Maybe qwer ($1.63 in chips)=20
Seat 3: ILbIO4A ($5.54 in chips)=20
Seat 4: wilmago17 ($2.10 in chips)=20
Seat 6: IceAngel82 ($2.09 in chips)=20
Seat 8: 1tillit1 ($2 in chips)=20
Seat 9: Mielchon ($1.66 in chips)=20
Maybe qwer: posts small blind $0.01
ILbIO4A: posts big blind $0.02
Savinf: sits out=20
*** HOLE CARDS ***
Dealt to the_wickstar [9c 4c]
wilmago17: folds=20
IceAngel82: folds=20
1tillit1: raises $0.04 to $0.06
Mielchon: folds=20
the_wickstar: folds=20
Maybe qwer: calls $0.05
ILbIO4A: calls $0.04
*** FLOP *** [6h 6c 4h]
Maybe qwer: checks=20
ILbIO4A: checks=20
1tillit1: bets $0.11
Maybe qwer: calls $0.11
ILbIO4A: folds=20
*** TURN *** [6h 6c 4h] [7d]
Maybe qwer: checks=20
1tillit1: bets $0.22
Maybe qwer: calls $0.22
*** RIVER *** [6h 6c 4h 7d] [6s]
Maybe qwer: checks=20
1tillit1: bets $0.44
Maybe qwer: folds=20
Uncalled bet ($0.44) returned to 1tillit1
1tillit1 collected $0.81 from pot
1tillit1: doesn't show hand=20
*** SUMMARY ***
Total pot $0.84 | Rake $0.03=20
Board [6h 6c 4h 7d 6s]
Seat 1: the_wickstar (button) folded before Flop (didn't bet)
Seat 2: Maybe qwer (small blind) folded on the River
Seat 3: ILbIO4A (big blind) folded on the Flop
Seat 4: wilmago17 folded before Flop (didn't bet)
Seat 6: IceAngel82 folded before Flop (didn't bet)
Seat 8: 1tillit1 collected ($0.81)
Seat 9: Mielchon folded before Flop (didn't bet)


*********** # 192 **************
PokerStars Hand #169849454223:  Hold'em No Limit ($0.01/$0.02 USD) - 20=
17/05/02 22:32:36 CUST [2017/05/02 8:32:36 ET]
Table 'Telephus' 9-max Seat #9 is the button
Seat 1: the_wickstar ($0.44 in chips)=20
Seat 2: Maybe qwer ($1.65 in chips)=20
Seat 3: ILbIO4A ($5.54 in chips)=20
Seat 4: wilmago17 ($2.07 in chips)=20
Seat 6: IceAngel82 ($2.09 in chips)=20
Seat 8: 1tillit1 ($2 in chips)=20
Seat 9: Mielchon ($1.66 in chips)=20
the_wickstar: posts small blind $0.01
Maybe qwer: posts big blind $0.02
Savinf: sits out=20
*** HOLE CARDS ***
Dealt to the_wickstar [7s 7d]
ILbIO4A: folds=20
wilmago17: raises $0.06 to $0.08
IceAngel82: folds=20
1tillit1: folds=20
Mielchon: folds=20
the_wickstar: folds=20
Maybe qwer: folds=20
Uncalled bet ($0.06) returned to wilmago17
wilmago17 collected $0.05 from pot
wilmago17: doesn't show hand=20
*** SUMMARY ***
Total pot $0.05 | Rake $0=20
Seat 1: the_wickstar (small blind) folded before Flop
Seat 2: Maybe qwer (big blind) folded before Flop
Seat 3: ILbIO4A folded before Flop (didn't bet)
Seat 4: wilmago17 collected ($0.05)
Seat 6: IceAngel82 folded before Flop (didn't bet)
Seat 8: 1tillit1 folded before Flop (didn't bet)
Seat 9: Mielchon (button) folded before Flop (didn't bet)


*********** # 193 **************
PokerStars Hand #169849447663:  Hold'em No Limit ($0.01/$0.02 USD) - 20=
17/05/02 22:32:22 CUST [2017/05/02 8:32:22 ET]
Table 'Botha' 9-max Seat #3 is the button
Seat 1: zartovskiy ($2.89 in chips)=20
Seat 3: Sprut2013 ($2.59 in chips)=20
Seat 4: WebCamSasha ($2 in chips)=20
Seat 5: Tikinh00 ($0.80 in chips)=20
Seat 6: diment76 ($1.53 in chips)=20
Seat 7: the_wickstar ($1.73 in chips)=20
Seat 8: Dooley121 ($3.01 in chips)=20
Seat 9: obama552 ($2.16 in chips)=20
WebCamSasha: posts small blind $0.01
Tikinh00: posts big blind $0.02
*** HOLE CARDS ***
Dealt to the_wickstar [8c Kh]
diment76: folds=20
the_wickstar: folds=20
Dooley121: folds=20
obama552: folds=20
zartovskiy: raises $0.03 to $0.05
Sprut2013: folds=20
WebCamSasha: folds=20
Tikinh00: calls $0.03
*** FLOP *** [5h 9h Kd]
Tikinh00: checks=20
zartovskiy: bets $0.07
Tikinh00: folds=20
Uncalled bet ($0.07) returned to zartovskiy
zartovskiy collected $0.11 from pot
zartovskiy: doesn't show hand=20
*** SUMMARY ***
Total pot $0.11 | Rake $0=20
Board [5h 9h Kd]
Seat 1: zartovskiy collected ($0.11)
Seat 3: Sprut2013 (button) folded before Flop (didn't bet)
Seat 4: WebCamSasha (small blind) folded before Flop
Seat 5: Tikinh00 (big blind) folded on the Flop
Seat 6: diment76 folded before Flop (didn't bet)
Seat 7: the_wickstar folded before Flop (didn't bet)
Seat 8: Dooley121 folded before Flop (didn't bet)
Seat 9: obama552 folded before Flop (didn't bet)


*********** # 194 **************
PokerStars Hand #169849442059:  Hold'em No Limit ($0.01/$0.02 USD) - 20=
17/05/02 22:32:11 CUST [2017/05/02 8:32:11 ET]
Table 'Telephus' 9-max Seat #8 is the button
Seat 1: the_wickstar ($0.46 in chips)=20
Seat 2: Maybe qwer ($1.65 in chips)=20
Seat 3: ILbIO4A ($5.54 in chips)=20
Seat 4: wilmago17 ($2.07 in chips)=20
Seat 6: IceAngel82 ($2.06 in chips)=20
Seat 8: 1tillit1 ($2 in chips)=20
Seat 9: Mielchon ($1.67 in chips)=20
Mielchon: posts small blind $0.01
the_wickstar: posts big blind $0.02
Savinf: sits out=20
*** HOLE CARDS ***
Dealt to the_wickstar [8h 9h]
Maybe qwer: folds=20
ILbIO4A: folds=20
wilmago17: folds=20
IceAngel82: raises $0.04 to $0.06
1tillit1: folds=20
Mielchon: folds=20
the_wickstar: folds=20
Uncalled bet ($0.04) returned to IceAngel82
IceAngel82 collected $0.05 from pot
IceAngel82: doesn't show hand=20
*** SUMMARY ***
Total pot $0.05 | Rake $0=20
Seat 1: the_wickstar (big blind) folded before Flop
Seat 2: Maybe qwer folded before Flop (didn't bet)
Seat 3: ILbIO4A folded before Flop (didn't bet)
Seat 4: wilmago17 folded before Flop (didn't bet)
Seat 6: IceAngel82 collected ($0.05)
Seat 8: 1tillit1 (button) folded before Flop (didn't bet)
Seat 9: Mielchon (small blind) folded before Flop


*********** # 195 **************
PokerStars Hand #169849427981:  Hold'em No Limit ($0.01/$0.02 USD) - 20=
17/05/02 22:31:42 CUST [2017/05/02 8:31:42 ET]
Table 'Telephus' 9-max Seat #6 is the button
Seat 1: the_wickstar ($0.46 in chips)=20
Seat 2: Maybe qwer ($1.69 in chips)=20
Seat 3: ILbIO4A ($5.54 in chips)=20
Seat 4: wilmago17 ($2 in chips)=20
Seat 6: IceAngel82 ($2.06 in chips)=20
Seat 8: 1tillit1 ($2 in chips)=20
Seat 9: Mielchon ($1.69 in chips)=20
Savinf will be allowed to play after the button
1tillit1: posts small blind $0.01
Mielchon: posts big blind $0.02
*** HOLE CARDS ***
Dealt to the_wickstar [9c 4c]
the_wickstar: folds=20
Maybe qwer: raises $0.02 to $0.04
ILbIO4A: folds=20
wilmago17: raises $0.12 to $0.16
IceAngel82: folds=20
1tillit1: folds=20
Mielchon: folds=20
Maybe qwer: folds=20
Uncalled bet ($0.12) returned to wilmago17
wilmago17 collected $0.11 from pot
wilmago17: doesn't show hand=20
*** SUMMARY ***
Total pot $0.11 | Rake $0=20
Seat 1: the_wickstar folded before Flop (didn't bet)
Seat 2: Maybe qwer folded before Flop
Seat 3: ILbIO4A folded before Flop (didn't bet)
Seat 4: wilmago17 collected ($0.11)
Seat 6: IceAngel82 (button) folded before Flop (didn't bet)
Seat 8: 1tillit1 (small blind) folded before Flop
Seat 9: Mielchon (big blind) folded before Flop


*********** # 196 **************
PokerStars Hand #169849426607:  Hold'em No Limit ($0.01/$0.02 USD) - 20=
17/05/02 22:31:39 CUST [2017/05/02 8:31:39 ET]
Table 'Botha' 9-max Seat #1 is the button
Seat 1: zartovskiy ($2.89 in chips)=20
Seat 3: Sprut2013 ($2.65 in chips)=20
Seat 4: WebCamSasha ($2 in chips)=20
Seat 6: diment76 ($1.53 in chips)=20
Seat 7: the_wickstar ($1.65 in chips)=20
Seat 8: Dooley121 ($3.01 in chips)=20
Seat 9: obama552 ($2.16 in chips)=20
Sprut2013: posts small blind $0.01
WebCamSasha: posts big blind $0.02
Tikinh00: sits out=20
*** HOLE CARDS ***
Dealt to the_wickstar [9c 9d]
diment76: folds=20
the_wickstar: raises $0.04 to $0.06
Dooley121: folds=20
obama552: folds=20
zartovskiy: folds=20
Sprut2013: calls $0.05
WebCamSasha: folds=20
*** FLOP *** [Jh 7c 9h]
Sprut2013: checks=20
the_wickstar: bets $0.07
Sprut2013: folds=20
Uncalled bet ($0.07) returned to the_wickstar
the_wickstar collected $0.14 from pot
*** SUMMARY ***
Total pot $0.14 | Rake $0=20
Board [Jh 7c 9h]
Seat 1: zartovskiy (button) folded before Flop (didn't bet)
Seat 3: Sprut2013 (small blind) folded on the Flop
Seat 4: WebCamSasha (big blind) folded before Flop
Seat 6: diment76 folded before Flop (didn't bet)
Seat 7: the_wickstar collected ($0.14)
Seat 8: Dooley121 folded before Flop (didn't bet)
Seat 9: obama552 folded before Flop (didn't bet)


*********** # 197 **************
PokerStars Hand #169849417914:  Hold'em No Limit ($0.01/$0.02 USD) - 20=
17/05/02 22:31:21 CUST [2017/05/02 8:31:21 ET]
Table 'Telephus' 9-max Seat #4 is the button
Seat 1: the_wickstar ($0.46 in chips)=20
Seat 2: Maybe qwer ($1.66 in chips)=20
Seat 3: ILbIO4A ($5.54 in chips)=20
Seat 4: wilmago17 ($2 in chips)=20
Seat 6: IceAngel82 ($2.07 in chips)=20
Seat 8: 1tillit1 ($2 in chips)=20
Seat 9: Mielchon ($1.69 in chips)=20
IceAngel82: posts small blind $0.01
AliceX6: is sitting out=20
1tillit1: posts big blind $0.02
*** HOLE CARDS ***
Dealt to the_wickstar [Ts 4d]
AliceX6 leaves the table
Mielchon: folds=20
the_wickstar: folds=20
Maybe qwer: raises $0.02 to $0.04
Savinf joins the table at seat #7=20
ILbIO4A: folds=20
wilmago17: folds=20
IceAngel82: folds=20
1tillit1: folds=20
Uncalled bet ($0.02) returned to Maybe qwer
Maybe qwer collected $0.05 from pot
*** SUMMARY ***
Total pot $0.05 | Rake $0=20
Seat 1: the_wickstar folded before Flop (didn't bet)
Seat 2: Maybe qwer collected ($0.05)
Seat 3: ILbIO4A folded before Flop (didn't bet)
Seat 4: wilmago17 (button) folded before Flop (didn't bet)
Seat 6: IceAngel82 (small blind) folded before Flop
Seat 8: 1tillit1 (big blind) folded before Flop
Seat 9: Mielchon folded before Flop (didn't bet)


*********** # 198 **************
PokerStars Hand #169849398718:  Hold'em No Limit ($0.01/$0.02 USD) - 20=
17/05/02 22:30:40 CUST [2017/05/02 8:30:40 ET]
Table 'Telephus' 9-max Seat #3 is the button
Seat 1: the_wickstar ($0.46 in chips)=20
Seat 2: Maybe qwer ($1.66 in chips)=20
Seat 3: ILbIO4A ($5.54 in chips)=20
Seat 4: wilmago17 ($2.01 in chips)=20
Seat 6: IceAngel82 ($2 in chips)=20
Seat 7: AliceX6 ($2.21 in chips)=20
Seat 8: 1tillit1 ($2 in chips)=20
Seat 9: Mielchon ($1.69 in chips)=20
wilmago17: posts small blind $0.01
IceAngel82: posts big blind $0.02
*** HOLE CARDS ***
Dealt to the_wickstar [6h 3h]
AliceX6: raises $0.04 to $0.06
1tillit1: folds=20
Mielchon: folds=20
the_wickstar: folds=20
Maybe qwer: folds=20
ILbIO4A: folds=20
wilmago17: folds=20
IceAngel82: raises $0.14 to $0.20
AliceX6: folds=20
Uncalled bet ($0.14) returned to IceAngel82
IceAngel82 collected $0.13 from pot
IceAngel82: doesn't show hand=20
*** SUMMARY ***
Total pot $0.13 | Rake $0=20
Seat 1: the_wickstar folded before Flop (didn't bet)
Seat 2: Maybe qwer folded before Flop (didn't bet)
Seat 3: ILbIO4A (button) folded before Flop (didn't bet)
Seat 4: wilmago17 (small blind) folded before Flop
Seat 6: IceAngel82 (big blind) collected ($0.13)
Seat 7: AliceX6 folded before Flop
Seat 8: 1tillit1 folded before Flop (didn't bet)
Seat 9: Mielchon folded before Flop (didn't bet)


*********** # 199 **************
PokerStars Hand #169849389907:  Hold'em No Limit ($0.01/$0.02 USD) - 20=
17/05/02 22:30:22 CUST [2017/05/02 8:30:22 ET]
Table 'Telephus' 9-max Seat #2 is the button
Seat 1: the_wickstar ($0.46 in chips)=20
Seat 2: Maybe qwer ($1.66 in chips)=20
Seat 3: ILbIO4A ($5.52 in chips)=20
Seat 4: wilmago17 ($2.03 in chips)=20
Seat 6: IceAngel82 ($2 in chips)=20
Seat 7: AliceX6 ($2.21 in chips)=20
Seat 8: 1tillit1 ($2 in chips)=20
Seat 9: Mielchon ($1.69 in chips)=20
ILbIO4A: posts small blind $0.01
wilmago17: posts big blind $0.02
*** HOLE CARDS ***
Dealt to the_wickstar [3s 2c]
IceAngel82: folds=20
AliceX6: folds=20
1tillit1: folds=20
Mielchon: folds=20
the_wickstar: folds=20
Maybe qwer: folds=20
ILbIO4A: raises $0.03 to $0.05
wilmago17: folds=20
Uncalled bet ($0.03) returned to ILbIO4A
ILbIO4A collected $0.04 from pot
ILbIO4A: doesn't show hand=20
*** SUMMARY ***
Total pot $0.04 | Rake $0=20
Seat 1: the_wickstar folded before Flop (didn't bet)
Seat 2: Maybe qwer (button) folded before Flop (didn't bet)
Seat 3: ILbIO4A (small blind) collected ($0.04)
Seat 4: wilmago17 (big blind) folded before Flop
Seat 6: IceAngel82 folded before Flop (didn't bet)
Seat 7: AliceX6 folded before Flop (didn't bet)
Seat 8: 1tillit1 folded before Flop (didn't bet)
Seat 9: Mielchon folded before Flop (didn't bet)


*********** # 200 **************
PokerStars Hand #169849379379:  Hold'em No Limit ($0.01/$0.02 USD) - 20=
17/05/02 22:30:00 CUST [2017/05/02 8:30:00 ET]
Table 'Botha' 9-max Seat #9 is the button
Seat 1: zartovskiy ($2.58 in chips)=20
Seat 3: Sprut2013 ($2.67 in chips)=20
Seat 4: WebCamSasha ($2 in chips)=20
Seat 5: MarkAvrelij ($2 in chips)=20
Seat 6: diment76 ($1.84 in chips)=20
Seat 7: the_wickstar ($1.65 in chips)=20
Seat 8: Dooley121 ($3.01 in chips)=20
Seat 9: obama552 ($2.16 in chips)=20
zartovskiy: posts small blind $0.01
Sprut2013: posts big blind $0.02
*** HOLE CARDS ***
Dealt to the_wickstar [Js 3d]
WebCamSasha: folds=20
MarkAvrelij has timed out
MarkAvrelij: folds=20
diment76: raises $0.04 to $0.06
the_wickstar: folds=20
Dooley121: folds=20
obama552: folds=20
MarkAvrelij leaves the table
zartovskiy: raises $0.09 to $0.15
Sprut2013: folds=20
diment76: calls $0.09
*** FLOP *** [Qs Jc Kc]
Tikinh00 joins the table at seat #5=20
zartovskiy: checks=20
diment76: bets $0.16
zartovskiy: raises $0.60 to $0.76
diment76: folds=20
Uncalled bet ($0.60) returned to zartovskiy
zartovskiy collected $0.62 from pot
zartovskiy: doesn't show hand=20
*** SUMMARY ***
Total pot $0.64 | Rake $0.02=20
Board [Qs Jc Kc]
Seat 1: zartovskiy (small blind) collected ($0.62)
Seat 3: Sprut2013 (big blind) folded before Flop
Seat 4: WebCamSasha folded before Flop (didn't bet)
Seat 5: MarkAvrelij folded before Flop (didn't bet)
Seat 6: diment76 folded on the Flop
Seat 7: the_wickstar folded before Flop (didn't bet)
Seat 8: Dooley121 folded before Flop (didn't bet)
Seat 9: obama552 (button) folded before Flop (didn't bet)



If you have any questions, please contact us at "PokerStars Support" <s=
upport@pokerstars.com>


