"","HandID","Timestamp","BigBlind","all-in","bets","calls","collected","posts","raises","Uncalled bet","profit","balance","profit_bb","balance_bb","running_sum","running_sum_bb"
"1","169202441319:  ",2017-04-18 02:59:33,0.02,0,0.22,0,0.22,0,0.1,0.22,0.12,0.12,6,6,0,0
"5","169202462725:  ",2017-04-18 03:00:59,0.02,0,0.1,0.02,0.05,0,0,0.1,0.03,0.15,1.5,7.5,0,0
"9","169202475482:  ",2017-04-18 03:01:45,0.02,0,0,0.03,0,0.02,0,0,-0.05,0.1,-2.5,5,0,0
"11","169202500246:  ",2017-04-18 03:03:14,0.02,0,0,0,0,0.01,0,0,-0.01,0.09,-0.5,4.5,0,0
"12","169205560435:  ",2017-04-18 05:38:13,0.05,0,0.45,0.1,0,0.05,0,0,-0.6,-0.51,-12,-7.5,0,0
"15","169205579221:  ",2017-04-18 05:39:00,0.05,1.05,0,0.35,0.69,0,0,1.05,0.34,-0.17,6.8,-0.7,0,0
"20","169205600369:  ",2017-04-18 05:39:53,0.05,0,0,0.05,0,0,0,0,-0.05,-0.22,-1,-1.7,0,0
"21","169205615781:  ",2017-04-18 05:40:32,0.05,0,0.17,0.1,0.31,0.05,0,0.17,0.16,-0.06,3.2,1.5,0,0
"26","169205629324:  ",2017-04-18 05:41:06,0.05,0,0,0,0,0.02,0,0,-0.02,-0.08,-0.4,1.1,0,0
"27","169205635567:  ",2017-04-18 05:41:21,0.05,0,0.24,0,0.24,0,0.1,0.24,0.14,0.06,2.8,3.9,0,0
"31","169205650646:  ",2017-04-18 05:41:59,0.05,0,0,0,0,0.05,0,0,-0.05,0.00999999999999998,-1,2.9,0,0
"32","169205652411:  ",2017-04-18 05:42:03,0.05,0,0.06,0.05,0.12,0,0,0.06,0.07,0.08,1.4,4.3,0,0
"36","169205663265:  ",2017-04-18 05:42:30,0.05,0,0,0,0.35,0.02,0.7,0.6,0.23,0.31,4.6,8.9,0,0
"40","169205670656:  ",2017-04-18 05:42:49,0.05,1.92,0.25,0.07,1.97,0.05,0,0,-0.32,-0.0100000000000001,-6.4,2.5,0,0
"45","169205689085:  ",2017-04-18 05:43:35,0.05,0,0,0,0,0.02,0,0,-0.02,-0.0300000000000001,-0.4,2.1,0,0
"46","169205698804:  ",2017-04-18 05:43:59,0.07,0,0,0.05,0,0,0,0,-0.05,-0.0800000000000001,-0.7,1.4,0,0
"47","169205707661:  ",2017-04-18 05:44:21,0.05,0,0.94,0,0.7,0,0.1,0.7,0.36,0.28,7.2,8.6,0,0
"52","169205708919:  ",2017-04-18 05:44:24,0.05,0,0,0.05,0,0,0,0,-0.05,0.23,-1,7.6,0,0
"53","169205743873:  ",2017-04-18 05:45:50,0.05,0,0,0,0,0.05,0,0,-0.05,0.18,-1,6.6,0,0
"54","169205747089:  ",2017-04-18 05:45:58,0.05,0,0,0.19,0,0,0,0,-0.19,-0.0100000000000002,-3.8,2.8,0,0
"56","169205752080:  ",2017-04-18 05:46:10,0.05,0,0,0,0,0.02,0,0,-0.02,-0.0300000000000002,-0.4,2.4,0,0
"57","169205765290:  ",2017-04-18 05:46:43,0.05,0,0.34,0,0,0,0.15,0,-0.49,-0.52,-9.8,-7.4,0,0
"59","169205766894:  ",2017-04-18 05:46:47,0.05,0,0,0,0,0.05,0,0,-0.05,-0.57,-1,-8.4,0,0
"60","169205779467:  ",2017-04-18 05:47:18,0.05,0,0,0,0,0.02,0,0,-0.02,-0.59,-0.4,-8.8,0,0
"61","169205783168:  ",2017-04-18 05:47:27,0.05,0,0,0.05,0,0,0,0,-0.05,-0.64,-1,-9.8,0,0
"62","169205808760:  ",2017-04-18 05:48:31,0.05,0,0,0,0,0.05,0,0,-0.05,-0.69,-1,-10.8,0,0
"63","169205816824:  ",2017-04-18 05:48:51,0.05,0,0,0,0,0.02,0,0,-0.02,-0.71,-0.4,-11.2,0,0
"64","169205824787:  ",2017-04-18 05:49:10,0.05,0,0.14,0.05,0.14,0,0,0.14,0.09,-0.62,1.8,-9.4,0,0
"68","169205844036:  ",2017-04-18 05:49:59,0.05,0,0,0,0.12,0,0.15,0.1,0.07,-0.55,1.4,-8,0,0
"71","169205864035:  ",2017-04-18 05:50:48,0.05,0,0,0.05,0,0.05,0,0,-0.1,-0.65,-2,-10,0,0
"73","169205889265:  ",2017-04-18 05:51:50,0.05,0,0,0,0,0.02,0,0,-0.02,-0.67,-0.4,-10.4,0,0
"74","169205897433:  ",2017-04-18 05:52:11,0.05,0,0,0,0,0.05,0,0,-0.05,-0.72,-1,-11.4,0,0
"75","169205904745:  ",2017-04-18 05:52:29,0.05,0,0,0,0,0.02,0,0,-0.02,-0.74,-0.4,-11.8,0,0
"76","169205907368:  ",2017-04-18 05:52:36,0.05,0,1.07,0.15,1.07,0,0.4,1.07,0.52,-0.22,10.4,-1.4,0,0
"82","169205931532:  ",2017-04-18 05:53:36,0.05,1.11,0,0.15,0.77,0,0,0.87,0.38,0.16,7.6,6.2,0,0
"87","169205935815:  ",2017-04-18 05:53:47,0.05,0,0,0.2,0,0,0,0,-0.2,-0.0400000000000003,-4,2.2,0,0
"88","169205955314:  ",2017-04-18 05:54:35,0.05,0,0,0,0.12,0,0.15,0.1,0.07,0.0299999999999997,1.4,3.6,0,0
"91","169205972416:  ",2017-04-18 05:55:18,0.05,0,0,0,0.12,0,0.2,0.15,0.07,0.0999999999999997,1.4,5,0,0
"94","169205981163:  ",2017-04-18 05:55:43,0.05,1.78,0,0,0.24,0.05,0,1.67,0.0799999999999998,0.18,1.6,6.6,0,0
"98","169205990814:  ",2017-04-18 05:56:09,0.05,0,0.1,0.03,0.1,0.02,0,0.1,0.05,0.23,1,7.6,0,0
"103","169206001806:  ",2017-04-18 05:56:39,0.05,0,0.12,0.05,0.12,0,0,0.12,0.07,0.3,1.4,9,0,0
"107","169393188558:  ",2017-04-22 08:08:42,0.02,0,0.06,0,0.23,0.03,0,0,0.14,0.44,7,16,0,0
"111","169393217137:  ",2017-04-22 08:09:36,0.02,0,0.2,0.05,0.2,0.02,0,0.2,0.13,0.57,6.5,22.5,0,0
"117","169393247697:  ",2017-04-22 08:10:33,0.02,0,0,0.02,0,0.01,0,0,-0.03,0.54,-1.5,21,0,0
"119","169393282573:  ",2017-04-22 08:11:38,0.02,0,0,0,0,0.01,0,0,-0.01,0.53,-0.5,20.5,0,0
"120","169393300288:  ",2017-04-22 08:12:11,0.02,0,0,0,0,0.01,0,0,-0.01,0.52,-0.5,20,0,0
"121","169393312116:  ",2017-04-22 08:12:33,0.02,0,0,0.02,0,0.01,0,0,-0.03,0.49,-1.5,18.5,0,0
"123","169393346172:  ",2017-04-22 08:13:36,0.02,0,0.05,0.01,0,0.02,0,0,-0.08,0.41,-4,14.5,0,0
"127","169393438716:  ",2017-04-22 08:16:17,0.02,0,0,0,0.16,0.01,0.08,0.06,0.13,0.54,6.5,21,0,0
"131","169393502653:  ",2017-04-22 08:18:14,0.02,0,0,0.02,0,0.01,0,0,-0.03,0.51,-1.5,19.5,0,0
"133","169393530711:  ",2017-04-22 08:19:06,0.02,0,0,0,0,0.01,0,0,-0.01,0.5,-0.5,19,0,0
"134","169393559191:  ",2017-04-22 08:19:58,0.02,0,0.21,0,0.31,0.01,0.06,0.21,0.24,0.74,12,31,0,0
"139","169393590662:  ",2017-04-22 08:20:56,0.02,0,0,0,0,0.01,0,0,-0.01,0.73,-0.5,30.5,0,0
"140","169393605403:  ",2017-04-22 08:21:23,0.02,0,0.41,0,0.41,0.03,0.12,0.41,0.26,0.989999999999999,13,43.5,0,0
"146","169393647935:  ",2017-04-22 08:22:40,0.02,0,0,0,0,0.02,0,0,-0.02,0.97,-1,42.5,0,0
"148","169393695171:  ",2017-04-22 08:24:05,0.02,0,0,0.02,0,0.01,0,0,-0.03,0.94,-1.5,41,0,0
"150","169393747112:  ",2017-04-22 08:25:38,0.03,0,0,1,0,0.01,0.12,0,-1.13,-0.190000000000001,-37.7,3.3,0,0
"155","169393831145:  ",2017-04-22 08:28:09,0.02,0,0,0,0,0.01,0,0,-0.01,-0.200000000000001,-0.5,2.8,0,0
"156","169393881753:  ",2017-04-22 08:29:40,0.02,0,0,0,0,0.01,0,0,-0.01,-0.210000000000001,-0.5,2.3,0,0
"157","169393925021:  ",2017-04-22 08:30:57,0.02,0,0,0,0,0.01,0,0,-0.01,-0.220000000000001,-0.5,1.8,0,0
"158","169393952722:  ",2017-04-22 08:31:46,0.02,0,0,0,0,0.01,0,0,-0.01,-0.230000000000001,-0.5,1.3,0,0
"159","169393991782:  ",2017-04-22 08:32:55,0.02,0,0,0.01,0,0.02,0,0,-0.03,-0.260000000000001,-1.5,-0.200000000000005,0,0
"162","169394028910:  ",2017-04-22 08:34:01,0.02,0.59,0,0.06,0,0.01,0,0,-0.66,-0.920000000000001,-33,-33.2,0,0
"165","169394140270:  ",2017-04-22 08:37:19,0.02,0,0,0,0,0.02,0,0,-0.02,-0.940000000000001,-1,-34.2,0,0
"166","169394168657:  ",2017-04-22 08:38:09,0.02,0,0,0,0,0.01,0,0,-0.01,-0.950000000000001,-0.5,-34.7,0,0
"167","169394188132:  ",2017-04-22 08:38:43,0.02,0,0,0.02,0,0,0,0,-0.02,-0.970000000000001,-1,-35.7,0,0
"168","169394238529:  ",2017-04-22 08:40:12,0.02,0.71,0,0.1,0.92,0,0.2,0.55,0.46,-0.51,23,-12.7,0,0
"174","169394286974:  ",2017-04-22 08:41:37,0.02,0,0,0.04,0,0,0,0,-0.04,-0.55,-2,-14.7,0,0
"175","169394315195:  ",2017-04-22 08:42:26,0.02,0,0.06,0.02,0.06,0,0,0.06,0.04,-0.51,2,-12.7,0,0
"179","169394435051:  ",2017-04-22 08:45:56,0.02,0,0,0,0,0.02,0,0,-0.02,-0.53,-1,-13.7,0,0
"180","169394453850:  ",2017-04-22 08:46:29,0.02,0,0,0,0,0.01,0,0,-0.01,-0.54,-0.5,-14.2,0,0
"181","169394503383:  ",2017-04-22 08:47:55,0.02,0,0.1,0.04,0.14,0,0,0.1,0.1,-0.44,5,-9.2,0,0
"185","169394632454:  ",2017-04-22 08:51:39,0.02,0,0.43,0.03,0,0.02,0,0,-0.48,-0.92,-24,-33.2,0,0
"189","169394684093:  ",2017-04-22 08:53:08,0.02,0,0,0,0,0.01,0,0,-0.01,-0.93,-0.5,-33.7,0,0
"190","169394706018:  ",2017-04-22 08:53:46,0.02,0,0.13,0,0,0,0.06,0,-0.19,-1.12,-9.5,-43.2,0,0
"192","169394757142:  ",2017-04-22 08:55:15,0.02,0,0.05,0.02,0.05,0,0,0.05,0.03,-1.09,1.5,-41.7,0,0
"196","169394801485:  ",2017-04-22 08:56:44,0.02,0,0,0.02,0,0,0,0,-0.02,-1.11,-1,-42.7,0,0
"197","169394858216:  ",2017-04-22 08:58:38,0.02,0,0,0,0,0.02,0,0,-0.02,-1.13,-1,-43.7,0,0
"198","169394894877:  ",2017-04-22 08:59:51,0.02,0,0,0,0,0.01,0,0,-0.01,-1.14,-0.5,-44.2,0,0
"199","169395010247:  ",2017-04-22 09:03:17,0.02,0,0,0,0.05,0,0.06,0.04,0.03,-1.11,1.5,-42.7,0,0
"202","169395049570:  ",2017-04-22 09:04:23,0.02,0,0.22,0.06,0.22,0,0,0.22,0.16,-0.95,8,-34.7,0,0
"207","169395192977:  ",2017-04-22 09:08:17,0.02,0,0,0,0,0.02,0,0,-0.02,-0.97,-1,-35.7,0,0
"208","169395234140:  ",2017-04-22 09:09:23,0.02,0,0,0,0,0.01,0,0,-0.01,-0.98,-0.5,-36.2,0,0
"209","169395268128:  ",2017-04-22 09:10:18,0.02,0,0.06,0.02,0.07,0,0,0.06,0.05,-0.93,2.5,-33.7,0,0
"213","169395479814:  ",2017-04-22 09:15:59,0.02,0,0.03,0,0.05,0.02,0,0.03,0.03,-0.9,1.5,-32.2,0,0
"217","169395511761:  ",2017-04-22 09:16:50,0.02,0,0.06,0.01,0,0.01,0.26,0,-0.34,-1.24,-17,-49.2,0,0
"221","169395567220:  ",2017-04-22 09:18:19,0.02,0,0.26,0.08,0.26,0,0,0.26,0.18,-1.06,9,-40.2,0,0
"225","169395595828:  ",2017-04-22 09:19:05,0.02,0,0.27,0.02,0.2,0,0,0.2,0.11,-0.95,5.5,-34.7,0,0
"230","169395712068:  ",2017-04-22 09:21:56,0.02,0,0.18,0,0.18,0,0.08,0.18,0.1,-0.85,5,-29.7,0,0
"234","169395737787:  ",2017-04-22 09:22:37,0.02,0,0,0,0,0.02,0,0,-0.02,-0.87,-1,-30.7,0,0
"235","169395761073:  ",2017-04-22 09:23:14,0.02,0,0,0.41,0,0.01,0,0,-0.42,-1.29,-21,-51.7,0,0
"240","169395814323:  ",2017-04-22 09:24:39,0.02,0,0,0,0.07,0,0.1,0.08,0.05,-1.24,2.5,-49.2,0,0
"243","169395833901:  ",2017-04-22 09:25:10,0.02,0,0,0.04,0,0,0,0,-0.04,-1.28,-2,-51.2,0,0
"244","169395853230:  ",2017-04-22 09:25:41,0.02,0,0.05,0.02,0.05,0,0,0.05,0.03,-1.25,1.5,-49.7,0,0
"248","169395911808:  ",2017-04-22 09:27:14,0.02,0,0,0.07,0,0,0,0,-0.07,-1.32,-3.5,-53.2,0,0
"250","169395950821:  ",2017-04-22 09:28:16,0.02,0,0,0,0,0.02,0.08,0,-0.1,-1.42,-5,-58.2,0,0
"252","169395994476:  ",2017-04-22 09:29:25,0.02,0,0,0,0,0.01,0,0,-0.01,-1.43,-0.5,-58.7,0,0
"253","169396030286:  ",2017-04-22 09:30:21,0.02,0.35,0.13,0.04,0,0,0,0,-0.52,-1.95,-26,-84.7,0,0
"256","169396190555:  ",2017-04-22 09:34:33,0.02,0,0.07,0,0.07,0.02,0,0.07,0.05,-1.9,2.5,-82.2,0,0
"260","169396213141:  ",2017-04-22 09:35:09,0.02,0,0.19,0,0.19,0.01,0.06,0.19,0.12,-1.78,6,-76.2,0,0
"265","169396269335:  ",2017-04-22 09:36:38,0.02,0,0.18,0.02,1.67,0,0.63,0,0.84,-0.94,42,-34.2,-1.06,-40.2
"270","169396348716:  ",2017-04-22 09:38:42,0.02,0,0,0.04,0,0,0,0,-0.04,-0.98,-2,-36.2,-1.13,-43.7
"272","169396476758:  ",2017-04-22 09:42:04,0.02,0,0,0,0,0.02,0,0,-0.02,-1,-1,-37.2,-1.1,-42.2
"273","169396498201:  ",2017-04-22 09:42:38,0.02,0,0,0,0,0.01,0,0,-0.01,-1.01,-0.5,-37.7,-1.1,-42.2
"274","169396519457:  ",2017-04-22 09:43:11,0.02,0,0,0.06,0,0,0,0,-0.06,-1.07,-3,-40.7,-0.56,-33.2
"275","169396557284:  ",2017-04-22 09:44:11,0.02,1.71,0,0.18,0.69,0,0,1.55,0.35,-0.72,17.5,-23.2,-0.55,-22.5
"280","169396605536:  ",2017-04-22 09:45:26,0.02,0,0,0,0,0,0.06,0,-0.06,-0.78,-3,-26.2,-0.56,-24.5
"281","169396750452:  ",2017-04-22 09:49:11,0.02,0,0,0.02,0,0,0,0,-0.02,-0.8,-1,-27.2,-0.74,-28.7
"282","169396787279:  ",2017-04-22 09:50:09,0.02,0,0,0,0,0.02,0,0,-0.02,-0.82,-1,-28.2,-0.74,-29.3
"283","169396821435:  ",2017-04-22 09:51:03,0.02,0,0,0,0,0.01,0,0,-0.01,-0.83,-0.5,-28.7,-0.89,-32.6
"284","169396853597:  ",2017-04-22 09:51:54,0.02,0,0,0.04,0,0,0,0,-0.04,-0.87,-2,-30.7,-0.88,-33.6
"286","169396966177:  ",2017-04-22 09:54:51,0.02,0,0,0,0.05,0,0.06,0.04,0.03,-0.84,1.5,-29.2,-0.92,-33.5
"289","169396984799:  ",2017-04-22 09:55:22,0.02,0,0.15,0,0.18,0,0.06,0.15,0.12,-0.72,6,-23.2,-1.03,-32.1
"293","169397060819:  ",2017-04-22 09:57:43,0.02,0,0,0.04,0,0.02,0,0,-0.06,-0.78,-3,-26.2,-0.77,-28.7
"295","169397093182:  ",2017-04-22 09:58:43,0.02,0,0,0,0,0.01,0,0,-0.01,-0.79,-0.5,-26.7,-0.76,-28.8
"296","169397104864:  ",2017-04-22 09:59:04,0.02,0,0.26,0,0.26,0,0.08,0.26,0.18,-0.61,9,-17.7,-0.53,-19.1
"300","169397126979:  ",2017-04-22 09:59:45,0.02,0,0,0.07,0,0,0,0,-0.07,-0.68,-3.5,-21.2,-0.96,-29.8
"302","169399003582:  ",2017-04-22 10:46:55,0.02,0,0.05,0,0.07,0.02,0,0.05,0.05,-0.63,2.5,-18.7,-0.86,-26.3
"306","169399044029:  ",2017-04-22 10:47:40,0.02,0,0.2,0.07,0.29,0.01,0,0.2,0.21,-0.42,10.5,-8.2,-0.6,-14.8
"312","169399071563:  ",2017-04-22 10:48:22,0.02,0,0,0.02,0,0,0,0,-0.02,-0.44,-1,-9.2,-0.43,-12
"313","169399096253:  ",2017-04-22 10:48:54,0.02,0,0.07,0.02,0,0,0,0,-0.09,-0.53,-4.5,-13.7,-0.5,-16.1
"315","169399124384:  ",2017-04-22 10:49:29,0.02,0,0,0.02,0,0,0,0,-0.02,-0.55,-1,-14.7,-0.0299999999999999,-7.3
"316","169399166149:  ",2017-04-22 10:50:25,0.02,0,0,0.02,0,0,0,0,-0.02,-0.57,-1,-15.7,1.11022302462516e-16,-7.3
"317","169399209622:  ",2017-04-22 10:51:27,0.02,0,0.06,0.04,0.13,0,0,0.06,0.09,-0.48,4.5,-11.2,0.11,-2.4
"322","169399255484:  ",2017-04-22 10:52:34,0.02,0,0,0,0,0.02,0,0,-0.02,-0.5,-1,-12.2,0.14,-2.4
"323","169399260914:  ",2017-04-22 10:52:42,0.02,0,0,0,0,0.02,0,0,-0.02,-0.52,-1,-13.2,0.17,-2.4
"324","169399270367:  ",2017-04-22 10:52:56,0.02,0,0,0,0,0.01,0,0,-0.01,-0.53,-0.5,-13.7,0.18,-2.5
"325","169399284257:  ",2017-04-22 10:53:16,0.02,0,0.04,0.01,0.04,0.01,0,0.04,0.02,-0.51,1,-12.7,0.11,-3.3
"330","169399296890:  ",2017-04-22 10:53:34,0.02,0,0.13,0.04,0.13,0,0,0.13,0.09,-0.42,4.5,-8.2,0.13,-0.200000000000003
"334","169399340797:  ",2017-04-22 10:54:24,0.02,0,0.23,0,0.23,0,0.08,0.23,0.15,-0.27,7.5,-0.700000000000005,0.38,9.3
"338","169399377483:  ",2017-04-22 10:55:19,0.02,0,0,0,0.05,0,0.06,0.04,0.03,-0.24,1.5,0.799999999999995,0.43,11.2
"341","169399379672:  ",2017-04-22 10:55:23,0.02,0,0,0.06,0,0,0,0,-0.06,-0.3,-3,-2.2,0.42,9.2
"342","169399390498:  ",2017-04-22 10:55:41,0.02,0,0.13,0,0.13,0,0.04,0.13,0.09,-0.21,4.5,2.3,0.53,14.1
"346","169399407546:  ",2017-04-22 10:56:10,0.02,0,0,0.02,0,0,0,0,-0.02,-0.23,-1,1.3,-0.01,2.7
"347","169399442183:  ",2017-04-22 10:57:09,0.03,0,0.04,0.01,0.07,0.01,0,0.04,0.05,-0.18,1.7,3,-0.34,-3.2
"352","169399469469:  ",2017-04-22 10:57:56,0.02,0,0.31,0.02,0.31,0,0.12,0.31,0.17,-0.0100000000000002,8.5,11.5,0.0300000000000001,9.3
"357","169399489458:  ",2017-04-22 10:58:29,0.02,0,0.1,0.02,0.14,0,0.04,0.1,0.08,0.0699999999999998,4,15.5,0.0400000000000001,11.9
"362","169399514891:  ",2017-04-22 10:59:13,0.02,0,0,0.04,0.13,0,0.09,0.07,0.07,0.14,3.5,19,0.0400000000000001,14
"367","169399542806:  ",2017-04-22 11:00:00,0.02,0,0,0.02,0,0,0,0,-0.02,0.12,-1,18,-0.0599999999999997,11.4
"368","169399562158:  ",2017-04-22 11:00:31,0.02,0,0,0.02,0,0,0,0,-0.02,0.0999999999999998,-1,17,-0.13,9.4
"369","169399582483:  ",2017-04-22 11:01:04,0.02,0,0,0,0.02,0.02,0,0.01,0.01,0.11,0.5,17.5,-0.19,8.5
"372","169399602321:  ",2017-04-22 11:01:34,0.02,0,0,0,0,0.01,0,0,-0.01,0.0999999999999998,-0.5,17,-0.34,0.999999999999998
"373","169399643186:  ",2017-04-22 11:02:34,0.02,0,0.08,0.02,0.16,0,0.06,0.08,0.08,0.18,4,21,-0.39,-1.5
"378","169399705345:  ",2017-04-22 11:04:05,0.02,0,0,0,0.05,0,0.04,0.02,0.03,0.21,1.5,22.5,-0.33,1.5
"381","169399806562:  ",2017-04-22 11:06:32,0.02,0,0,0,0.05,0,0.06,0.04,0.03,0.24,1.5,24,-0.29,3.5
"384","169399910181:  ",2017-04-22 11:09:02,0.02,0,0,0.02,0,0,0,0,-0.02,0.22,-1,23,-0.3,3
"385","169399954629:  ",2017-04-22 11:10:07,0.02,0,0,0.02,0.13,0.02,0.09,0.07,0.07,0.29,3.5,26.5,-0.2,8
"390","169404558231:  ",2017-04-22 12:55:35,0.02,0,0,0,0.02,0.02,0,0.01,0.01,0.3,0.5,27,-0.11,12.5
"393","169404574714:  ",2017-04-22 12:56:02,0.02,0,0,0,0,0.01,0,0,-0.01,0.29,-0.5,26.5,-0.25,5.5
"394","169404620996:  ",2017-04-22 12:57:18,0.02,0,0.07,0.02,0.09,0,0,0.07,0.07,0.36,3.5,30,-0.15,10.5
"398","169404629932:  ",2017-04-22 12:57:32,0.02,0,0,0,0.02,0.02,0,0.01,0.01,0.37,0.5,30.5,-0.13,11.5
"401","169404645159:  ",2017-04-22 12:57:57,0.02,0,0,0,0,0.01,0,0,-0.01,0.36,-0.5,30,-0.38,-1
"402","169404674003:  ",2017-04-22 12:58:44,0.02,0,0,0,0,0.02,0,0,-0.02,0.34,-1,29,-0.39,-1.5
"403","169404702938:  ",2017-04-22 12:59:31,0.02,0,0,0,0,0.01,0,0,-0.01,0.33,-0.5,28.5,-0.66,-15
"404","169404703883:  ",2017-04-22 12:59:32,0.02,0,0,0.06,0,0,0,0,-0.06,0.27,-3,25.5,-0.7,-17
"406","169404720602:  ",2017-04-22 13:00:00,0.02,0,0.05,0.02,0.07,0,0,0.05,0.05,0.32,2.5,28,-0.62,-13
"410","169404756474:  ",2017-04-22 13:00:56,0.02,0,0,0,0.07,0,0.06,0.04,0.05,0.37,2.5,30.5,0.56,27.2
"413","169404797123:  ",2017-04-22 13:01:53,0.02,0,0.03,0.02,0.05,0,0,0.03,0.03,0.4,1.5,32,0.6,29.2
"417","169404825324:  ",2017-04-22 13:02:31,0.02,0,0,0,0,0.02,0,0,-0.02,0.38,-1,31,0.590000000000001,28.7
"418","169404842769:  ",2017-04-22 13:02:52,0.02,0,0,0,0,0.01,0,0,-0.01,0.37,-0.5,30.5,0.590000000000001,28.7
"419","169404848005:  ",2017-04-22 13:02:58,0.02,0,0.42,0.08,0,0.02,0,0,-0.52,-0.15,-26,4.5,0.0800000000000005,3.2
"423","169404896310:  ",2017-04-22 13:03:57,0.02,0,0.12,0,0.14,0,0.04,0.12,0.1,-0.0500000000000002,5,9.49999999999999,0.21,9.7
"427","169404913577:  ",2017-04-22 13:04:18,0.02,0,0.06,0.01,0,0.01,0,0,-0.08,-0.13,-4,5.5,0.79,38.7
"430","169404983100:  ",2017-04-22 13:05:41,0.02,0,0.18,0,0.18,0,0.08,0.18,0.1,-0.0300000000000002,5,10.5,0.91,44.7
"434","169405025948:  ",2017-04-22 13:06:31,0.02,0,0.14,0,0.14,0,0.06,0.14,0.08,0.0499999999999998,4,14.5,1,49.2
"438","169405052499:  ",2017-04-22 13:07:02,0.02,0,0,0.36,0,0,0,0,-0.36,-0.31,-18,-3.5,0.66,32.2
"440","169405097395:  ",2017-04-22 13:07:54,0.02,0,0,0,0,0,0.06,0,-0.06,-0.37,-3,-6.5,0.14,6.2
"441","169405144399:  ",2017-04-22 13:08:49,0.02,0,0,0.02,0,0,0,0,-0.02,-0.39,-1,-7.5,0.16,7.2
"442","169405160694:  ",2017-04-22 13:09:08,0.02,0,0,0,0.3,0,0.24,0.14,0.2,-0.19,10,2.5,0.32,15.2
"446","169405214903:  ",2017-04-22 13:10:11,0.02,0,0.1,0.04,0,0.02,0,0,-0.16,-0.35,-8,-5.5,0.18,8.2
"449","169405262960:  ",2017-04-22 13:11:08,0.02,0,0,0,0,0.01,0,0,-0.01,-0.36,-0.5,-6,0.18,8.2
"450","169405277263:  ",2017-04-22 13:11:24,0.02,0,0,0.06,0,0.02,0,0,-0.08,-0.44,-4,-10,2.22044604925031e-16,-0.800000000000001
"453","169405295927:  ",2017-04-22 13:11:46,0.02,0,0,0,0.09,0,0.08,0.06,0.07,-0.37,3.5,-6.5,0.55,26.7
"456","169405353851:  ",2017-04-22 13:12:53,0.02,0,0,0,0,0.01,0,0,-0.01,-0.38,-0.5,-7,0.55,26.7
"457","169405373213:  ",2017-04-22 13:13:15,0.02,0,0,0,0.05,0,0.06,0.04,0.03,-0.35,1.5,-5.5,0.77,37.7
"460","169405404061:  ",2017-04-22 13:13:52,0.02,0,0.04,0.02,0.06,0,0,0.04,0.04,-0.31,2,-3.5,0.78,38.2
"464","169405443558:  ",2017-04-22 13:14:38,0.02,0,0.02,0,0.09,0.02,0,0,0.05,-0.26,2.5,-1,0.85,41.7
"467","169405476222:  ",2017-04-22 13:15:16,0.02,0,0,0,0,0.01,0,0,-0.01,-0.27,-0.5,-1.5,0.86,42.2
"468","169405489573:  ",2017-04-22 13:15:32,0.02,0,0,0,0.05,0,0.08,0.06,0.03,-0.24,1.5,-4.55191440096314e-15,0.9,44.2
"471","169405518787:  ",2017-04-22 13:16:06,0.02,0.32,0.19,0.02,0.44,0,0,0.32,0.23,-0.0100000000000002,11.5,11.5,1.1,54.2
"477","169405571367:  ",2017-04-22 13:17:07,0.02,0,0.22,0,0.22,0,0.1,0.22,0.12,0.11,6,17.5,1.06,52.2
"481","169405626790:  ",2017-04-22 13:18:13,0.02,0,0,0,0.14,0,0.06,0,0.08,0.19,4,21.5,1.16,57.2
"483","169405668397:  ",2017-04-22 13:19:01,0.02,0,0,0,0,0.02,0,0,-0.02,0.17,-1,20.5,1.15,56.7
"484","169405685747:  ",2017-04-22 13:19:22,0.02,0,0.12,0.03,1.02,0.01,0.35,0,0.51,0.68,25.5,46,1.61,79.7
"490","169405693706:  ",2017-04-22 13:19:31,0.02,0,0,0,0,0.02,0,0,-0.02,0.66,-1,45,1.56,77.2
"491","169405723849:  ",2017-04-22 13:20:06,0.02,0,0,0,0,0.01,0,0,-0.01,0.65,-0.5,44.5,1.89,93.7
"492","169405825291:  ",2017-04-22 13:22:04,0.02,0,0.1,0.02,0.1,0,0,0.1,0.08,0.73,4,48.5,1.79,88.7
"496","169405871455:  ",2017-04-22 13:22:59,0.02,0,0.1,0.06,0,0,0,0,-0.16,0.57,-8,40.5,1.52,75.2
"498","169405951377:  ",2017-04-22 13:24:32,0.02,0,0,0.12,0,0,0.06,0,-0.18,0.39,-9,31.5,1.24,61.2
"500","169405973725:  ",2017-04-22 13:24:59,0.02,0,0,0.02,0.06,0,0,0,0.04,0.43,2,33.5,1.3,64.2
"502","169406045362:  ",2017-04-22 13:26:24,0.02,0,0.14,0,0.19,0,0.06,0.14,0.13,0.56,6.5,40,1.85,91.7
"506","169406058435:  ",2017-04-22 13:26:39,0.02,0,0.21,0,0.21,0.02,0.08,0.21,0.11,0.67,5.5,45.5,1.91,94.7
"511","169406103421:  ",2017-04-22 13:27:33,0.02,0,0,0,0.02,0.02,0,0.01,0.01,0.68,0.5,46,1.96,97.2
"514","169406116664:  ",2017-04-22 13:27:49,0.02,0,0,0,0,0.01,0,0,-0.01,0.67,-0.5,45.5,1.92,95.2
"515","169406121233:  ",2017-04-22 13:27:55,0.02,0,0,0,0,0.01,0,0,-0.01,0.66,-0.5,45,1.98,98.2
"516","169406136382:  ",2017-04-22 13:28:12,0.02,0,0.1,0,0.14,0,0.06,0.1,0.08,0.74,4,49,2.16,107.2
"520","169406142144:  ",2017-04-22 13:28:19,0.02,0,0.02,0.08,0,0,0,0,-0.1,0.64,-5,44,2.07,102.7
"523","169406261236:  ",2017-04-22 13:30:42,0.02,0,0,0.04,0.18,0,0,0,0.14,0.78,7,51,2.73,135.7
"526","169406290190:  ",2017-04-22 13:31:17,0.02,0,0,0.02,0,0,0,0,-0.02,0.76,-1,50,2.66,132.2
"527","169406345327:  ",2017-04-22 13:32:23,0.02,0,0.09,0.02,0.09,0,0,0.09,0.07,0.83,3.5,53.5,2.61,129.7
"531","169406404786:  ",2017-04-22 13:33:34,0.02,0,0,0.02,0,0,0,0,-0.02,0.81,-1,52.5,1.75,86.7
"532","169406421958:  ",2017-04-22 13:33:55,0.02,0,0,0,0.04,0.01,0.06,0.04,0.01,0.82,0.5,53,1.8,89.2
"536","169406460285:  ",2017-04-22 13:34:40,0.02,0,0.13,0,0,0,0.06,0,-0.19,0.63,-9.5,43.5,1.63,80.7
"538","169406462745:  ",2017-04-22 13:34:43,0.02,0,0,0.04,0,0.02,0,0,-0.06,0.57,-3,40.5,1.58,78.2
"540","169406526613:  ",2017-04-22 13:35:54,0.02,0,0.28,0.13,0.28,0,0,0.28,0.15,0.72,7.5,48,1.79,88.7
"545","169406535917:  ",2017-04-22 13:36:05,0.02,0,0,0,0,0.01,0,0,-0.01,0.71,-0.5,47.5,1.43,70.7
"546","169406576378:  ",2017-04-22 13:36:53,0.02,0,0.16,0,0.18,0,0.06,0.16,0.12,0.83,6,53.5,1.61,79.7
"550","169406618091:  ",2017-04-22 13:37:44,0.02,0,0.06,0.02,0,0,0,0,-0.08,0.75,-4,49.5,1.55,76.7
"552","169406638746:  ",2017-04-22 13:38:08,0.02,0,0,0.02,0,0,0,0,-0.02,0.73,-1,48.5,1.55,76.7
"553","169406733835:  ",2017-04-22 13:40:02,0.02,0,0,0,0,0.02,0,0,-0.02,0.71,-1,47.5,1.54,76.2
"554","169406755101:  ",2017-04-22 13:40:28,0.02,0,0,0,0.05,0,0.06,0.04,0.03,0.74,1.5,49,1.61,79.7
"557","169406785488:  ",2017-04-22 13:41:05,0.02,0,0.05,0.02,0.07,0,0,0.05,0.05,0.79,2.5,51.5,1.63,80.7
"561","169406793627:  ",2017-04-22 13:41:15,0.02,0,0,0,0,0.01,0,0,-0.01,0.78,-0.5,51,1.5,74.2
"562","169406844592:  ",2017-04-22 13:42:17,0.02,0,0.12,0,0,0,0.06,0,-0.18,0.6,-9,42,1.38,68.2
"564","169406904343:  ",2017-04-22 13:43:30,0.02,0,0,0,0,0.02,0,0,-0.02,0.58,-1,41,1.37,67.7
"565","169406929921:  ",2017-04-22 13:44:01,0.02,0,0,0,0,0.01,0,0,-0.01,0.57,-0.5,40.5,1.18,58.2
"566","169407020373:  ",2017-04-22 13:45:51,0.02,0,0,0,0,0,0.04,0,-0.04,0.53,-2,38.5,1.21,59.7
"567","169407026028:  ",2017-04-22 13:45:58,0.02,0,0,0,0.05,0,0.06,0.04,0.03,0.56,1.5,40,1.19,58.7
"570","169407101053:  ",2017-04-22 13:47:30,0.02,0,0,0,0,0.02,0,0,-0.02,0.54,-1,39,0.96,47.2
"571","169407131369:  ",2017-04-22 13:48:07,0.02,0,0,0.01,0,0.01,0,0,-0.02,0.52,-1,38,0.96,47.2
"573","169407154907:  ",2017-04-22 13:48:36,0.02,0,0,0,0,0,0.06,0,-0.06,0.46,-3,35,0.99,48.7
"574","169407236952:  ",2017-04-22 13:50:17,0.02,0,0,0.02,0,0,0,0,-0.02,0.44,-1,34,0.99,48.7
"575","169407255349:  ",2017-04-22 13:50:40,0.02,0,0,0,0,0.02,0,0,-0.02,0.42,-1,33,0.99,48.7
"576","169407315690:  ",2017-04-22 13:51:55,0.02,0,0.04,0.01,0.08,0.01,0,0.02,0.04,0.46,2,35,0.94,46.2
"582","169407349537:  ",2017-04-22 13:52:38,0.02,0,0.12,0.04,0.39,0,0,0,0.23,0.69,11.5,46.5,1.19,58.7
"585","169407401386:  ",2017-04-22 13:53:43,0.02,0,0.25,0.02,0.56,0,0,0,0.29,0.98,14.5,61,1.5,74.2
"589","169407413428:  ",2017-04-22 13:53:58,0.02,0,0,0.06,0,0,0,0,-0.06,0.92,-3,58,1.45,71.7
"590","169407488192:  ",2017-04-22 13:55:38,0.02,0,0,0.06,0,0.02,0,0,-0.08,0.84,-4,54,1.35,66.7
"593","169407553266:  ",2017-04-22 13:57:25,0.02,0,0.25,0.04,0,0,0.06,0,-0.35,0.49,-17.5,36.5,0.91,44.7
"596","169407589902:  ",2017-04-22 13:58:25,0.02,0,0.08,0.01,0.08,0.01,0,0.08,0.06,0.55,3,39.5,0.82,40.2
"601","169407603035:  ",2017-04-22 13:58:46,0.02,0,0,0,0,0.02,0,0,-0.02,0.53,-1,38.5,0.77,37.7
"602","169407629676:  ",2017-04-22 13:59:29,0.02,0,0,0.05,0,0.01,0,0,-0.06,0.47,-3,35.5,0.77,37.7
"604","169407656657:  ",2017-04-22 14:00:07,0.02,0,0,0.02,0,0,0,0,-0.02,0.45,-1,34.5,0.66,32.2
"605","169407671241:  ",2017-04-22 14:00:29,0.02,0,0,0.02,0,0,0,0,-0.02,0.43,-1,33.5,0.66,32.2
"606","169407807240:  ",2017-04-22 14:03:32,0.02,0,0,0,0,0.02,0,0,-0.02,0.41,-1,32.5,0.59,29.5
"607","169407823620:  ",2017-04-22 14:03:52,0.02,0,0,0,0,0.01,0,0,-0.01,0.4,-0.5,32,0.41,20.5
"608","169407851278:  ",2017-04-22 14:04:27,0.02,0,0,0.02,0.44,0,0.59,0.39,0.22,0.62,11,43,0.55,27.5
"614","169529566403:  ",2017-04-25 05:49:36,0.02,0,0,0.02,0,0,0,0,-0.02,0.6,-1,42,0.46,23
"615","169529585755:  ",2017-04-25 05:50:27,0.02,0,0.36,0,0.48,0,0.06,0.24,0.3,0.9,15,57,0.78,39
"620","169529600189:  ",2017-04-25 05:51:04,0.02,0,0,0,0,0.02,0,0,-0.02,0.88,-1,56,0.78,39
"621","169529625493:  ",2017-04-25 05:52:11,0.03,0,0,0.1,0,0,0,0,-0.1,0.78,-3.3,52.7,0.67,35.2
"623","169529633499:  ",2017-04-25 05:52:32,0.02,0,0,0.01,0.04,0.01,0,0,0.02,0.8,1,53.7,0.7,36.7
"626","169529650561:  ",2017-04-25 05:53:16,0.02,0,0.08,0,0.13,0.02,0.06,0.08,0.05,0.85,2.5,56.2,0.67,35.2
"631","169529655776:  ",2017-04-25 05:53:29,0.02,0,0,0,0.05,0,0.06,0.04,0.03,0.88,1.5,57.7,0.67,35.2
"634","169529669605:  ",2017-04-25 05:54:05,0.02,0,0,0,0.07,0,0.06,0.04,0.05,0.93,2.5,60.2,0.69,36.2
"637","169529675606:  ",2017-04-25 05:54:21,0.02,0,0,0,0,0.01,0,0,-0.01,0.92,-0.5,59.7,0.7,36.7
"638","169529697446:  ",2017-04-25 05:55:21,0.02,0,0,0.02,0,0,0,0,-0.02,0.9,-1,58.7,0.61,32.2
"639","169529740231:  ",2017-04-25 05:57:27,0.02,0,0,0.02,0,0,0,0,-0.02,0.88,-1,57.7,0.58,30.7
"640","169529757973:  ",2017-04-25 05:58:19,0.02,0,0,0,0,0.02,0,0,-0.02,0.86,-1,56.7,0.57,30.2
"641","169529768090:  ",2017-04-25 05:58:48,0.02,0,0,0.01,0,0.01,0,0,-0.02,0.84,-1,55.7,0.48,25.7
"643","169529799186:  ",2017-04-25 06:00:18,0.02,0,0,0.01,0,0.01,0,0,-0.02,0.82,-1,54.7,0.45,24.2
"645","169529827020:  ",2017-04-25 06:01:34,0.02,0,0.28,0.07,0.28,0,0.06,0.28,0.15,0.97,7.5,62.2,0.61,32.2
"650","169529888058:  ",2017-04-25 06:04:11,0.02,0,0,0,0.02,0.02,0,0.01,0.01,0.98,0.5,62.7,0.64,33.7
"653","169529894150:  ",2017-04-25 06:04:26,0.02,0,0,0,0,0.01,0,0,-0.01,0.97,-0.5,62.2,0.64,33.7
"654","169529906451:  ",2017-04-25 06:04:58,0.02,0,0,0.02,0,0,0,0,-0.02,0.95,-1,61.2,0.68,35.7
"655","169529912624:  ",2017-04-25 06:05:14,0.02,0,0,0,0,0.02,0,0,-0.02,0.93,-1,60.2,0.61,32.2
"656","169529944070:  ",2017-04-25 06:06:35,0.02,0,0,0,0,0.01,0,0,-0.01,0.92,-0.5,59.7,0.55,29.2
"657","169529959449:  ",2017-04-25 06:07:14,0.02,0,0,0.02,0,0.02,0,0,-0.04,0.88,-2,57.7,0.48,25.7
"659","169529987929:  ",2017-04-25 06:08:27,0.02,0,0,0,0,0.01,0,0,-0.01,0.87,-0.5,57.2,0.49,26.2
"660","169529996930:  ",2017-04-25 06:08:50,0.02,0,0,0,0.05,0,0.06,0.04,0.03,0.9,1.5,58.7,0.53,28.2
"663","169530003178:  ",2017-04-25 06:09:06,0.02,0,0,0.02,0,0,0,0,-0.02,0.88,-1,57.7,1.03,53.2
"664","169530006396:  ",2017-04-25 06:09:14,0.02,0,0,0.02,0,0,0,0,-0.02,0.86,-1,56.7,0.91,47.2
"665","169530069118:  ",2017-04-25 06:11:54,0.02,0,0.04,0,0,0.02,0,0,-0.06,0.8,-3,53.7,0.93,48.2
"667","169562774420:  ",2017-04-25 19:44:12,0.02,0,0,0,0,0.02,0,0,-0.02,0.78,-1,52.7,0.81,42.2
"668","169562794164:  ",2017-04-25 19:44:48,0.02,0,0,0,0,0.01,0,0,-0.01,0.77,-0.5,52.2,0.72,37.7
"669","169562881398:  ",2017-04-25 19:47:29,0.02,0,0,0.02,0,0,0,0,-0.02,0.75,-1,51.2,1.06,54.7
"670","169562963411:  ",2017-04-25 19:50:02,0.02,0,0,0,0,0.02,0,0,-0.02,0.73,-1,50.2,1.1,56.7
"671","169563000315:  ",2017-04-25 19:51:11,0.03,0,0,0,0,0.01,0,0,-0.01,0.72,-0.3,49.9,1.11,57.4
"672","169563017475:  ",2017-04-25 19:51:44,0.02,0,0,0,0,0.02,0,0,-0.02,0.7,-1,48.9,0.89,46.4
"673","169563033047:  ",2017-04-25 19:52:13,0.02,0,0,0,0,0.01,0,0,-0.01,0.69,-0.5,48.4,1.04,53.9
"674","169563042446:  ",2017-04-25 19:52:32,0.02,0,0.12,0.07,0.22,0,0,0.12,0.15,0.84,7.5,55.9,1.2,61.9
"678","169563072696:  ",2017-04-25 19:53:30,0.02,0,0.04,0.02,0.06,0,0,0.04,0.04,0.88,2,57.9,1.32,67.9
"682","169563077013:  ",2017-04-25 19:53:38,0.02,0,0,0.02,0.05,0,0,0,0.03,0.91,1.5,59.4,1.28,65.9
"684","169563119929:  ",2017-04-25 19:55:00,0.02,0,0,0.26,0,0,0,0,-0.26,0.65,-13,46.4,1.03,53.4
"687","169563159800:  ",2017-04-25 19:56:28,0.02,0,0,0,0.07,0,0.06,0.04,0.05,0.7,2.5,48.9,1.05,54.4
"690","169563168499:  ",2017-04-25 19:56:48,0.02,0,0,0.02,0,0,0,0,-0.02,0.68,-1,47.9,0.99,51.4
"691","169563194505:  ",2017-04-25 19:57:39,0.02,0,0.1,0.08,0.19,0.02,0,0.1,0.0900000000000001,0.77,4.5,52.4,1.03,53.4
"697","169563207229:  ",2017-04-25 19:58:08,0.02,0,0.03,0.09,0.28,0.02,0,0,0.14,0.91,7,59.4,1.18,60.9
"702","169563214936:  ",2017-04-25 19:58:25,0.02,0,0,0,0,0.01,0,0,-0.01,0.9,-0.5,58.9,1.14,58.9
"703","169563224195:  ",2017-04-25 19:58:46,0.02,0,0,0.06,0,0,0,0,-0.06,0.84,-3,55.9,0.85,44.4
"704","169563244617:  ",2017-04-25 19:59:32,0.02,0,0,0,0,0.01,0,0,-0.01,0.83,-0.5,55.4,0.72,37.9
"705","169563269724:  ",2017-04-25 20:00:29,0.02,0,0,0,0,0,0.06,0,-0.06,0.77,-3,52.4,0.58,30.9
"706","169563280471:  ",2017-04-25 20:00:52,0.02,0,0,0,0.05,0,0.06,0.04,0.03,0.8,1.5,53.9,0.63,33.4
"709","169563302494:  ",2017-04-25 20:01:37,0.02,0,0,0.07,0.38,0,0.12,0,0.19,0.99,9.5,63.4,0.31,17.4
"713","169563358435:  ",2017-04-25 20:03:28,0.02,0,0,0,0,0.02,0,0,-0.02,0.97,-1,62.4,0.31,17.4
"714","169563360614:  ",2017-04-25 20:03:32,0.02,0,0,0.02,0,0,0,0,-0.02,0.95,-1,61.4,0.3,16.9
"715","169563381609:  ",2017-04-25 20:04:13,0.02,0,0,0,0,0.01,0,0,-0.01,0.94,-0.5,60.9,0.21,12.4
"716","169563407682:  ",2017-04-25 20:05:04,0.02,0,0,0.02,0,0,0,0,-0.02,0.92,-1,59.9,0.35,19.4
"717","169563418347:  ",2017-04-25 20:05:25,0.02,0,0.03,0.02,0.05,0,0,0.03,0.03,0.95,1.5,61.4,0.56,29.9
"721","169563427135:  ",2017-04-25 20:05:42,0.02,0,0,0,0,0.02,0,0,-0.02,0.93,-1,60.4,0.5,26.9
"722","169563453481:  ",2017-04-25 20:06:33,0.02,0,0,0,0,0.01,0,0,-0.01,0.92,-0.5,59.9,0.36,19.9
"723","169563460631:  ",2017-04-25 20:06:47,0.02,0,0.07,0,0.14,0,0.06,0.07,0.08,1,4,63.9,0.33,18.4
"727","169563472858:  ",2017-04-25 20:07:11,0.02,0,0.03,0.02,0.07,0,0,0.03,0.05,1.05,2.5,66.4,0.37,20.4
"731","169563481289:  ",2017-04-25 20:07:28,0.02,0,0,0.02,0,0,0,0,-0.02,1.03,-1,65.4,0.36,19.9
"732","169563540481:  ",2017-04-25 20:09:25,0.02,0,0,0.02,0,0,0,0,-0.02,1.01,-1,64.4,0.35,19.4
"733","169563566469:  ",2017-04-25 20:10:17,0.02,0,0,0.1,0.21,0,0,0,0.11,1.12,5.5,69.9,0.38,20.9
"737","169563595639:  ",2017-04-25 20:10:59,0.02,0,0,0,0,0.02,0,0,-0.02,1.1,-1,68.9,0.46,24.9
"738","169563615062:  ",2017-04-25 20:11:38,0.02,0,0,0,0,0.01,0,0,-0.01,1.09,-0.5,68.4,0.31,17.4
"739","169563648139:  ",2017-04-25 20:12:44,0.02,0,0,0,0,0,0.06,0,-0.06,1.03,-3,65.4,0.27,15.4
"740","169563709981:  ",2017-04-25 20:14:48,0.02,0,0,0.27,0.54,0,0,0,0.27,1.3,13.5,78.9,0.47,25.4
"745","169563729576:  ",2017-04-25 20:15:28,0.02,0,0,0,0.02,0.02,0,0.01,0.01,1.31,0.5,79.4,0.5,26.9
"748","169563743883:  ",2017-04-25 20:15:57,0.02,0,0,0,0,0.01,0,0,-0.01,1.3,-0.5,78.9,0.48,25.9
"749","169563771253:  ",2017-04-25 20:16:52,0.02,0,0,0.02,0,0,0,0,-0.02,1.28,-1,77.9,0.65,34.4
"750","169563781355:  ",2017-04-25 20:17:13,0.02,0,0,0,0,0.02,0,0,-0.02,1.26,-1,76.9,0.69,36.4
"751","169563801895:  ",2017-04-25 20:17:54,0.02,0,0,0,0,0.01,0,0,-0.01,1.25,-0.5,76.4,0.53,28.4
"752","169563816909:  ",2017-04-25 20:18:25,0.02,0,0.06,0.02,0,0,0,0,-0.08,1.17,-4,72.4,0.46,24.9
"754","169563860826:  ",2017-04-25 20:19:54,0.02,0,0.08,0,0.13,0,0.06,0.08,0.07,1.24,3.5,75.9,0.41,22.4
"758","169563886195:  ",2017-04-25 20:20:46,0.02,0,0.08,0.04,0,0,0,0,-0.12,1.12,-6,69.9,0.37,20.4
"761","169563958265:  ",2017-04-25 20:23:14,0.02,0,0,0.02,0,0,0,0,-0.02,1.1,-1,68.9,0.37,20.4
"762","169563988546:  ",2017-04-25 20:24:16,0.03,0,0,0,0,0.02,0,0,-0.02,1.08,-0.7,68.2,0.37,20.7
"763","169564026834:  ",2017-04-25 20:25:36,0.02,0,0.07,0,0,0,0.06,0,-0.13,0.95,-6.5,61.7,0.21,12.7
"765","169564055722:  ",2017-04-25 20:26:37,0.02,0,0,0,0,0.02,0,0,-0.02,0.93,-1,60.7,0.14,9.2
"766","169564068443:  ",2017-04-25 20:27:03,0.02,0,0.1,0.02,0,0,0.36,0,-0.48,0.45,-24,36.7,-0.33,-14.3
"770","169564113078:  ",2017-04-25 20:28:37,0.02,0,0,0,0,0.01,0,0,-0.01,0.44,-0.5,36.2,-0.16,-5.8
"771","169564138235:  ",2017-04-25 20:29:29,0.02,0,0,0.03,0,0.02,0,0,-0.05,0.39,-2.5,33.7,-0.19,-7.3
"773","169564172625:  ",2017-04-25 20:30:41,0.02,0,0.02,0.01,0.04,0.01,0,0.02,0.02,0.41,1,34.7,-0.16,-5.8
"778","169564417111:  ",2017-04-25 20:39:24,0.02,0,0.1,0.04,0,0.02,0,0,-0.16,0.25,-8,26.7,-0.28,-11.8
"781","169564466631:  ",2017-04-25 20:41:10,0.02,0,0.06,0.01,0.08,0.01,0,0.06,0.06,0.31,3,29.7,-0.25,-10.3
"786","169564490937:  ",2017-04-25 20:42:00,0.02,0,0.16,0.02,0.6,0,0.62,0.54,0.34,0.65,17,46.7,0.11,7.7
"792","169564570967:  ",2017-04-25 20:44:55,0.02,0,0.06,0.02,0.07,0,0,0.06,0.05,0.7,2.5,49.2,0.18,11.2
"796","169564702421:  ",2017-04-25 20:49:25,0.02,0,0.08,0,0.22,0.02,0,0,0.12,0.82,6,55.2,0.36,20.2
"800","169564721808:  ",2017-04-25 20:50:07,0.02,0,0,0,0,0.02,0,0,-0.02,0.8,-1,54.2,0.36,20.2
"801","169564737518:  ",2017-04-25 20:50:43,0.02,0,0,0,0,0.01,0,0,-0.01,0.79,-0.5,53.7,0.37,20.7
"802","169564761662:  ",2017-04-25 20:51:36,0.02,0,0,0,0,0.01,0,0,-0.01,0.78,-0.5,53.2,0.32,18.2
"803","169564779270:  ",2017-04-25 20:52:16,0.03,0,0.14,0.02,0.18,0,0,0.09,0.11,0.89,3.7,56.9,0.2,10.4
"808","169564898938:  ",2017-04-25 20:57:00,0.02,0,0,0,0,0.02,0,0,-0.02,0.87,-1,55.9,-0.11,-5.09999999999999
"809","169564918642:  ",2017-04-25 20:57:52,0.02,0,0,0,0,0.01,0,0,-0.01,0.86,-0.5,55.4,-0.0599999999999996,-2.59999999999999
"810","169564943366:  ",2017-04-25 20:58:58,0.02,0,0.04,0,0.06,0.02,0,0.04,0.04,0.9,2,57.4,0.0600000000000004,3.40000000000001
"814","169564959674:  ",2017-04-25 20:59:41,0.02,0,0.09,0.17,0,0,0,0,-0.26,0.64,-13,44.4,0.15,7.90000000000001
"817","169565024172:  ",2017-04-25 21:02:21,0.02,0,0.04,0.01,0.04,0.01,0,0.04,0.02,0.66,1,45.4,0.11,5.90000000000001
"822","169565097895:  ",2017-04-25 21:05:11,0.02,0,0.12,0,0.19,0,0.06,0.12,0.13,0.79,6.5,51.9,0.26,13.4
"826","169565167081:  ",2017-04-25 21:07:47,0.02,0,0,0,0,0.02,0,0,-0.02,0.77,-1,50.9,0.3,15.4
"827","169565187112:  ",2017-04-25 21:08:32,0.02,0,0,0.01,0,0.01,0,0,-0.02,0.75,-1,49.9,0.3,15.4
"829","169565223625:  ",2017-04-25 21:09:55,0.02,0,0,0.02,0,0,0,0,-0.02,0.73,-1,48.9,0.3,15.4
"830","169565228339:  ",2017-04-25 21:10:06,0.02,0,0,0.02,0,0,0,0,-0.02,0.71,-1,47.9,0.3,15.4
"831","169565242005:  ",2017-04-25 21:10:36,0.02,0,0.1,0.17,0,0,0.06,0,-0.33,0.38,-16.5,31.4,-0.0199999999999997,-0.600000000000001
"834","169565284484:  ",2017-04-25 21:12:13,0.02,0,0,0,0,0.02,0,0,-0.02,0.36,-1,30.4,-0.26,-12.6
"835","169565292575:  ",2017-04-25 21:12:31,0.02,0,0.2,0.1,0.28,0,0,0.2,0.18,0.54,9,39.4,-0.0599999999999997,-2.59999999999999
"841","169565319029:  ",2017-04-25 21:13:31,0.02,0,0,0,0,0.01,0,0,-0.01,0.53,-0.5,38.9,-0.37,-18.1
"842","169565324634:  ",2017-04-25 21:13:44,0.02,0,0.05,0.02,0.07,0,0,0.05,0.05,0.58,2.5,41.4,-0.3,-14.6
"846","169565342457:  ",2017-04-25 21:14:25,0.02,0,0,0,0,0.02,0,0,-0.02,0.56,-1,40.4,-0.22,-12.3
"847","169565365087:  ",2017-04-25 21:15:17,0.02,0,0,0,0,0.01,0,0,-0.01,0.55,-0.5,39.9,-0.25,-13.8
"848","169565420473:  ",2017-04-25 21:17:21,0.02,0,0,0.69,1.8,0,0.22,0,0.89,1.44,44.5,84.4,0.59,28.2
"853","169565459045:  ",2017-04-25 21:18:49,0.02,0,0,0.02,0,0,0,0,-0.02,1.42,-1,83.4,0.54,25.7
"854","169565499660:  ",2017-04-25 21:20:11,0.02,0,0,0,0,0.02,0,0,-0.02,1.4,-1,82.4,0.47,22.2
"855","169676909564:  ",2017-04-28 13:17:30,0.02,0,0,0.12,0,0,0.06,0,-0.18,1.22,-9,73.4,0.3,13.7
"857","169676912919:  ",2017-04-28 13:17:34,0.02,0,0.14,0.02,0.11,0,0,0.11,0.06,1.28,3,76.4,0.38,17.7
"862","169676966482:  ",2017-04-28 13:18:47,0.02,0,0.07,0.14,0,0,0.06,0,-0.27,1.01,-13.5,62.9,0.13,5.2
"865","169677098843:  ",2017-04-28 13:21:46,0.02,0,0,0,0,0.02,0,0,-0.02,0.99,-1,61.9,0.13,5.2
"866","169677123872:  ",2017-04-28 13:22:19,0.02,0,0,0.01,0,0.01,0,0,-0.02,0.97,-1,60.9,0.13,5.2
"868","169677159770:  ",2017-04-28 13:23:08,0.02,0,0,0,0,0.02,0,0,-0.02,0.95,-1,59.9,0.13,5.2
"869","169677212535:  ",2017-04-28 13:24:18,0.02,0,0,0,0,0.01,0,0,-0.01,0.94,-0.5,59.4,-0.0299999999999997,-2.8
"870","169677331551:  ",2017-04-28 13:26:58,0.02,0,0,0,0.05,0,0.08,0.06,0.03,0.97,1.5,60.9,-0.00999999999999968,-1.8
"873","169677403475:  ",2017-04-28 13:28:35,0.02,0,0,0,0,0.02,0,0,-0.02,0.95,-1,59.9,-0.0199999999999997,-2.3
"874","169677411135:  ",2017-04-28 13:28:45,0.02,0,0,0,0,0.01,0,0,-0.01,0.94,-0.5,59.4,-0.00999999999999968,-1.8
"875","169677429260:  ",2017-04-28 13:29:10,0.02,0,0,0,0,0.01,0,0,-0.01,0.93,-0.5,58.9,2.22044604925031e-16,-1.3
"876","169677434632:  ",2017-04-28 13:29:17,0.02,0,0,0,0.05,0,0.06,0.04,0.03,0.96,1.5,60.4,0.0400000000000003,0.700000000000003
"879","169677500841:  ",2017-04-28 13:30:46,0.02,0,0,0,0,0.02,0,0,-0.02,0.94,-1,59.4,0.0600000000000003,1.7
"880","169677529641:  ",2017-04-28 13:31:24,0.02,0.35,0,0.05,0.23,0.01,0,0.35,0.17,1.11,8.5,67.9,0.24,10.7
"885","169677618008:  ",2017-04-28 13:33:22,0.02,0,0.04,0.02,0.07,0,0,0.04,0.05,1.16,2.5,70.4,0.26,11.7
"889","169677693443:  ",2017-04-28 13:35:03,0.02,0,0,0.02,0,0,0,0,-0.02,1.14,-1,69.4,0.26,11.7
"890","169677705191:  ",2017-04-28 13:35:18,0.02,0,0,0.02,0,0,0,0,-0.02,1.12,-1,68.4,0.26,11.7
"891","169677758306:  ",2017-04-28 13:36:29,0.02,0,0,0.02,0,0.02,0,0,-0.04,1.08,-2,66.4,0.28,12.7
"893","169677798231:  ",2017-04-28 13:37:22,0.02,0,0,0,0,0.01,0,0,-0.01,1.07,-0.5,65.9,0.29,13.2
"894","169677867725:  ",2017-04-28 13:38:54,0.02,0,0.1,0.06,0.14,0,0,0.1,0.08,1.15,4,69.9,0.38,17.7
"898","169697072807:  ",2017-04-28 21:11:52,0.02,0,0,0,0,0.02,0,0,-0.02,1.13,-1,68.9,0.38,17.7
"899","169697085722:  ",2017-04-28 21:12:19,0.02,0,0,0.01,0,0.01,0,0,-0.02,1.11,-1,67.9,0.38,17.7
"901","169697115158:  ",2017-04-28 21:13:23,0.02,0,0.07,0.04,0,0,0,0,-0.11,1,-5.5,62.4,0.28,12.5
"903","169697224520:  ",2017-04-28 21:17:21,0.02,0,0,0,0.02,0.02,0,0.01,0.01,1.01,0.5,62.9,0.31,14
"906","169697227240:  ",2017-04-28 21:17:27,0.02,0.14,0.5,0.1,1.85,0,0.21,0,0.9,1.91,45,107.9,1.22,59.5
"912","169697239592:  ",2017-04-28 21:17:53,0.02,0,0,0,0,0.01,0,0,-0.01,1.9,-0.5,107.4,1.06,51.5
"913","169697290473:  ",2017-04-28 21:19:45,0.02,1.04,0,0,2.23,0,0.06,0,1.13,3.03,56.5,163.9,2.15,106
"916","169697304039:  ",2017-04-28 21:20:15,0.02,0,0,0,0,0.02,0,0,-0.02,3.01,-1,162.9,2.1,103.5
"917","169697343245:  ",2017-04-28 21:21:41,0.02,0,0,0,0,0.01,0,0,-0.01,3,-0.5,162.4,2.35,116
"918","169697362227:  ",2017-04-28 21:22:24,0.02,0,0,0.02,0,0,0,0,-0.02,2.98,-1,161.4,2.28,112.5
"919","169697396887:  ",2017-04-28 21:23:40,0.02,0,0.1,0.04,0.13,0,0,0.1,0.09,3.07,4.5,165.9,2.39,118
"923","169697417300:  ",2017-04-28 21:24:25,0.02,0,0,0,0,0.02,0,0,-0.02,3.05,-1,164.9,2.28,112.5
"924","169697428318:  ",2017-04-28 21:24:49,0.02,0,0,0,0,0,0.04,0,-0.04,3.01,-2,162.9,2.1,103.5
"925","169697452832:  ",2017-04-28 21:25:44,0.02,0,0.03,0.02,0.06,0,0,0.03,0.04,3.05,2,164.9,2.15,106
"929","169697462465:  ",2017-04-28 21:26:06,0.02,0,0,0,0,0.01,0,0,-0.01,3.04,-0.5,164.4,2.2,108.5
"930","169697479588:  ",2017-04-28 21:26:44,0.02,0,0.03,0,0.11,0.02,0,0,0.06,3.1,3,167.4,2.27,112
"933","169697499812:  ",2017-04-28 21:27:30,0.02,0,0.04,0.02,0,0,0,0,-0.06,3.04,-3,164.4,2.27,112
"935","169697506831:  ",2017-04-28 21:27:46,0.02,0,0,0,0,0.01,0,0,-0.01,3.03,-0.5,163.9,2.23,110
"936","169697533182:  ",2017-04-28 21:28:46,0.02,0,0.05,0.02,0,0,0,0,-0.07,2.96,-3.5,160.4,1.97,97
"938","169697602978:  ",2017-04-28 21:31:26,0.02,0,0.04,0,0,0.02,0,0,-0.06,2.9,-3,157.4,1.93,95
"940","169697638587:  ",2017-04-28 21:32:48,0.03,0,0,0.01,0,0.01,0,0,-0.02,2.88,-0.7,156.7,1.93,95.3
"942","169697667493:  ",2017-04-28 21:33:44,0.02,0,0,0,0,0.02,0,0,-0.02,2.86,-1,155.7,1.92,94.8
"943","169697676598:  ",2017-04-28 21:34:05,0.02,0,0.18,0,0,0,0.08,0,-0.26,2.6,-13,142.7,1.68,82.8
"945","169697711546:  ",2017-04-28 21:35:27,0.02,0,0.04,0.01,0.15,0.01,0,0,0.09,2.69,4.5,147.2,1.74,85.8
"949","169697716393:  ",2017-04-28 21:35:38,0.02,0,0,0.02,0,0,0,0,-0.02,2.67,-1,146.2,1.74,85.8
"950","169697834965:  ",2017-04-28 21:40:16,0.02,0,0,0,0,0.02,0,0,-0.02,2.65,-1,145.2,1.73,85.3
"951","169697844273:  ",2017-04-28 21:40:38,0.02,0,0,0,0,0.01,0,0,-0.01,2.64,-0.5,144.7,1.64,80.8
"952","169697858286:  ",2017-04-28 21:41:11,0.02,0,0.1,0.06,0.2,0,0,0.1,0.14,2.78,7,151.7,1.73,85.3
"957","169697879937:  ",2017-04-28 21:42:01,0.02,0,0,0.02,0,0.02,0,0,-0.04,2.74,-2,149.7,1.71,84.3
"959","169697902180:  ",2017-04-28 21:42:55,0.02,0,0.04,0.11,0,0.01,0.12,0,-0.28,2.46,-14,135.7,1.45,71.3
"964","169697937931:  ",2017-04-28 21:44:19,0.02,0,0.03,0.02,0.05,0,0,0.03,0.03,2.49,1.5,137.2,1.37,67.3
"968","169697965385:  ",2017-04-28 21:45:25,0.02,0,0.1,0,0.14,0,0.06,0.1,0.08,2.57,4,141.2,1.47,72.3
"972","169697966584:  ",2017-04-28 21:45:27,0.02,0,0,0.04,0,0,0,0,-0.04,2.53,-2,139.2,1.44,70.8
"973","169698010721:  ",2017-04-28 21:47:13,0.02,0,0,0.02,0,0,0,0,-0.02,2.51,-1,138.2,1.48,72.8
"974","169698033349:  ",2017-04-28 21:48:09,0.02,0,0,0,0.02,0.02,0,0.01,0.01,2.52,0.5,138.7,1.22,59.8
"977","169698055533:  ",2017-04-28 21:49:02,0.02,0,0.1,0.05,0.14,0.01,0,0.1,0.08,2.6,4,142.7,1.29,63.3
"984","169698069402:  ",2017-04-28 21:49:36,0.02,0,0,0,0,0.02,0,0,-0.02,2.58,-1,141.7,1.28,62.8
"985","169698097138:  ",2017-04-28 21:50:43,0.02,0,0,0.24,0,0,0,0,-0.24,2.34,-12,129.7,1.06,51.8
"986","169698100365:  ",2017-04-28 21:50:51,0.02,0,0,0,0,0.01,0,0,-0.01,2.33,-0.5,129.2,1.07,52.3
"987","169698115967:  ",2017-04-28 21:51:26,0.02,0,0,0.06,0,0,0,0,-0.06,2.27,-3,126.2,1.02,49.8
"990","169698182269:  ",2017-04-28 21:54:08,0.02,0,0,0.02,0,0,0,0,-0.02,2.25,-1,125.2,1.08,52.8
"991","169698203533:  ",2017-04-28 21:55:00,0.02,0,0,0,0,0.02,0,0,-0.02,2.23,-1,124.2,0.99,48.3
"992","169698204406:  ",2017-04-28 21:55:03,0.02,0,0.1,0,0.13,0,0.06,0.1,0.07,2.3,3.5,127.7,1.18,57.8
"996","169698224873:  ",2017-04-28 21:56:00,0.02,0,0,0,0,0.01,0,0,-0.01,2.29,-0.5,127.2,1.19,58.3
"997","169698244160:  ",2017-04-28 21:56:54,0.02,0,0,0,0,0.02,0,0,-0.02,2.27,-1,126.2,1.19,58
"998","169698260825:  ",2017-04-28 21:57:38,0.02,0,0,0,0,0.01,0,0,-0.01,2.26,-0.5,125.7,1.31,64
"999","169698270264:  ",2017-04-28 21:58:04,0.02,0,0.41,0,0.99,0,0.08,0,0.5,2.76,25,150.7,1.83,90
"1003","169698296297:  ",2017-04-28 21:59:16,0.02,0,0.17,0.02,0,0,0.06,0,-0.25,2.51,-12.5,138.2,2.06,101.5
"1006","169698360074:  ",2017-04-28 22:02:03,0.02,0,0,0,0,0.02,0,0,-0.02,2.49,-1,137.2,2.05,101
"1007","169698369828:  ",2017-04-28 22:02:28,0.02,0,0,0,0,0.02,0,0,-0.02,2.47,-1,136.2,2.08,102.5
"1008","169698370103:  ",2017-04-28 22:02:29,0.02,0,0.08,0.01,0.08,0.01,0,0.08,0.06,2.53,3,139.2,2.12,104.5
"1013","169698390172:  ",2017-04-28 22:03:05,0.02,0,0,0,0,0.01,0,0,-0.01,2.52,-0.5,138.7,2.27,112
"1014","169698406806:  ",2017-04-28 22:03:47,0.02,0,0,0,0.05,0,0.06,0.04,0.03,2.55,1.5,140.2,2.24,110.5
"1017","169698429998:  ",2017-04-28 22:04:45,0.02,0,0.03,0.02,0.05,0,0,0.03,0.03,2.58,1.5,141.7,1.93,95
"1021","169698433732:  ",2017-04-28 22:04:54,0.02,0,0,0.12,0,0,0,0,-0.12,2.46,-6,135.7,1.76,86.5
"1025","169698493921:  ",2017-04-28 22:07:26,0.02,0,0.1,0.07,0.16,0,0,0.1,0.09,2.55,4.5,140.2,1.73,85
"1030","169698495305:  ",2017-04-28 22:07:30,0.02,0,0,0,0,0.02,0,0,-0.02,2.53,-1,139.2,1.73,85
"1031","169698516048:  ",2017-04-28 22:08:22,0.02,0,0,0,0,0.01,0,0,-0.01,2.52,-0.5,138.7,1.73,85
"1032","169698549141:  ",2017-04-28 22:09:47,0.02,0,0.1,0,0.14,0,0.06,0.1,0.08,2.6,4,142.7,1.82,89.5
"1036","169698559082:  ",2017-04-28 22:10:12,0.02,0,0,0,0,0.02,0,0,-0.02,2.58,-1,141.7,1.69,84.8
"1037","169698575671:  ",2017-04-28 22:10:54,0.02,0,0.03,0.01,0,0.01,0,0,-0.05,2.53,-2.5,139.2,1.66,83.3
"1040","169698619626:  ",2017-04-28 22:12:47,0.02,0,0.12,0.06,0.19,0,0,0.12,0.13,2.66,6.5,145.7,1.8,90.3
"1045","169698663491:  ",2017-04-28 22:14:40,0.02,0,0,0,0,0.02,0,0,-0.02,2.64,-1,144.7,1.74,87.3
"1046","169698680955:  ",2017-04-28 22:15:25,0.02,0,0,0,0,0.01,0,0,-0.01,2.63,-0.5,144.2,1.99,99.8
"1047","169698685458:  ",2017-04-28 22:15:36,0.02,0,0.02,0.04,0.09,0,0,0.02,0.05,2.68,2.5,146.7,2.02,101.3
"1052","169698701636:  ",2017-04-28 22:16:18,0.02,0,0,0,0,0.02,0,0,-0.02,2.66,-1,145.7,1.87,93.8
"1053","169698712009:  ",2017-04-28 22:16:45,0.02,0,0.25,0.05,0.32,0,0,0.15,0.17,2.83,8.5,154.2,2.06,103.3
"1058","169698738930:  ",2017-04-28 22:17:55,0.02,0,0,0.01,0,0.01,0,0,-0.02,2.81,-1,153.2,2.06,103.3
"1060","169698750507:  ",2017-04-28 22:18:25,0.02,0,0.02,0.02,0.05,0,0,0.02,0.03,2.84,1.5,154.7,2.11,105.8
"1064","169698768458:  ",2017-04-28 22:19:12,0.02,0,0.03,0.02,0.06,0,0,0.03,0.04,2.88,2,156.7,2.17,108.8
"1068","169698791277:  ",2017-04-28 22:20:11,0.02,0,0.1,0.04,0,0,0,0,-0.14,2.74,-7,149.7,2.36,118.3
"1071","169698816373:  ",2017-04-28 22:21:17,0.02,0,0,0.02,0,0,0,0,-0.02,2.72,-1,148.7,2.36,118.3
"1072","169698839410:  ",2017-04-28 22:22:17,0.02,0,0,0,0,0.02,0,0,-0.02,2.7,-1,147.7,2.16,108.3
"1073","169799481141:  ",2017-05-01 05:21:47,0.02,0,0.04,0.02,0,0,0,0,-0.06,2.64,-3,144.7,2.11,105.8
"1075","169799507194:  ",2017-05-01 05:22:52,0.02,0,0.12,0,0.18,0,0.06,0.12,0.12,2.76,6,150.7,2.18,109.3
"1079","169799536662:  ",2017-05-01 05:24:06,0.02,0,0,0,0,0,0.06,0,-0.06,2.7,-3,147.7,2.14,107.3
"1080","169799591502:  ",2017-05-01 05:26:23,0.02,0,0,0,0,0.02,0,0,-0.02,2.68,-1,146.7,2.13,106.8
"1081","169799671962:  ",2017-05-01 05:29:42,0.02,0,0,0,0,0.02,0,0,-0.02,2.66,-1,145.7,1.22,61.3
"1082","169799686282:  ",2017-05-01 05:30:18,0.02,0,0,0,0,0.01,0,0,-0.01,2.65,-0.5,145.2,1.23,61.8
"1083","169799720102:  ",2017-05-01 05:31:42,0.02,0,0,0,0.13,0.02,0.18,0.12,0.05,2.7,2.5,147.7,1.3,65.3
"1087","169799743916:  ",2017-05-01 05:32:41,0.02,0,0,0.01,0,0.01,0,0,-0.02,2.68,-1,146.7,1.46,73.3
"1089","169799780229:  ",2017-05-01 05:34:10,0.02,0,0,0.1,0,0,0,0,-0.1,2.58,-5,141.7,1.3,65.3
"1091","169799827509:  ",2017-05-01 05:36:07,0.02,0,0,0.02,0,0,0,0,-0.02,2.56,-1,140.7,1.55,77.8
"1092","169799845331:  ",2017-05-01 05:36:51,0.02,0,0,0.06,0,0,0,0,-0.06,2.5,-3,137.7,1.51,75.8
"1093","169799906469:  ",2017-05-01 05:39:20,0.02,0,0,0,0,0.02,0,0,-0.02,2.48,-1,136.7,1.51,75.8
"1094","169799907758:  ",2017-05-01 05:39:23,0.02,0,0,0,0,0.02,0,0,-0.02,2.46,-1,135.7,1.51,75.8
"1095","169799923040:  ",2017-05-01 05:40:00,0.02,0,0,0,0,0.01,0,0,-0.01,2.45,-0.5,135.2,1.51,75.8
"1096","169799931424:  ",2017-05-01 05:40:21,0.02,0,0,0,0,0.01,0,0,-0.01,2.44,-0.5,134.7,1.47,73.8
"1097","169799961584:  ",2017-05-01 05:41:34,0.02,0,0.12,0,0.23,0,0.06,0.12,0.17,2.61,8.5,143.2,1.66,83.3
"1101","169800074392:  ",2017-05-01 05:46:08,0.02,0,0,0,0,0.02,0,0,-0.02,2.59,-1,142.2,1.65,82.8
"1102","169800102093:  ",2017-05-01 05:47:16,0.02,0,0,0,0,0.01,0,0,-0.01,2.58,-0.5,141.7,1.65,82.8
"1103","169800109479:  ",2017-05-01 05:47:34,0.02,0,0.1,0.08,0.38,0,0,0,0.2,2.78,10,151.7,1.82,91.3
"1107","169800137222:  ",2017-05-01 05:48:41,0.02,0,0,0.02,0,0,0,0,-0.02,2.76,-1,150.7,1.82,91.3
"1108","169800168904:  ",2017-05-01 05:49:59,0.02,0,0,0.04,0,0,0.06,0,-0.1,2.66,-5,145.7,1.55,77.8
"1110","169800179991:  ",2017-05-01 05:50:27,0.02,0,0,0.04,0,0.02,0,0,-0.06,2.6,-3,142.7,1.44,72.3
"1112","169800211448:  ",2017-05-01 05:51:43,0.02,0,0,0.01,0,0.01,0,0,-0.02,2.58,-1,141.7,1.44,72.3
"1114","169800237196:  ",2017-05-01 05:52:46,0.02,0,0,0,0.05,0,0.06,0.04,0.03,2.61,1.5,143.2,1.49,74.8
"1117","169800258876:  ",2017-05-01 05:53:40,0.02,0,0.27,0,0.28,0,0.06,0.2,0.15,2.76,7.5,150.7,1.68,84.3
"1122","169800278375:  ",2017-05-01 05:54:27,0.02,0,0,0.05,0,0.01,0,0,-0.06,2.7,-3,147.7,1.63,81.8
"1124","169800292273:  ",2017-05-01 05:55:00,0.02,0,0,0.02,0,0,0,0,-0.02,2.68,-1,146.7,1.53,76.8
"1125","169800344144:  ",2017-05-01 05:57:20,0.02,0,0,0.06,0,0,0,0,-0.06,2.62,-3,143.7,1.49,74.8
"1127","169800357124:  ",2017-05-01 05:57:55,0.02,0,0,0,0.02,0.02,0,0.01,0.01,2.63,0.5,144.2,1.52,76.3
"1130","169800365981:  ",2017-05-01 05:58:19,0.02,0,0,0,0,0.01,0,0,-0.01,2.62,-0.5,143.7,1.62,81.3
"1131","169800385632:  ",2017-05-01 05:59:12,0.02,0,0,0.06,0,0,0,0,-0.06,2.56,-3,140.7,1.55,77.8
"1132","169800386588:  ",2017-05-01 05:59:14,0.02,0,0.05,0.11,0.36,0,0,0,0.2,2.76,10,150.7,0.85,42.8
"1136","169800413520:  ",2017-05-01 06:00:26,0.02,0,0,0.02,0,0,0,0,-0.02,2.74,-1,149.7,0.84,42.3
"1137","169800420547:  ",2017-05-01 06:00:44,0.02,0,0,0,0,0.02,0,0,-0.02,2.72,-1,148.7,-0.31,-15.2
"1138","169800441649:  ",2017-05-01 06:01:37,0.02,0,0,0.02,0,0,0,0,-0.02,2.7,-1,147.7,-0.31,-15.2
"1139","169800451545:  ",2017-05-01 06:02:01,0.02,0,0.04,0.01,0,0.01,0,0,-0.06,2.64,-3,144.7,-0.36,-17.7
"1142","169800467609:  ",2017-05-01 06:02:40,0.02,0,0,0.02,0.05,0,0,0,0.03,2.67,1.5,146.2,-0.31,-15.2
"1144","169800515806:  ",2017-05-01 06:04:36,0.02,0,0,0,0,0.02,0,0,-0.02,2.65,-1,145.2,-0.42,-20.7
"1145","169800531924:  ",2017-05-01 06:05:15,0.02,0,0,0,0,0.01,0,0,-0.01,2.64,-0.5,144.7,-0.41,-20.2
"1146","169800540259:  ",2017-05-01 06:05:34,0.03,0,0.06,0.02,0.08,0,0,0.06,0.06,2.7,2,146.7,-0.31,-16.2
"1150","169800610120:  ",2017-05-01 06:08:21,0.02,0,0.1,0,0,0,0.06,0,-0.16,2.54,-8,138.7,-0.51,-26.2
"1152","169800641113:  ",2017-05-01 06:09:36,0.02,0,0,0,0,0.02,0,0,-0.02,2.52,-1,137.7,-0.52,-26.7
"1153","169800668192:  ",2017-05-01 06:10:40,0.02,0,0.04,0.01,0.06,0.01,0,0.04,0.04,2.56,2,139.7,-0.54,-27.7
"1158","169800697899:  ",2017-05-01 06:11:51,0.02,0,0.04,0.01,0.06,0.01,0,0.04,0.04,2.6,2,141.7,-0.44,-22.7
"1163","169800722124:  ",2017-05-01 06:12:48,0.02,0,0,0.24,0.49,0,0,0,0.25,2.85,12.5,154.2,-0.18,-9.70000000000002
"1168","169800748895:  ",2017-05-01 06:13:50,0.02,0,0.2,0.06,0.26,0,0,0.2,0.2,3.05,10,164.2,0.0899999999999999,3.79999999999998
"1172","169800788844:  ",2017-05-01 06:15:24,0.02,0,0,0.02,0,0,0,0,-0.02,3.03,-1,163.2,0.13,5.79999999999998
"1173","169800801731:  ",2017-05-01 06:15:54,0.02,0.65,0.2,0,0,0,0.1,0,-0.95,2.08,-47.5,115.7,-0.8,-41
"1176","169800834376:  ",2017-05-01 06:17:11,0.02,0,0,0,0,0.02,0,0,-0.02,2.06,-1,114.7,-0.8,-41
"1177","169800861517:  ",2017-05-01 06:18:15,0.02,0,0.04,0.01,0.06,0.01,0,0.04,0.04,2.1,2,116.7,-0.5,-26
"1182","169800888872:  ",2017-05-01 06:19:19,0.02,0,0.16,0,0.2,0,0.06,0.16,0.14,2.24,7,123.7,-0.45,-23.5
"1186","169800910157:  ",2017-05-01 06:20:08,0.02,0,0,0.06,0,0,0,0,-0.06,2.18,-3,120.7,-0.49,-25.5
"1187","169801043966:  ",2017-05-01 06:25:21,0.02,0,0,0,0,0.02,0,0,-0.02,2.16,-1,119.7,-0.49,-25.5
"1188","169801078204:  ",2017-05-01 06:26:41,0.02,0,0.15,0.05,0.19,0.01,0,0.15,0.13,2.29,6.5,126.2,-0.35,-18.5
"1193","169801129074:  ",2017-05-01 06:28:40,0.02,0,0,0.08,0,0,0,0,-0.08,2.21,-4,122.2,-0.57,-29.5
"1195","169801154304:  ",2017-05-01 06:29:39,0.02,0,0,0,0,0,0.06,0,-0.06,2.15,-3,119.2,-0.59,-30.5
"1196","169801181170:  ",2017-05-01 06:30:41,0.02,0,0,0.06,0,0,0,0,-0.06,2.09,-3,116.2,-0.37,-19.5
"1198","169801197587:  ",2017-05-01 06:31:19,0.02,0.51,0,0.33,1.88,0,0.14,0,0.9,2.99,45,161.2,0.5,24
"1203","169801227283:  ",2017-05-01 06:32:27,0.02,0,0,0.02,0,0,0,0,-0.02,2.97,-1,160.2,0.4,19
"1204","169801243433:  ",2017-05-01 06:33:04,0.02,0,0,0,0,0.02,0,0,-0.02,2.95,-1,159.2,0.42,20
"1205","169801269658:  ",2017-05-01 06:34:04,0.02,0,0,0,0,0.01,0,0,-0.01,2.94,-0.5,158.7,0.43,20.5
"1206","169801392586:  ",2017-05-01 06:38:43,0.02,0,0,0,0.02,0.02,0,0.01,0.01,2.95,0.5,159.2,0.43,20.5
"1209","169801411167:  ",2017-05-01 06:39:25,0.02,0,0,0,0,0.01,0,0,-0.01,2.94,-0.5,158.7,0.339999999999999,16
"1210","169801435367:  ",2017-05-01 06:40:21,0.02,0,0,0.17,0,0,0,0,-0.17,2.77,-8.5,150.2,0.19,8.5
"1211","169801601177:  ",2017-05-01 06:46:35,0.02,0,0,0.04,0.32,0.02,0.2,0.1,0.16,2.93,8,158.2,0.59,28.5
"1216","169801628923:  ",2017-05-01 06:47:38,0.02,0,0,0.05,0,0.01,0,0,-0.06,2.87,-3,155.2,0.54,26
"1218","169801775777:  ",2017-05-01 06:53:07,0.02,0,0,0,0,0.02,0,0,-0.02,2.85,-1,154.2,0.58,28
"1219","169801798875:  ",2017-05-01 06:53:59,0.02,0,0,0,0,0.01,0,0,-0.01,2.84,-0.5,153.7,0.59,28.5
"1220","169801822867:  ",2017-05-01 06:54:53,0.02,1.39,0,0.34,0,0,0,0,-1.73,1.11,-86.5,67.2,-1.12,-57
"1223","169802205600:  ",2017-05-01 07:09:34,0.02,0,0,0,0,0.02,0,0,-0.02,1.09,-1,66.2,-1.21,-61.5
"1224","169802230290:  ",2017-05-01 07:10:28,0.02,0,0,0.02,0,0,0,0,-0.02,1.07,-1,65.2,-1.22,-62
"1225","169802313157:  ",2017-05-01 07:13:28,0.02,0,0.05,0.02,0.47,0,0.16,0,0.24,1.31,12,77.2,-0.96,-49
"1229","169802343371:  ",2017-05-01 07:14:34,0.02,0,0.02,0,0.05,0.02,0,0.02,0.03,1.34,1.5,78.7,-0.92,-47
"1233","169802374119:  ",2017-05-01 07:15:40,0.02,0,0,0.22,0.24,0.01,0,0,0.00999999999999998,1.35,0.5,79.2,-1.41,-71.5
"1238","169802425231:  ",2017-05-01 07:17:30,0.02,0,0,0.48,1.42,0,0,0,0.94,2.29,47,126.2,-0.22,-12
"1242","169802484721:  ",2017-05-01 07:19:39,0.02,0,0,0.02,0,0,0,0,-0.02,2.27,-1,125.2,-0.22,-12
"1243","169802509483:  ",2017-05-01 07:20:32,0.02,0,0,0,0,0.02,0,0,-0.02,2.25,-1,124.2,-0.22,-12
"1244","169802516141:  ",2017-05-01 07:20:47,0.02,0,0,0.05,0,0.01,0.14,0,-0.2,2.05,-10,114.2,-0.48,-25
"1247","169802581614:  ",2017-05-01 07:23:08,0.02,0,0,0.02,0,0,0,0,-0.02,2.03,-1,113.2,-0.490000000000001,-25.5
"1248","169802602907:  ",2017-05-01 07:23:54,0.02,0,0,0.02,0.23,0,0.2,0.1,0.11,2.14,5.5,118.7,-0.41,-21.5
"1252","169802631068:  ",2017-05-01 07:24:54,0.02,0,0.07,0.04,0,0.02,0,0,-0.13,2.01,-6.5,112.2,-0.57,-29.5
"1255","169802671287:  ",2017-05-01 07:26:21,0.02,0,0,0,0,0.01,0,0,-0.01,2,-0.5,111.7,-0.46,-24
"1256","169802776273:  ",2017-05-01 07:30:06,0.02,0,0,0,0.02,0.02,0,0.01,0.01,2.01,0.5,112.2,-0.54,-28
"1259","169802787270:  ",2017-05-01 07:30:29,0.02,0,0,0,0,0.01,0,0,-0.01,2,-0.5,111.7,-0.53,-27.5
"1260","169802807563:  ",2017-05-01 07:31:13,0.02,0,0.03,0.1,0,0,0,0,-0.13,1.87,-6.5,105.2,-0.650000000000001,-33.5
"1263","169802985647:  ",2017-05-01 07:37:30,0.02,0,0,0,0,0.02,0,0,-0.02,1.85,-1,104.2,-0.75,-38.5
"1264","169803009473:  ",2017-05-01 07:38:20,0.02,0,0,0,0,0.01,0,0,-0.01,1.84,-0.5,103.7,-0.74,-38
"1265","169803035492:  ",2017-05-01 07:39:14,0.02,0,0.35,0.06,0.64,0,0,0.15,0.38,2.22,19,122.7,-0.31,-16.5
"1270","169803125244:  ",2017-05-01 07:42:20,0.02,0,0,0,0,0.02,0,0,-0.02,2.2,-1,121.7,-0.46,-24
"1271","169803137367:  ",2017-05-01 07:42:46,0.02,0,0,0,0,0.01,0,0,-0.01,2.19,-0.5,121.2,-0.45,-23.5
"1272","169803152087:  ",2017-05-01 07:43:16,0.02,0,0,0.02,0.05,0,0,0,0.03,2.22,1.5,122.7,-0.41,-21.5
"1274","169803199185:  ",2017-05-01 07:44:53,0.02,0,0,0,0,0.02,0,0,-0.02,2.2,-1,121.7,-0.48,-25
"1275","169803207194:  ",2017-05-01 07:45:09,0.02,0,0,0,0,0.01,0,0,-0.01,2.19,-0.5,121.2,-0.47,-24.5
"1276","169803234017:  ",2017-05-01 07:46:04,0.02,0,0,0.02,0,0,0,0,-0.02,2.17,-1,120.2,-0.66,-34
"1277","169803250904:  ",2017-05-01 07:46:39,0.02,0,0.2,0.46,0,0,0.06,0,-0.72,1.45,-36,84.2,-1.36,-69
"1281","169849426607:  ",2017-05-02 08:31:39,0.02,0,0.07,0,0.14,0,0.06,0.07,0.08,1.53,4,88.2,-1.31,-66.5
"1285","169849442059:  ",2017-05-02 08:32:11,0.02,0,0,0,0,0.02,0,0,-0.02,1.51,-1,87.2,-1.37,-69.5
"1286","169849454223:  ",2017-05-02 08:32:36,0.02,0,0,0,0,0.01,0,0,-0.01,1.5,-0.5,86.7,-1.24,-63
"1287","169849507643:  ",2017-05-02 08:34:27,0.02,0,0,0,0,0.02,0,0,-0.02,1.48,-1,85.7,-1.24,-63
"1288","169849524189:  ",2017-05-02 08:35:02,0.02,0,0,0,0,0.01,0,0,-0.01,1.47,-0.5,85.2,-1.23,-62.5
"1289","169849535347:  ",2017-05-02 08:35:25,0.02,0,0.02,0.02,0.05,0,0,0.02,0.03,1.5,1.5,86.7,-1.14,-58
"1293","169849556858:  ",2017-05-02 08:36:09,0.02,0.32,0,0.14,0,0,0,0,-0.46,1.04,-23,63.7,-1.72,-87
"1297","169849633424:  ",2017-05-02 08:38:46,0.02,0,0.04,0.02,0,0,0,0,-0.06,0.98,-3,60.7,-1.72,-87
"1299","169849678522:  ",2017-05-02 08:40:19,0.02,0,0,0.06,0,0,0,0,-0.06,0.92,-3,57.7,-1.76,-89
"1301","169849714611:  ",2017-05-02 08:41:32,0.02,0,0.06,0.03,0.11,0.02,0,0.06,0.06,0.98,3,60.7,-1.68,-85
"1306","169849742573:  ",2017-05-02 08:42:29,0.02,0,0,0,0,0.01,0,0,-0.01,0.97,-0.5,60.2,-1.68,-85
"1307","169849755960:  ",2017-05-02 08:42:57,0.02,0,0.02,0.02,0.05,0,0,0.02,0.03,1,1.5,61.7,-1.7,-86
"1311","169849784213:  ",2017-05-02 08:43:37,0.02,0,0,0,0,0.02,0,0,-0.02,0.98,-1,60.7,-1.7,-86
"1312","169849794942:  ",2017-05-02 08:43:59,0.02,0,0,0,0,0.01,0,0,-0.01,0.97,-0.5,60.2,-1.61,-81.5
"1313","169849806244:  ",2017-05-02 08:44:22,0.02,0,0.31,0,0.31,0,0.12,0.31,0.19,1.16,9.5,69.7,-1.4,-71
"1317","169849843703:  ",2017-05-02 08:45:38,0.02,0,0,0.02,0,0,0,0,-0.02,1.14,-1,68.7,-1.36,-69
"1318","169849858739:  ",2017-05-02 08:46:08,0.02,0,0.05,0,0.09,0,0.04,0.05,0.05,1.19,2.5,71.2,-1.29,-65.5
"1322","169849869660:  ",2017-05-02 08:46:30,0.02,0,0,0.07,0,0,0,0,-0.07,1.12,-3.5,67.7,-1.34,-68
"1324","169849927320:  ",2017-05-02 08:48:26,0.02,0,0,0,0,0.02,0,0,-0.02,1.1,-1,66.7,-1.35,-68.5
"1325","169849933637:  ",2017-05-02 08:48:39,0.02,0,0,0.02,0,0,0,0,-0.02,1.08,-1,65.7,-1.36,-69
"1326","169849948189:  ",2017-05-02 08:49:08,0.02,0,0,0,0,0.01,0,0,-0.01,1.07,-0.5,65.2,-1.54,-78
"1327","169850017378:  ",2017-05-02 08:51:25,0.02,0,0,0,0,0.02,0,0,-0.02,1.05,-1,64.2,-1.54,-78
"1328","169850019191:  ",2017-05-02 08:51:28,0.02,0,0,0,0.05,0,0.06,0.04,0.03,1.08,1.5,65.7,-1.5,-76
"1331","169850041364:  ",2017-05-02 08:52:12,0.02,0,0,0,0,0.01,0,0,-0.01,1.07,-0.5,65.2,-1.71,-86.5
"1332","169850043685:  ",2017-05-02 08:52:17,0.02,0,0,0,0,0,0.06,0,-0.06,1.01,-3,62.2,-1.75,-88.5
"1333","169850103341:  ",2017-05-02 08:54:16,0.02,0,0,0,0,0.02,0,0,-0.02,0.99,-1,61.2,-1.67,-84.5
"1334","169850107966:  ",2017-05-02 08:54:25,0.02,0,0.13,0.02,0.16,0,0,0.08,0.09,1.08,4.5,65.7,-1.52,-77
"1339","169850113497:  ",2017-05-02 08:54:36,0.02,0,0,0,0,0.01,0,0,-0.01,1.07,-0.5,65.2,-1.51,-76.5
"1340","169850145951:  ",2017-05-02 08:55:44,0.02,0,0.2,0.02,0.67,0,0.1,0,0.35,1.42,17.5,82.7,-1.19,-60.5
"1344","169850221570:  ",2017-05-02 08:58:34,0.02,0,0.06,0.02,0.06,0,0,0.06,0.04,1.46,2,84.7,-1.3,-66
"1348","169850244102:  ",2017-05-02 08:59:24,0.02,0,0,0.02,0,0,0,0,-0.02,1.44,-1,83.7,-1.26,-64
"1349","169850274342:  ",2017-05-02 09:00:30,0.02,0,0,0,0,0.02,0,0,-0.02,1.42,-1,82.7,-1.26,-64
"1350","169850280255:  ",2017-05-02 09:00:43,0.02,0,0,0,0.02,0.02,0,0.01,0.01,1.43,0.5,83.2,-1.19,-60.5
"1353","169850289358:  ",2017-05-02 09:01:02,0.02,0,0,0,0,0.01,0,0,-0.01,1.42,-0.5,82.7,-1.21,-61.5
"1354","169850294541:  ",2017-05-02 09:01:12,0.02,0,0,0,0,0.01,0,0,-0.01,1.41,-0.5,82.2,-1.21,-61.5
"1355","169850346816:  ",2017-05-02 09:02:57,0.02,0,0.05,0.02,0.07,0,0,0.05,0.05,1.46,2.5,84.7,-1.1,-56
"1359","169850384340:  ",2017-05-02 09:04:10,0.02,0,0,0.02,0.11,0,0.06,0.03,0.06,1.52,3,87.7,-1.24,-63
"1363","169850426137:  ",2017-05-02 09:05:31,0.02,0,0,0,0,0.02,0,0,-0.02,1.5,-1,86.7,-1.24,-63
"1364","169850438489:  ",2017-05-02 09:05:56,0.02,0,0,0,0,0.01,0,0,-0.01,1.49,-0.5,86.2,-1.23,-62.5
"1365","169850490941:  ",2017-05-02 09:07:38,0.02,0,0,0.02,0,0,0,0,-0.02,1.47,-1,85.2,-1.23,-62.5
"1366","169850504900:  ",2017-05-02 09:08:05,0.02,0,0,0,0,0.02,0,0,-0.02,1.45,-1,84.2,-1.19,-60.5
"1367","169850519017:  ",2017-05-02 09:08:33,0.02,0,0,0,0,0.01,0,0,-0.01,1.44,-0.5,83.7,-1.23,-62.5
"1368","169850560971:  ",2017-05-02 09:09:54,0.02,0,0,0.08,0.3,0,0.06,0,0.16,1.6,8,91.7,-1.05,-53.5
"1371","169850619213:  ",2017-05-02 09:11:47,0.03,0,0,0,0,0.02,0,0,-0.02,1.58,-0.7,91,-1.06,-53.7
"1372","169850634665:  ",2017-05-02 09:12:17,0.02,0,0,0,0,0.01,0,0,-0.01,1.57,-0.5,90.5,-1.13,-56.2
"1373","169850650895:  ",2017-05-02 09:12:48,0.02,0,0.18,0.43,0.68,0,0.06,0,0.0100000000000001,1.58,0.5,91,-0.96,-47.7
"1377","169850696694:  ",2017-05-02 09:14:17,0.02,0,0,0,0,0.02,0,0,-0.02,1.56,-1,90,-0.96,-47.7
"1378","169850715605:  ",2017-05-02 09:14:54,0.02,0,0.39,0.06,0.39,0.01,0.12,0.39,0.2,1.76,10,100,-0.8,-39.7
"1384","169850830750:  ",2017-05-02 09:18:34,0.02,0,0,0,0,0.02,0,0,-0.02,1.74,-1,99,-0.86,-42.7
"1385","169850830977:  ",2017-05-02 09:18:35,0.02,0,0.06,0.02,0,0,0,0,-0.08,1.66,-4,95,-1.19,-59.2
"1387","169850857301:  ",2017-05-02 09:19:24,0.02,0,0,0,0,0.01,0,0,-0.01,1.65,-0.5,94.5,-1.4,-69.7
"1388","169850897175:  ",2017-05-02 09:20:40,0.02,0,0,0.02,0,0,0,0,-0.02,1.63,-1,93.5,-1.4,-69.7
"1389","169850960912:  ",2017-05-02 09:22:41,0.02,0,0,0.02,0,0,0,0,-0.02,1.61,-1,92.5,-0.47,-23.2
"1390","169850977590:  ",2017-05-02 09:23:13,0.02,0,0,0,0,0.01,0,0,-0.01,1.6,-0.5,92,-0.46,-22.7
"1391","169850980585:  ",2017-05-02 09:23:19,0.02,0,0.69,0,0.55,0.02,0.12,0.55,0.27,1.87,13.5,105.5,-0.23,-11.2
"1397","169851015855:  ",2017-05-02 09:24:26,0.02,0,0,0.16,0.37,0.01,0,0,0.2,2.07,10,115.5,-0.17,-8.2
"1403","169851047042:  ",2017-05-02 09:25:26,0.02,0,0,0.02,0,0,0,0,-0.02,2.05,-1,114.5,-0.13,-6.2
"1404","169851073799:  ",2017-05-02 09:26:17,0.02,0,0,0.02,0,0,0,0,-0.02,2.03,-1,113.5,-0.13,-6.2
"1405","169851086013:  ",2017-05-02 09:26:40,0.02,0,0,0,0.05,0,0.06,0.04,0.03,2.06,1.5,115,-0.23,-11.2
"1408","169851148727:  ",2017-05-02 09:28:39,0.02,0,0,0,0,0.02,0,0,-0.02,2.04,-1,114,-0.17,-8.2
"1409","169851156329:  ",2017-05-02 09:28:53,0.02,0,0,0.02,0,0,0,0,-0.02,2.02,-1,113,-0.13,-6.2
"1410","169851176729:  ",2017-05-02 09:29:32,0.02,0,0,0.01,0,0.01,0,0,-0.02,2,-1,112,-0.0900000000000003,-4.2
"1412","169851194752:  ",2017-05-02 09:30:05,0.02,0,0,0.06,0,0,0,0,-0.06,1.94,-3,109,-1.05,-52.2
"1413","169851233055:  ",2017-05-02 09:31:17,0.02,0,0,0,0,0.02,0,0,-0.02,1.92,-1,108,-1.05,-52.2
"1414","169851249549:  ",2017-05-02 09:31:48,0.02,0,0.03,0.02,0.05,0,0,0.03,0.03,1.95,1.5,109.5,-1,-49.7
"1418","169851265206:  ",2017-05-02 09:32:18,0.02,0,0.11,0,0.21,0.01,0.06,0.11,0.14,2.09,7,116.5,-0.85,-42.2
"1423","169851301582:  ",2017-05-02 09:33:26,0.02,0,0,0,0,0.02,0,0,-0.02,2.07,-1,115.5,-0.88,-43.7
"1424","169851305437:  ",2017-05-02 09:33:33,0.02,0,0,0.06,0,0,0,0,-0.06,2.01,-3,112.5,-0.93,-46.2
"1427","169851320321:  ",2017-05-02 09:34:01,0.02,0,0,0,0,0.01,0,0,-0.01,2,-0.5,112,-0.77,-38.2
"1428","169851354606:  ",2017-05-02 09:35:05,0.02,0,0,0.06,0,0,0,0,-0.06,1.94,-3,109,-0.99,-49.2
"1429","169851470462:  ",2017-05-02 09:38:43,0.02,0,0,0,0,0.02,0,0,-0.02,1.92,-1,108,-0.95,-47.2
"1430","169851486485:  ",2017-05-02 09:39:13,0.02,0,0,0,0,0.01,0,0,-0.01,1.91,-0.5,107.5,-0.94,-46.7
"1431","169851521974:  ",2017-05-02 09:40:19,0.02,0,0.38,0,0.99,0,0.12,0,0.49,2.4,24.5,132,-0.44,-21.7
"1435","169851547893:  ",2017-05-02 09:41:07,0.02,0,0,0.02,0,0.02,0,0,-0.04,2.36,-2,130,1.25,62.8
"1437","169851594148:  ",2017-05-02 09:42:33,0.02,0,0,0,0,0,0.04,0,-0.04,2.32,-2,128,1.23,61.8
"1438","169851609908:  ",2017-05-02 09:43:02,0.02,0,0.14,0.01,0.15,0.01,0,0.1,0.09,2.41,4.5,132.5,1.34,67.3
"1444","169851656082:  ",2017-05-02 09:44:28,0.02,0,0,0,0,0.02,0,0,-0.02,2.39,-1,131.5,1.08,54.3
"1445","169851674229:  ",2017-05-02 09:45:02,0.02,0,0,0,0,0.01,0,0,-0.01,2.38,-0.5,131,1.04,52.3
"1446","169851678405:  ",2017-05-02 09:45:09,0.02,0,0,0,0.05,0,0.04,0.02,0.03,2.41,1.5,132.5,1.06,53.3
"1449","169851692957:  ",2017-05-02 09:45:36,0.02,0,0.05,0.02,0,0,0,0,-0.07,2.34,-3.5,129,0.0500000000000003,2.8
"1451","169851805858:  ",2017-05-02 09:49:03,0.02,0,0,0.08,0,0,0,0,-0.08,2.26,-4,125,-0.00999999999999979,-0.200000000000003
"1453","169851848418:  ",2017-05-02 09:50:21,0.02,0.3,1.22,1,5,0.01,0,0,2.47,4.73,123.5,248.5,2.48,124.3
"1460","169851893199:  ",2017-05-02 09:51:42,0.02,0,0,0,0,0.02,0,0,-0.02,4.71,-1,247.5,2.66,133.3
"1461","169851918334:  ",2017-05-02 09:52:28,0.02,0,0,0,0,0.01,0,0,-0.01,4.7,-0.5,247,2.67,133.8
"1462","169851995638:  ",2017-05-02 09:54:48,0.02,0,0,0.05,0.11,0,0,0,0.06,4.76,3,250,2.62,131.3
"1465","169852000008:  ",2017-05-02 09:54:56,0.02,0,0,0.02,0,0,0,0,-0.02,4.74,-1,249,2.73,136.8
"1466","169852022458:  ",2017-05-02 09:55:41,0.02,0,0.15,0,0.2,0,0.06,0.15,0.14,4.88,7,256,2.88,144.3
"1470","169852046804:  ",2017-05-02 09:56:32,0.02,0,0,0,0,0.02,0,0,-0.02,4.86,-1,255,2.85,142.8
"1471","169938805759:  ",2017-05-04 10:01:19,0.02,0,0,0,0,0.02,0,0,-0.02,4.84,-1,254,2.84,142.3
"1472","169938818860:  ",2017-05-04 10:01:42,0.02,0,0,0,0,0.01,0,0,-0.01,4.83,-0.5,253.5,2.96,148.3
"1473","169938959927:  ",2017-05-04 10:05:10,0.02,0,0,0,0,0.02,0,0,-0.02,4.81,-1,252.5,2.96,148.3
"1474","169939012297:  ",2017-05-04 10:06:16,0.02,0,0,0,0,0.01,0,0,-0.01,4.8,-0.5,252,2.96,148.3
"1475","169939022286:  ",2017-05-04 10:06:31,0.02,0,0,0,0,0.02,0,0,-0.02,4.78,-1,251,2.56,128.3
"1476","169939078743:  ",2017-05-04 10:07:52,0.02,0,0,0,0.05,0,0.06,0.04,0.03,4.81,1.5,252.5,2.61,130.8
"1479","169939089819:  ",2017-05-04 10:08:08,0.02,0,0.12,0.13,0,0.01,0,0,-0.26,4.55,-13,239.5,2.36,118.3
"1483","169939149225:  ",2017-05-04 10:09:35,0.02,0,0,0,0.15,0,0.12,0.06,0.09,4.64,4.5,244,2.42,121.3
"1486","169939230961:  ",2017-05-04 10:11:35,0.02,0,0,0.02,0,0,0,0,-0.02,4.62,-1,243,2.42,121.3
"1487","169939275890:  ",2017-05-04 10:12:41,0.02,0,0,0,0,0.02,0,0,-0.02,4.6,-1,242,2.41,120.8
"1488","169939288829:  ",2017-05-04 10:13:00,0.02,0,0,0,0,0.01,0,0,-0.01,4.59,-0.5,241.5,2.42,121.3
"1489","169939327243:  ",2017-05-04 10:13:56,0.02,0,0,0,0,0.02,0,0,-0.02,4.57,-1,240.5,3.12,156.3
"1490","169939338247:  ",2017-05-04 10:14:12,0.02,0,0,0,0.19,0,0.24,0.16,0.11,4.68,5.5,246,3.15,157.8
"1493","169939351815:  ",2017-05-04 10:14:32,0.02,0,0,0,0,0.01,0,0,-0.01,4.67,-0.5,245.5,3.16,158.3
"1494","169939418230:  ",2017-05-04 10:16:10,0.02,0,0,0,0,0,0.04,0,-0.04,4.63,-2,243.5,3.13,156.8
"1495","169939456740:  ",2017-05-04 10:17:06,0.02,0,0,0,0.05,0,0.04,0.02,0.03,4.66,1.5,245,3.18,159.3
"1498","169939512250:  ",2017-05-04 10:18:28,0.02,0,0,0,0,0.02,0,0,-0.02,4.64,-1,244,3.17,158.8
"1499","169939526287:  ",2017-05-04 10:18:48,0.02,0.24,0.12,0.36,0,0.01,0.12,0,-0.85,3.79,-42.5,201.5,2.29,114.8
"1504","169939537641:  ",2017-05-04 10:19:05,0.02,0,0,0,0.02,0.02,0,0.01,0.01,3.8,0.5,202,2.76,138.3
"1507","169939551875:  ",2017-05-04 10:19:26,0.02,0,0,0.05,0,0.01,0,0,-0.06,3.74,-3,199,2.76,138.3
"1509","169939587262:  ",2017-05-04 10:20:19,0.02,0,0.45,0.06,0.58,0,0,0.3,0.37,4.11,18.5,217.5,3.19,159.8
"1514","169939676772:  ",2017-05-04 10:22:35,0.02,0,0.03,0.02,0.05,0,0,0.03,0.03,4.14,1.5,219,3.16,158.3
"1518","169939705420:  ",2017-05-04 10:23:19,0.02,0,0,0,0,0.02,0,0,-0.02,4.12,-1,218,3.15,157.8
"1519","169939724198:  ",2017-05-04 10:23:48,0.02,0,0,0,0,0.01,0,0,-0.01,4.11,-0.5,217.5,3.11,155.8
"1520","169939726583:  ",2017-05-04 10:23:52,0.02,0,0.1,0.15,0.66,0,0.06,0,0.35,4.46,17.5,235,3.48,174.3
"1524","169939756045:  ",2017-05-04 10:24:37,0.02,0,0,0.06,0,0,0,0,-0.06,4.4,-3,232,3.43,171.8
"1526","169939803303:  ",2017-05-04 10:25:49,0.02,0,0,0,0,0.02,0,0,-0.02,4.38,-1,231,3.22,161.3
"1527","169939833345:  ",2017-05-04 10:26:36,0.02,0,0,0,0,0.01,0,0,-0.01,4.37,-0.5,230.5,3.23,161.8
"1528","169939878355:  ",2017-05-04 10:27:46,0.02,0,0,0,0,0.02,0,0,-0.02,4.35,-1,229.5,3.16,158.3
"1529","169939893328:  ",2017-05-04 10:28:09,0.02,0,0,0,0.05,0,0.04,0.02,0.03,4.38,1.5,231,3.26,163.3
"1532","169939901761:  ",2017-05-04 10:28:22,0.02,0,0,0,0,0.01,0,0,-0.01,4.37,-0.5,230.5,3.27,163.8
"1533","169939921052:  ",2017-05-04 10:28:52,0.02,0,0,0.02,0,0,0,0,-0.02,4.35,-1,229.5,3.27,163.8
"1534","169939938507:  ",2017-05-04 10:29:20,0.02,0,0.03,0.02,0.05,0,0,0.03,0.03,4.38,1.5,231,3.31,165.8
"1538","169939960380:  ",2017-05-04 10:29:53,0.02,0,0,0,0.05,0,0.06,0.04,0.03,4.41,1.5,232.5,3.36,168.3
"1541","169939977808:  ",2017-05-04 10:30:21,0.02,0,0,0,0,0.02,0,0,-0.02,4.39,-1,231.5,3.31,165.8
"1542","169939990554:  ",2017-05-04 10:30:40,0.02,0,0,0,0,0.01,0,0,-0.01,4.38,-0.5,231,3.31,165.8
"1543","169940109085:  ",2017-05-04 10:33:45,0.02,0,0,0,0.05,0,0.04,0.02,0.03,4.41,1.5,232.5,3.4,170.3
"1546","169940122920:  ",2017-05-04 10:34:07,0.02,0,0,0.04,0,0.02,0,0,-0.06,4.35,-3,229.5,3.36,168.3
"1548","169940151402:  ",2017-05-04 10:34:51,0.02,0,0,0,0,0.01,0,0,-0.01,4.34,-0.5,229,3.26,163.3
"1549","169940173858:  ",2017-05-04 10:35:27,0.02,0,0,0,0,0.02,0,0,-0.02,4.32,-1,228,3.25,162.8
"1550","169940209019:  ",2017-05-04 10:36:22,0.02,0,0,0,0,0.01,0,0,-0.01,4.31,-0.5,227.5,2.89,144.8
"1551","169940320022:  ",2017-05-04 10:39:14,0.02,0.75,0,0.21,0,0,0,0,-0.96,3.35,-48,179.5,1.89,94.8
"1555","169940374558:  ",2017-05-04 10:40:40,0.02,0,0.02,0.02,0.07,0,0,0.02,0.05,3.4,2.5,182,1.96,98.3
"1559","169940398186:  ",2017-05-04 10:41:16,0.02,0,0,0,0,0.02,0,0,-0.02,3.38,-1,181,1.96,98.3
"1560","169940417361:  ",2017-05-04 10:41:46,0.02,0,0,0,0,0.01,0,0,-0.01,3.37,-0.5,180.5,1.94,97.3
"1561","169940439603:  ",2017-05-04 10:42:20,0.02,0,0.02,0.02,0.05,0,0,0.02,0.03,3.4,1.5,182,1.98,99.3
"1565","169940459285:  ",2017-05-04 10:42:51,0.02,0,0,0.05,0,0,0,0,-0.05,3.35,-2.5,179.5,1.94,97.3
"1567","169940461226:  ",2017-05-04 10:42:54,0.02,0,0,0,0,0.02,0,0,-0.02,3.33,-1,178.5,1.87,93.8
"1568","169940495932:  ",2017-05-04 10:43:47,0.02,0,0,0,0,0.01,0,0,-0.01,3.32,-0.5,178,1.8,90.3
"1569","169940626934:  ",2017-05-04 10:47:11,0.02,0,0,0,0,0.02,0,0,-0.02,3.3,-1,177,1.8,90.3
"1570","169940642026:  ",2017-05-04 10:47:34,0.02,0,0,0.01,0,0.01,0,0,-0.02,3.28,-1,176,1.79,89.8
"1572","169940671853:  ",2017-05-04 10:48:21,0.02,0,0,0,0,0.02,0,0,-0.02,3.26,-1,175,1.79,89.8
"1573","169940710666:  ",2017-05-04 10:49:21,0.02,0,0.06,0.05,0.13,0,0,0.06,0.08,3.34,4,179,1.89,94.8
"1577","169940717299:  ",2017-05-04 10:49:31,0.02,0,0,0.19,0.36,0.01,0.16,0,0,3.34,0,179,1.9,95.3
"1582","169940743642:  ",2017-05-04 10:50:12,0.02,0,0.03,0.02,0.05,0,0,0.03,0.03,3.37,1.5,180.5,1.77,88.8
"1586","169940771172:  ",2017-05-04 10:50:54,0.02,0,0.04,0.02,0.08,0,0,0.04,0.06,3.43,3,183.5,1.85,92.5
"1590","169940851558:  ",2017-05-04 10:52:59,0.02,0,0,0,0,0.02,0,0,-0.02,3.41,-1,182.5,1.84,92
"1591","169940872979:  ",2017-05-04 10:53:32,0.02,0,0,0,0,0.01,0,0,-0.01,3.4,-0.5,182,1.82,91
"1592","169940938101:  ",2017-05-04 10:55:14,0.02,0.66,0,0,3.75,0,1.28,0,1.81,5.21,90.5,272.5,3.65,182.5
"1596","169940969296:  ",2017-05-04 10:56:11,0.02,0,0,0.02,0,0,0,0,-0.02,5.19,-1,271.5,3.43,171.5
"1597","169940999818:  ",2017-05-04 10:57:07,0.02,0,0,0,0,0.02,0,0,-0.02,5.17,-1,270.5,3.43,171.5
"1598","169941013987:  ",2017-05-04 10:57:32,0.02,0,0,0,0,0.02,0,0,-0.02,5.15,-1,269.5,3.49,174.5
"1599","169941017382:  ",2017-05-04 10:57:38,0.02,0,0.02,0.01,0.06,0.01,0,0.02,0.04,5.19,2,271.5,3.54,177
"1604","169941024677:  ",2017-05-04 10:57:52,0.02,0,0,0.03,0.08,0.01,0,0,0.04,5.23,2,273.5,3.6,180
"1608","169941045757:  ",2017-05-04 10:58:30,0.02,0,0,0.02,0,0,0,0,-0.02,5.21,-1,272.5,3.6,180
"1609","169941066717:  ",2017-05-04 10:59:07,0.02,0,0,0.13,0.68,0.02,0.4,0.2,0.33,5.54,16.5,289,3.94,197
"1615","169941095365:  ",2017-05-04 10:59:59,0.02,0,0,0,0,0.01,0,0,-0.01,5.53,-0.5,288.5,3.66,183
"1616","169941122529:  ",2017-05-04 11:00:47,0.02,0,0.06,0.05,0.11,0,0,0.06,0.06,5.59,3,291.5,3.52,176
"1621","169941150645:  ",2017-05-04 11:01:34,0.02,0,0,0,0.02,0.02,0,0.01,0.01,5.6,0.5,292,3.55,177.5
"1624","169941156357:  ",2017-05-04 11:01:43,0.02,0,0,0.01,0,0.01,0,0,-0.02,5.58,-1,291,3.55,177.5
"1626","169941179615:  ",2017-05-04 11:02:19,0.02,0,0.02,0.02,0.05,0,0,0.02,0.03,5.61,1.5,292.5,3.55,177.5
"1630","169941260856:  ",2017-05-04 11:04:25,0.02,0,0,0,0,0.02,0,0,-0.02,5.59,-1,291.5,3.55,177.5
"1631","169941308638:  ",2017-05-04 11:05:39,0.02,0,0,0.03,0,0.01,0,0,-0.04,5.55,-2,289.5,3.53,176.5
"1634","169969523617:  ",2017-05-04 22:23:58,0.02,0,0.02,0,0.04,0.02,0,0.02,0.02,5.57,1,290.5,3.57,178.5
"1638","169969554081:  ",2017-05-04 22:25:23,0.02,0,0,0,0,0.01,0,0,-0.01,5.56,-0.5,290,3.62,181
"1639","169969591241:  ",2017-05-04 22:27:09,0.02,0,0.14,0.2,0,0,0,0,-0.34,5.22,-17,273,3.3,165
"1643","169969669130:  ",2017-05-04 22:30:53,0.02,0,0,0,0.05,0,0.06,0.04,0.03,5.25,1.5,274.5,3.3,165
"1646","169969715960:  ",2017-05-04 22:33:06,0.02,0,0,0,0.05,0,0.04,0.02,0.03,5.28,1.5,276,3.19,159.5
"1649","169969758666:  ",2017-05-04 22:35:08,0.02,0,0,0.08,0,0.02,0.2,0,-0.3,4.98,-15,261,2.91,145.5
"1652","169969799492:  ",2017-05-04 22:36:38,0.02,0,0.21,0.01,0.15,0.01,0,0.15,0.07,5.05,3.5,264.5,3.04,152
"1659","169969872136:  ",2017-05-04 22:40:07,0.02,0,0.07,0,0.11,0,0.04,0.07,0.07,5.12,3.5,268,3.12,156
"1663","169969886439:  ",2017-05-04 22:40:48,0.02,0,0,0,0.05,0,0.04,0.02,0.03,5.15,1.5,269.5,3.21,160.5
"1666","169969911001:  ",2017-05-04 22:41:58,0.02,0,0,0.04,0,0,0.04,0,-0.08,5.07,-4,265.5,3.15,157.5
"1668","169969972016:  ",2017-05-04 22:45:04,0.02,0,0,0,0,0.02,0,0,-0.02,5.05,-1,264.5,3.14,157
"1669","169970246690:  ",2017-05-04 22:59:12,0.02,0,0,0,0.02,0.02,0,0.01,0.01,5.06,0.5,265,2.66,133
"1672","169970249673:  ",2017-05-04 22:59:22,0.02,0,0,0,0,0.01,0,0,-0.01,5.05,-0.5,264.5,2.69,134.5
"1673","169970257071:  ",2017-05-04 22:59:47,0.02,0,0,0.12,1.25,0.02,0.47,0,0.64,5.69,32,296.5,3.37,168.5
"1678","169970260855:  ",2017-05-04 23:00:00,0.02,0,0,0,0.05,0,0.04,0.02,0.03,5.72,1.5,298,3.31,165.5
"1681","169970272279:  ",2017-05-04 23:00:38,0.02,0,0,0,0,0.02,0,0,-0.02,5.7,-1,297,3.31,165.5
"1682","169970277582:  ",2017-05-04 23:00:55,0.02,0,0,0,0,0.01,0,0,-0.01,5.69,-0.5,296.5,3.31,165.5
"1683","169970283528:  ",2017-05-04 23:01:14,0.02,0,0.05,0.02,0.05,0,0,0.05,0.03,5.72,1.5,298,3.31,165.5
"1687","169970287798:  ",2017-05-04 23:01:27,0.02,0,0.03,0.02,0.05,0,0,0.03,0.03,5.75,1.5,299.5,3.41,170.5
"1691","169970291422:  ",2017-05-04 23:01:38,0.02,0,0,0.02,0,0,0,0,-0.02,5.73,-1,298.5,3.47,173.5
"1692","169970298494:  ",2017-05-04 23:02:00,0.02,0,0,0,0,0.02,0,0,-0.02,5.71,-1,297.5,0.98,49
"1693","169970309110:  ",2017-05-04 23:02:33,0.02,0,0,0,0,0.01,0,0,-0.01,5.7,-0.5,297,0.99,49.5
"1694","169970921293:  ",2017-05-04 23:34:34,0.02,0,0,0,0,0.02,0,0,-0.02,5.68,-1,296,0.98,49
"1695","170015253076:  ",2017-05-05 22:29:05,0.02,0,0,0,0.05,0,0.04,0.02,0.03,5.71,1.5,297.5,0.95,47.5
"1698","170015271851:  ",2017-05-05 22:29:53,0.02,0,0.06,0,0.08,0.02,0,0.06,0.06,5.77,3,300.5,1.03,51.5
"1702","170015301846:  ",2017-05-05 22:31:13,0.02,0,0,0,0,0.01,0,0,-0.01,5.76,-0.5,300,0.88,44
"1703","170015311408:  ",2017-05-05 22:31:38,0.02,0,0.03,0.02,0.05,0,0,0.03,0.03,5.79,1.5,301.5,0.930000000000001,46.5
"1707","170015357038:  ",2017-05-05 22:33:38,0.02,0,0,0.04,0,0.02,0,0,-0.06,5.73,-3,298.5,0.89,44.5
"1709","170015370579:  ",2017-05-05 22:34:14,0.02,0,0,0,0.06,0.01,0.08,0.06,0.03,5.76,1.5,300,0.93,46.5
"1713","170015389477:  ",2017-05-05 22:35:05,0.02,0,0.2,0.04,0,0,0.1,0,-0.34,5.42,-17,283,0.61,30.5
"1717","170015405502:  ",2017-05-05 22:35:47,0.02,0,0,0.02,0,0,0,0,-0.02,5.4,-1,282,0.6,30
"1718","170015433122:  ",2017-05-05 22:37:01,0.02,0,0,0,0,0.02,0,0,-0.02,5.38,-1,281,0.6,30
"1719","170015450706:  ",2017-05-05 22:37:48,0.02,0,0,0,0,0.01,0,0,-0.01,5.37,-0.5,280.5,0.56,28
"1720","170015453102:  ",2017-05-05 22:37:54,0.02,0,0,0.06,0,0,0,0,-0.06,5.31,-3,277.5,0.76,38
"1722","170015470752:  ",2017-05-05 22:38:41,0.02,0,0,0,0,0.02,0,0,-0.02,5.29,-1,276.5,0.65,32.5
"1723","170015482663:  ",2017-05-05 22:39:13,0.02,0,0,0.05,0,0.01,0,0,-0.06,5.23,-3,273.5,0.609999999999999,30.5
"1726","170015503572:  ",2017-05-05 22:40:09,0.02,0,0,0,0.05,0,0.06,0.04,0.03,5.26,1.5,275,0.66,33
"1729","170015521893:  ",2017-05-05 22:40:59,0.02,0,0.12,0,0.18,0,0.06,0.12,0.12,5.38,6,281,0.79,39.5
"1733","170015543798:  ",2017-05-05 22:41:59,0.02,0,0,0,0,0.02,0,0,-0.02,5.36,-1,280,0.79,39.5
"1734","170015553074:  ",2017-05-05 22:42:24,0.02,0,0,0,0,0.01,0,0,-0.01,5.35,-0.5,279.5,0.67,33.5
"1735","170015558839:  ",2017-05-05 22:42:39,0.02,0,0,0,0,0.02,0,0,-0.02,5.33,-1,278.5,0.66,33
"1736","170015565727:  ",2017-05-05 22:42:58,0.02,0,0,0.02,0,0,0,0,-0.02,5.31,-1,277.5,0.68,34
"1737","170015573771:  ",2017-05-05 22:43:21,0.02,0,0.03,0.02,0.05,0,0,0.03,0.03,5.34,1.5,279,0.68,34
"1741","170015587934:  ",2017-05-05 22:43:59,0.02,0,0,0,0,0.02,0,0,-0.02,5.32,-1,278,0.680000000000001,34
"1742","170015595946:  ",2017-05-05 22:44:21,0.02,0,0,0,0,0.01,0,0,-0.01,5.31,-0.5,277.5,1.52,76
"1743","170015606487:  ",2017-05-05 22:44:50,0.02,0,0,0.02,0,0,0,0,-0.02,5.29,-1,276.5,1.49,74.5
"1744","170015612418:  ",2017-05-05 22:45:06,0.02,0,0,0,0,0.01,0,0,-0.01,5.28,-0.5,276,1.54,77
"1745","170015659973:  ",2017-05-05 22:47:16,0.02,0,0,0.3,0,0.02,0,0,-0.32,4.96,-16,260,0.850000000000001,42.5
"1748","170015691654:  ",2017-05-05 22:48:31,0.02,0,0,0,0,0.01,0,0,-0.01,4.95,-0.5,259.5,0.81,40.5
"1749","170015700749:  ",2017-05-05 22:48:56,0.02,0,0.26,0.4,1.4,0,0.04,0,0.7,5.65,35,294.5,1.53,76.5
"1755","170015761020:  ",2017-05-05 22:51:44,0.02,0,0,0,0,0.02,0,0,-0.02,5.63,-1,293.5,1.52,76
"1756","170015778547:  ",2017-05-05 22:52:33,0.02,0,0,0,0,0.01,0,0,-0.01,5.62,-0.5,293,1.16,58
"1757","170015789848:  ",2017-05-05 22:53:05,0.02,0,0,0.06,0,0,0,0,-0.06,5.56,-3,290,1.16,58
"1759","170015796328:  ",2017-05-05 22:53:23,0.02,0,0,0,0,0.02,0,0,-0.02,5.54,-1,289,1.16,58
"1760","170015813160:  ",2017-05-05 22:54:10,0.02,0,0,0,0,0.01,0,0,-0.01,5.53,-0.5,288.5,1.16,58
"1761","170015824520:  ",2017-05-05 22:54:42,0.02,0,0,0.09,0,0,0,0,-0.09,5.44,-4.5,284,1.09,54.5
"1763","170015854950:  ",2017-05-05 22:56:16,0.02,0,0,0,0,0.02,0,0,-0.02,5.42,-1,283,1.04,52
"1764","170015880377:  ",2017-05-05 22:57:36,0.02,0,0,0,0,0.01,0,0,-0.01,5.41,-0.5,282.5,1.04,52
"1765","170015885233:  ",2017-05-05 22:57:51,0.02,0,0,0,0.02,0.02,0,0.01,0.01,5.42,0.5,283,1.07,53.5
"1768","170015892425:  ",2017-05-05 22:58:13,0.02,0,0,0,0,0.01,0,0,-0.01,5.41,-0.5,282.5,1.03,51.5
"1769","170015916646:  ",2017-05-05 22:59:29,0.02,0,0,0,0,0.02,0,0,-0.02,5.39,-1,281.5,0.98,49
"1770","170015931820:  ",2017-05-05 23:00:17,0.02,0,0,0,0,0.01,0,0,-0.01,5.38,-0.5,281,0.99,49.5
"1771","170015966602:  ",2017-05-05 23:01:59,0.02,0,0,0.02,0,0,0,0,-0.02,5.36,-1,280,0.98,49
"1772","170015995146:  ",2017-05-05 23:03:20,0.02,0,0,0,0,0.02,0,0,-0.02,5.34,-1,279,0.93,46.5
"1773","170016003935:  ",2017-05-05 23:03:44,0.02,0,0,0,0,0.02,0,0,-0.02,5.32,-1,278,0.97,48.5
"1774","170016004500:  ",2017-05-05 23:03:46,0.02,0,0,0,0,0.01,0,0,-0.01,5.31,-0.5,277.5,0.97,48.5
"1775","170016012231:  ",2017-05-05 23:04:08,0.02,0,0,0.09,0,0,0.06,0,-0.15,5.16,-7.5,270,0.840000000000001,42
"1777","170016013680:  ",2017-05-05 23:04:12,0.02,0,0,0.05,0,0.01,0,0,-0.06,5.1,-3,267,0.79,39.5
"1779","170016048973:  ",2017-05-05 23:05:52,0.02,0,0.21,0.17,0,0,0,0,-0.38,4.72,-19,248,1.37,68.5
"1782","170016053303:  ",2017-05-05 23:06:03,0.02,0.11,0,0.07,0.33,0,0.04,0.11,0.22,4.94,11,259,1.54,77
"1787","170016056430:  ",2017-05-05 23:06:12,0.02,0,0,0,0.02,0.02,0,0.01,0.01,4.95,0.5,259.5,1.57,78.5
"1790","170016074561:  ",2017-05-05 23:07:04,0.02,0,0,0,0,0.01,0,0,-0.01,4.94,-0.5,259,1.57,78.5
"1791","170016103889:  ",2017-05-05 23:08:28,0.02,0,0,0,0,0.02,0,0,-0.02,4.92,-1,258,1.52,76
"1792","170016124127:  ",2017-05-05 23:09:13,0.02,0,0,0,0.05,0,0.04,0,0.01,4.93,0.5,258.5,1.58,79
"1794","170016126879:  ",2017-05-05 23:09:21,0.02,0,0,0,0,0.01,0,0,-0.01,4.92,-0.5,258,1.59,79.5
"1795","170016137731:  ",2017-05-05 23:09:52,0.02,0,0.03,0.02,0.05,0,0,0.03,0.03,4.95,1.5,259.5,1.63,81.5
"1799","170016150308:  ",2017-05-05 23:10:28,0.02,0,0.03,0.02,0.07,0,0,0.03,0.05,5,2.5,262,1.7,85
"1803","170016158043:  ",2017-05-05 23:10:50,0.02,0,0,0,0,0.02,0,0,-0.02,4.98,-1,261,1.7,85
"1804","170016168330:  ",2017-05-05 23:11:20,0.02,0,0,0,0,0.01,0,0,-0.01,4.97,-0.5,260.5,1.71,85.5
"1805","170016178567:  ",2017-05-05 23:11:50,0.02,0,0.14,0.06,0,0,0,0,-0.2,4.77,-10,250.5,1.43,71.5
"1808","170016194354:  ",2017-05-05 23:12:36,0.02,0,0,0,0,0.02,0,0,-0.02,4.75,-1,249.5,1.41,70.5
"1809","170016200824:  ",2017-05-05 23:12:54,0.03,0,0.06,0.02,0.08,0,0,0.06,0.06,4.81,2,251.5,1.44,71
"1813","170016204834:  ",2017-05-05 23:13:06,0.02,0,0,0.05,0,0.01,0,0,-0.06,4.75,-3,248.5,1.32,65
"1815","170016206963:  ",2017-05-05 23:13:12,0.02,0,0.13,0.06,0.2,0,0,0.13,0.14,4.89,7,255.5,1.48,73
"1820","170016234191:  ",2017-05-05 23:14:32,0.02,0,0,0,0,0.02,0,0,-0.02,4.87,-1,254.5,1.47,72.5
"1821","170016266220:  ",2017-05-05 23:16:06,0.02,0,0,0.4,0,0,0,0,-0.4,4.47,-20,234.5,-0.74,-38
"1824","170016272301:  ",2017-05-05 23:16:24,0.02,0,0,0,0,0.01,0,0,-0.01,4.46,-0.5,234,-0.73,-37.5
"1825","170016289385:  ",2017-05-05 23:17:14,0.02,0,0.12,0.16,0.63,0,0.04,0,0.31,4.77,15.5,249.5,-0.4,-21
"1830","170016291358:  ",2017-05-05 23:17:20,0.02,0,0,0,0.05,0,0.06,0.04,0.03,4.8,1.5,251,-0.35,-18.5
"1833","170016316254:  ",2017-05-05 23:18:34,0.02,0,0,0,0,0.01,0,0,-0.01,4.79,-0.5,250.5,-0.399999999999999,-21
"1834","170016331546:  ",2017-05-05 23:19:19,0.02,0,0.1,0,0,0,0.04,0,-0.14,4.65,-7,243.5,-0.58,-30
"1836","170016331704:  ",2017-05-05 23:19:19,0.02,0,0,0,0,0.02,0,0,-0.02,4.63,-1,242.5,-0.58,-30
"1837","170016334215:  ",2017-05-05 23:19:27,0.02,0,0,0.04,0,0,0.83,0,-0.87,3.76,-43.5,199,-1.78,-90
"1841","170016357656:  ",2017-05-05 23:20:36,0.02,0,0,0.01,0,0.01,0,0,-0.02,3.74,-1,198,-1.79,-90.5
"1843","170016373235:  ",2017-05-05 23:21:22,0.02,0.22,0,0.22,0.47,0.02,0,0.22,0.23,3.97,11.5,209.5,-1.62,-82
"1850","170016402945:  ",2017-05-05 23:22:50,0.02,0,0,0,0,0.01,0,0,-0.01,3.96,-0.5,209,-1.64,-83
"1851","170016414421:  ",2017-05-05 23:23:24,0.02,0,0,0,0.07,0,0.08,0.06,0.05,4.01,2.5,211.5,-1.57,-79.5
"1854","170016431899:  ",2017-05-05 23:24:17,0.02,0,0,0,0.05,0,0.08,0.06,0.03,4.04,1.5,213,-1.57,-79.5
"1857","170016433438:  ",2017-05-05 23:24:22,0.02,0,0,0.06,0,0,0,0,-0.06,3.98,-3,210,-1.61,-81.5
"1858","170016442941:  ",2017-05-05 23:24:50,0.02,0,0,0,0,0.02,0,0,-0.02,3.96,-1,209,-1.59,-80.5
"1859","170016449619:  ",2017-05-05 23:25:10,0.02,0,0,0,0,0.01,0,0,-0.01,3.95,-0.5,208.5,-1.62,-82
"1860","170016456972:  ",2017-05-05 23:25:33,0.02,0,0,0.2,0,0,0.1,0,-0.3,3.65,-15,193.5,-1.91,-96.5
"1863","170016483070:  ",2017-05-05 23:26:49,0.02,0,0.03,0.02,0.05,0,0,0.03,0.03,3.68,1.5,195,-1.54,-78
"1867","170016492813:  ",2017-05-05 23:27:19,0.02,0,0.04,0.02,0.07,0,0,0.04,0.05,3.73,2.5,197.5,-1.52,-77
"1871","170016505964:  ",2017-05-05 23:27:59,0.02,0,0,0,0,0.02,0,0,-0.02,3.71,-1,196.5,-1.57,-79.5
"1872","170016512345:  ",2017-05-05 23:28:16,0.02,0.5,0,0,1.34,0,0.12,0,0.72,4.43,36,232.5,-0.55,-28.5
"1875","170016533777:  ",2017-05-05 23:29:21,0.02,0,0,0,0,0.01,0,0,-0.01,4.42,-0.5,232,-0.63,-32.5
"1876","170016546424:  ",2017-05-05 23:30:00,0.02,0,0,0,0,0.02,0,0,-0.02,4.4,-1,231,-0.720000000000001,-37
"1877","170016562148:  ",2017-05-05 23:30:29,0.02,0,0,0.06,0,0,0,0,-0.06,4.34,-3,228,-0.81,-41.5
"1878","170016563889:  ",2017-05-05 23:30:34,0.02,0,0,0,0,0.01,0,0,-0.01,4.33,-0.5,227.5,-0.74,-38
"1879","170016586846:  ",2017-05-05 23:31:45,0.02,0,0.02,0.08,0,0.02,0,0,-0.12,4.21,-6,221.5,-0.84,-43
"1882","170016604589:  ",2017-05-05 23:32:39,0.02,0,0,0,0,0.01,0,0,-0.01,4.2,-0.5,221,-0.859999999999999,-44
"1883","170123367918:  ",2017-05-08 08:28:03,0.02,0,0,0,0,0.02,0,0,-0.02,4.18,-1,220,-0.87,-44.5
"1884","170123391493:  ",2017-05-08 08:28:48,0.02,0,0.02,0.01,0.04,0.01,0,0.02,0.02,4.2,1,221,-1.49,-75.5
"1889","170123434232:  ",2017-05-08 08:30:11,0.02,0,0.06,0.02,0.16,0,0,0,0.08,4.28,4,225,-1.44,-73
"1893","170123482689:  ",2017-05-08 08:31:44,0.02,0,0.06,0,0.08,0.02,0,0.06,0.06,4.34,3,228,-1.36,-69
"1897","170123542591:  ",2017-05-08 08:33:39,0.02,0,0,0,0,0.01,0,0,-0.01,4.33,-0.5,227.5,-1.36,-69
"1898","170123566932:  ",2017-05-08 08:34:26,0.02,0,0.45,0.13,1.17,0.02,0,0,0.57,4.9,28.5,256,-0.82,-42
"1904","170123582894:  ",2017-05-08 08:34:56,0.02,1.15,0,0,2.62,0,0.12,0,1.35,6.25,67.5,323.5,0.5,24
"1908","170123607155:  ",2017-05-08 08:35:43,0.02,0,0,0,0,0.01,0,0,-0.01,6.24,-0.5,323,0.510000000000001,24.5
"1909","170123621224:  ",2017-05-08 08:36:09,0.02,0,0,0.04,0,0,0,0,-0.04,6.2,-2,321,0.49,23.5
"1910","170123633807:  ",2017-05-08 08:36:33,0.02,0,0,0,0.05,0,0.06,0.04,0.03,6.23,1.5,322.5,0.529999999999999,25.5
"1913","170123730717:  ",2017-05-08 08:39:37,0.02,0,0,0,0.02,0.02,0,0.01,0.01,6.24,0.5,323,0.56,27
"1916","170123749660:  ",2017-05-08 08:40:13,0.02,0,0,0,0,0.01,0,0,-0.01,6.23,-0.5,322.5,0.52,25
"1917","170123809827:  ",2017-05-08 08:42:08,0.02,0,0,0,0,0.02,0,0,-0.02,6.21,-1,321.5,0.44,21
